,Unnamed: 0,DICE,FN,FP,IoU,TN,TP,n_pred,n_ref,prediction_file,reference_file,challenge_DICE,challenge_FP,challenge_FN,num_pred_conn_comps,num_gt_conn_comps
0,0,0.8338461538461538,215,217,0.7150395778364116,52158484,1084,1301,1299,/well/papiez/users/hri611/python/nnUNet_results/Dataset219_PETCT/nnUNetTrainer_1500epochs_NoMirroring__nnUNetPlans__3d_fullres/crossval_results_folds_0_1_2_3_4/PETCT_0011f3deaf_03232003.nii.gz,/well/papiez/users/hri611/python/nnUnet_raw/Dataset219_PETCT/labelsTr/PETCT_0011f3deaf_03232003.nii.gz,0.8338461538461538,0.8086663627624512,0.0,8,5
1,1,0.9543434086868172,354,1084,0.912673832513512,48783533,15029,16113,15383,/well/papiez/users/hri611/python/nnUNet_results/Dataset219_PETCT/nnUNetTrainer_1500epochs_NoMirroring__nnUNetPlans__3d_fullres/crossval_results_folds_0_1_2_3_4/PETCT_01140d52d8_08132005.nii.gz,/well/papiez/users/hri611/python/nnUnet_raw/Dataset219_PETCT/labelsTr/PETCT_01140d52d8_08132005.nii.gz,0.9543434086868172,0.58472798538208,0.1244102096557617,5,7
2,2,0.6697932793006102,7098,154,0.5035257068528788,45425393,7355,7509,14453,/well/papiez/users/hri611/python/nnUNet_results/Dataset219_PETCT/nnUNetTrainer_1500epochs_NoMirroring__nnUNetPlans__3d_fullres/crossval_results_folds_0_1_2_3_4/PETCT_0117d7f11f_09132001.nii.gz,/well/papiez/users/hri611/python/nnUnet_raw/Dataset219_PETCT/labelsTr/PETCT_0117d7f11f_09132001.nii.gz,0.6697932793006102,0.0,0.0995281677246093,5,5
3,3,0.0,0,69,0.0,46079931,0,69,0,/well/papiez/users/hri611/python/nnUNet_results/Dataset219_PETCT/nnUNetTrainer_1500epochs_NoMirroring__nnUNetPlans__3d_fullres/crossval_results_folds_0_1_2_3_4/PETCT_0143bab87a_07172005.nii.gz,/well/papiez/users/hri611/python/nnUnet_raw/Dataset219_PETCT/labelsTr/PETCT_0143bab87a_07172005.nii.gz,0.0,0.8584304466247559,0.0,1,0
4,4,0.532097704676568,7458,166,0.3624885023831424,52148041,4335,4501,11793,/well/papiez/users/hri611/python/nnUNet_results/Dataset219_PETCT/nnUNetTrainer_1500epochs_NoMirroring__nnUNetPlans__3d_fullres/crossval_results_folds_0_1_2_3_4/PETCT_01682f60c3_03112002.nii.gz,/well/papiez/users/hri611/python/nnUnet_raw/Dataset219_PETCT/labelsTr/PETCT_01682f60c3_03112002.nii.gz,0.532097704676568,0.3110255241394043,50.18707857513428,5,7
5,5,0.6006680026720107,1976,1013,0.4292533893450448,52154763,2248,3261,4224,/well/papiez/users/hri611/python/nnUNet_results/Dataset219_PETCT/nnUNetTrainer_1500epochs_NoMirroring__nnUNetPlans__3d_fullres/crossval_results_folds_0_1_2_3_4/PETCT_0168f65af8_04042003.nii.gz,/well/papiez/users/hri611/python/nnUnet_raw/Dataset219_PETCT/labelsTr/PETCT_0168f65af8_04042003.nii.gz,0.6006680026720107,0.0,11.79408787536621,2,6
6,6,0.7368421052631579,1,4,0.5833333333333334,99039988,7,11,8,/well/papiez/users/hri611/python/nnUNet_results/Dataset219_PETCT/nnUNetTrainer_1500epochs_NoMirroring__nnUNetPlans__3d_fullres/crossval_results_folds_0_1_2_3_4/PETCT_0223010e46_09042003.nii.gz,/well/papiez/users/hri611/python/nnUnet_raw/Dataset219_PETCT/labelsTr/PETCT_0223010e46_09042003.nii.gz,0.7368421052631579,0.0,0.0124410209655761,1,2
7,7,,0,0,,37120000,0,0,0,/well/papiez/users/hri611/python/nnUNet_results/Dataset219_PETCT/nnUNetTrainer_1500epochs_NoMirroring__nnUNetPlans__3d_fullres/crossval_results_folds_0_1_2_3_4/PETCT_0225325b91_08222005.nii.gz,/well/papiez/users/hri611/python/nnUnet_raw/Dataset219_PETCT/labelsTr/PETCT_0225325b91_08222005.nii.gz,,0.0,0.0,0,0
8,8,0.0,0,826,0.0,45439174,0,826,0,/well/papiez/users/hri611/python/nnUNet_results/Dataset219_PETCT/nnUNetTrainer_1500epochs_NoMirroring__nnUNetPlans__3d_fullres/crossval_results_folds_0_1_2_3_4/PETCT_0410759456_08222003.nii.gz,/well/papiez/users/hri611/python/nnUnet_raw/Dataset219_PETCT/labelsTr/PETCT_0410759456_08222003.nii.gz,0.0,10.276283317565918,0.0,3,0
9,9,,0,0,,45440000,0,0,0,/well/papiez/users/hri611/python/nnUNet_results/Dataset219_PETCT/nnUNetTrainer_1500epochs_NoMirroring__nnUNetPlans__3d_fullres/crossval_results_folds_0_1_2_3_4/PETCT_0410759456_11072002.nii.gz,/well/papiez/users/hri611/python/nnUnet_raw/Dataset219_PETCT/labelsTr/PETCT_0410759456_11072002.nii.gz,,0.0,0.0,0,0
10,10,0.8031764547534659,567,3820,0.6710901184585395,45426662,8951,12771,9518,/well/papiez/users/hri611/python/nnUNet_results/Dataset219_PETCT/nnUNetTrainer_1500epochs_NoMirroring__nnUNetPlans__3d_fullres/crossval_results_folds_0_1_2_3_4/PETCT_04606080a0_02202003.nii.gz,/well/papiez/users/hri611/python/nnUnet_raw/Dataset219_PETCT/labelsTr/PETCT_04606080a0_02202003.nii.gz,0.8031764547534659,4.901762260437011,0.0,11,2
11,11,0.9003032782939393,617,1454,0.8186832428646472,45428578,9351,10805,9968,/well/papiez/users/hri611/python/nnUNet_results/Dataset219_PETCT/nnUNetTrainer_1500epochs_NoMirroring__nnUNetPlans__3d_fullres/crossval_results_folds_0_1_2_3_4/PETCT_04a4e1c874_11182001.nii.gz,/well/papiez/users/hri611/python/nnUnet_raw/Dataset219_PETCT/labelsTr/PETCT_04a4e1c874_11182001.nii.gz,0.9003032782939393,11.40841622543335,0.0,9,2
12,12,0.845674740484429,683,432,0.7326139088729017,45435830,3055,3487,3738,/well/papiez/users/hri611/python/nnUNet_results/Dataset219_PETCT/nnUNetTrainer_1500epochs_NoMirroring__nnUNetPlans__3d_fullres/crossval_results_folds_0_1_2_3_4/PETCT_04ab5c61c9_11222002.nii.gz,/well/papiez/users/hri611/python/nnUnet_raw/Dataset219_PETCT/labelsTr/PETCT_04ab5c61c9_11222002.nii.gz,0.845674740484429,1.1196918869018555,0.0,5,3
13,13,0.0,0,64,0.0,51839936,0,64,0,/well/papiez/users/hri611/python/nnUNet_results/Dataset219_PETCT/nnUNetTrainer_1500epochs_NoMirroring__nnUNetPlans__3d_fullres/crossval_results_folds_0_1_2_3_4/PETCT_05808cf24e_03182006.nii.gz,/well/papiez/users/hri611/python/nnUnet_raw/Dataset219_PETCT/labelsTr/PETCT_05808cf24e_03182006.nii.gz,0.0,0.796225341796875,0.0,4,0
14,14,0.4860774160842959,12335,1858,0.3210715139918679,65579095,6712,8570,19047,/well/papiez/users/hri611/python/nnUNet_results/Dataset219_PETCT/nnUNetTrainer_1500epochs_NoMirroring__nnUNetPlans__3d_fullres/crossval_results_folds_0_1_2_3_4/PETCT_05808cf24e_07291999.nii.gz,/well/papiez/users/hri611/python/nnUnet_raw/Dataset219_PETCT/labelsTr/PETCT_05808cf24e_07291999.nii.gz,0.4860774160842959,21.560289333343505,77.8434681816101,13,18
15,15,0.0,0,8,0.0,52159992,0,8,0,/well/papiez/users/hri611/python/nnUNet_results/Dataset219_PETCT/nnUNetTrainer_1500epochs_NoMirroring__nnUNetPlans__3d_fullres/crossval_results_folds_0_1_2_3_4/PETCT_05bed31780_11242003.nii.gz,/well/papiez/users/hri611/python/nnUnet_raw/Dataset219_PETCT/labelsTr/PETCT_05bed31780_11242003.nii.gz,0.0,0.0995281677246093,0.0,2,0
16,16,0.0,0,273,0.0,92319727,0,273,0,/well/papiez/users/hri611/python/nnUNet_results/Dataset219_PETCT/nnUNetTrainer_1500epochs_NoMirroring__nnUNetPlans__3d_fullres/crossval_results_folds_0_1_2_3_4/PETCT_05d8640f52_02242005.nii.gz,/well/papiez/users/hri611/python/nnUnet_raw/Dataset219_PETCT/labelsTr/PETCT_05d8640f52_02242005.nii.gz,0.0,3.396398723602295,0.0,3,0
17,17,0.8312387791741472,0,188,0.7112135176651305,40639349,463,651,463,/well/papiez/users/hri611/python/nnUNet_results/Dataset219_PETCT/nnUNetTrainer_1500epochs_NoMirroring__nnUNetPlans__3d_fullres/crossval_results_folds_0_1_2_3_4/PETCT_06a46414eb_03122006.nii.gz,/well/papiez/users/hri611/python/nnUnet_raw/Dataset219_PETCT/labelsTr/PETCT_06a46414eb_03122006.nii.gz,0.8312387791741472,1.2067790336608886,0.0,3,1
18,18,0.0,0,68,0.0,38719932,0,68,0,/well/papiez/users/hri611/python/nnUNet_results/Dataset219_PETCT/nnUNetTrainer_1500epochs_NoMirroring__nnUNetPlans__3d_fullres/crossval_results_folds_0_1_2_3_4/PETCT_06d55e8295_04172003.nii.gz,/well/papiez/users/hri611/python/nnUnet_raw/Dataset219_PETCT/labelsTr/PETCT_06d55e8295_04172003.nii.gz,0.0,0.8459894256591797,0.0,9,0
19,19,0.6609118337244385,6004,2088,0.4935536362498435,45424022,7886,9974,13890,/well/papiez/users/hri611/python/nnUNet_results/Dataset219_PETCT/nnUNetTrainer_1500epochs_NoMirroring__nnUNetPlans__3d_fullres/crossval_results_folds_0_1_2_3_4/PETCT_06e7c24059_04222005.nii.gz,/well/papiez/users/hri611/python/nnUnet_raw/Dataset219_PETCT/labelsTr/PETCT_06e7c24059_04222005.nii.gz,0.6609118337244385,8.472335277557374,31.413577938079836,26,30
20,20,0.0,0,3436,0.0,38876564,0,3436,0,/well/papiez/users/hri611/python/nnUNet_results/Dataset219_PETCT/nnUNetTrainer_1500epochs_NoMirroring__nnUNetPlans__3d_fullres/crossval_results_folds_0_1_2_3_4/PETCT_072833774e_07232006.nii.gz,/well/papiez/users/hri611/python/nnUnet_raw/Dataset219_PETCT/labelsTr/PETCT_072833774e_07232006.nii.gz,0.0,42.747348037719725,0.0,5,0
21,21,0.9166749666341308,4611,3755,0.8461679905854663,45385616,46018,49773,50629,/well/papiez/users/hri611/python/nnUNet_results/Dataset219_PETCT/nnUNetTrainer_1500epochs_NoMirroring__nnUNetPlans__3d_fullres/crossval_results_folds_0_1_2_3_4/PETCT_07574bfa00_04202003.nii.gz,/well/papiez/users/hri611/python/nnUnet_raw/Dataset219_PETCT/labelsTr/PETCT_07574bfa00_04202003.nii.gz,0.9166749666341308,1.6297737464904785,0.3359075660705566,6,11
22,22,0.0,0,131,0.0,45439869,0,131,0,/well/papiez/users/hri611/python/nnUNet_results/Dataset219_PETCT/nnUNetTrainer_1500epochs_NoMirroring__nnUNetPlans__3d_fullres/crossval_results_folds_0_1_2_3_4/PETCT_07b7e9abfc_02102003.nii.gz,/well/papiez/users/hri611/python/nnUnet_raw/Dataset219_PETCT/labelsTr/PETCT_07b7e9abfc_02102003.nii.gz,0.0,1.6297737464904785,0.0,2,0
23,23,,0,0,,94080000,0,0,0,/well/papiez/users/hri611/python/nnUNet_results/Dataset219_PETCT/nnUNetTrainer_1500epochs_NoMirroring__nnUNetPlans__3d_fullres/crossval_results_folds_0_1_2_3_4/PETCT_07fec0d985_05042006.nii.gz,/well/papiez/users/hri611/python/nnUnet_raw/Dataset219_PETCT/labelsTr/PETCT_07fec0d985_05042006.nii.gz,,0.0,0.0,0,0
24,24,0.0,0,73,0.0,41439927,0,73,0,/well/papiez/users/hri611/python/nnUNet_results/Dataset219_PETCT/nnUNetTrainer_1500epochs_NoMirroring__nnUNetPlans__3d_fullres/crossval_results_folds_0_1_2_3_4/PETCT_080922db5a_01282006.nii.gz,/well/papiez/users/hri611/python/nnUnet_raw/Dataset219_PETCT/labelsTr/PETCT_080922db5a_01282006.nii.gz,0.0,0.9081945304870606,0.0,4,0
25,25,,0,0,,49440000,0,0,0,/well/papiez/users/hri611/python/nnUNet_results/Dataset219_PETCT/nnUNetTrainer_1500epochs_NoMirroring__nnUNetPlans__3d_fullres/crossval_results_folds_0_1_2_3_4/PETCT_08198c4f0c_11102005.nii.gz,/well/papiez/users/hri611/python/nnUnet_raw/Dataset219_PETCT/labelsTr/PETCT_08198c4f0c_11102005.nii.gz,,0.0,0.0,0,0
26,26,0.853230743774303,902,2646,0.7440300122646274,52146139,10313,12959,11215,/well/papiez/users/hri611/python/nnUNet_results/Dataset219_PETCT/nnUNetTrainer_1500epochs_NoMirroring__nnUNetPlans__3d_fullres/crossval_results_folds_0_1_2_3_4/PETCT_08212d7f6c_09112003.nii.gz,/well/papiez/users/hri611/python/nnUnet_raw/Dataset219_PETCT/labelsTr/PETCT_08212d7f6c_09112003.nii.gz,0.853230743774303,0.0870871467590332,0.0,3,2
27,27,0.0,0,1036,0.0,52158964,0,1036,0,/well/papiez/users/hri611/python/nnUNet_results/Dataset219_PETCT/nnUNetTrainer_1500epochs_NoMirroring__nnUNetPlans__3d_fullres/crossval_results_folds_0_1_2_3_4/PETCT_098c4b7b87_08312003.nii.gz,/well/papiez/users/hri611/python/nnUnet_raw/Dataset219_PETCT/labelsTr/PETCT_098c4b7b87_08312003.nii.gz,0.0,12.888897720336914,0.0,7,0
28,28,0.7205293685156442,1780,1641,0.5631464691610267,94872169,4410,6051,6190,/well/papiez/users/hri611/python/nnUNet_results/Dataset219_PETCT/nnUNetTrainer_1500epochs_NoMirroring__nnUNetPlans__3d_fullres/crossval_results_folds_0_1_2_3_4/PETCT_09ee00bdc6_09302005.nii.gz,/well/papiez/users/hri611/python/nnUnet_raw/Dataset219_PETCT/labelsTr/PETCT_09ee00bdc6_09302005.nii.gz,0.7205293685156442,2.6374964447021485,0.0,12,9
29,29,,0,0,,48640000,0,0,0,/well/papiez/users/hri611/python/nnUNet_results/Dataset219_PETCT/nnUNetTrainer_1500epochs_NoMirroring__nnUNetPlans__3d_fullres/crossval_results_folds_0_1_2_3_4/PETCT_0af7ffe12a_08122005.nii.gz,/well/papiez/users/hri611/python/nnUnet_raw/Dataset219_PETCT/labelsTr/PETCT_0af7ffe12a_08122005.nii.gz,,0.0,0.0,0,0
30,30,0.8231264780233222,2500,4007,0.6994179600886918,52138352,15141,19148,17641,/well/papiez/users/hri611/python/nnUNet_results/Dataset219_PETCT/nnUNetTrainer_1500epochs_NoMirroring__nnUNetPlans__3d_fullres/crossval_results_folds_0_1_2_3_4/PETCT_0b57b247b6_05022002.nii.gz,/well/papiez/users/hri611/python/nnUnet_raw/Dataset219_PETCT/labelsTr/PETCT_0b57b247b6_05022002.nii.gz,0.8231264780233222,6.220510482788086,0.0,12,4
31,31,0.8665888091230721,6210,1558,0.7645846592114435,52127003,25229,26787,31439,/well/papiez/users/hri611/python/nnUNet_results/Dataset219_PETCT/nnUNetTrainer_1500epochs_NoMirroring__nnUNetPlans__3d_fullres/crossval_results_folds_0_1_2_3_4/PETCT_0b98dbe00d_08112002.nii.gz,/well/papiez/users/hri611/python/nnUnet_raw/Dataset219_PETCT/labelsTr/PETCT_0b98dbe00d_08112002.nii.gz,0.8665888091230721,0.3981126708984375,9.8159655418396,21,21
32,32,0.9082098362966748,5845,4573,0.8318538364698667,52098042,51540,56113,57385,/well/papiez/users/hri611/python/nnUNet_results/Dataset219_PETCT/nnUNetTrainer_1500epochs_NoMirroring__nnUNetPlans__3d_fullres/crossval_results_folds_0_1_2_3_4/PETCT_0beb67c923_07251999.nii.gz,/well/papiez/users/hri611/python/nnUnet_raw/Dataset219_PETCT/labelsTr/PETCT_0beb67c923_07251999.nii.gz,0.9082098362966748,2.2145017318725584,0.149292251586914,9,13
33,33,0.0,0,13,0.0,52159987,0,13,0,/well/papiez/users/hri611/python/nnUNet_results/Dataset219_PETCT/nnUNetTrainer_1500epochs_NoMirroring__nnUNetPlans__3d_fullres/crossval_results_folds_0_1_2_3_4/PETCT_0c13e4df10_10112003.nii.gz,/well/papiez/users/hri611/python/nnUnet_raw/Dataset219_PETCT/labelsTr/PETCT_0c13e4df10_10112003.nii.gz,0.0,0.1617332725524902,0.0,3,0
34,34,0.4181745381051347,7204,23311,0.2643619970588944,52118519,10966,34277,18170,/well/papiez/users/hri611/python/nnUNet_results/Dataset219_PETCT/nnUNetTrainer_1500epochs_NoMirroring__nnUNetPlans__3d_fullres/crossval_results_folds_0_1_2_3_4/PETCT_0cda25453b_10122003.nii.gz,/well/papiez/users/hri611/python/nnUnet_raw/Dataset219_PETCT/labelsTr/PETCT_0cda25453b_10122003.nii.gz,0.4181745381051347,17.890188148498535,86.07942406082154,96,115
35,35,0.8060544118362778,3539,446,0.6751182129463558,45427734,8281,8727,11820,/well/papiez/users/hri611/python/nnUNet_results/Dataset219_PETCT/nnUNetTrainer_1500epochs_NoMirroring__nnUNetPlans__3d_fullres/crossval_results_folds_0_1_2_3_4/PETCT_0e2034240b_01312003.nii.gz,/well/papiez/users/hri611/python/nnUnet_raw/Dataset219_PETCT/labelsTr/PETCT_0e2034240b_01312003.nii.gz,0.8060544118362778,0.1119691886901855,12.441020965576172,3,5
36,36,,0,0,,52160000,0,0,0,/well/papiez/users/hri611/python/nnUNet_results/Dataset219_PETCT/nnUNetTrainer_1500epochs_NoMirroring__nnUNetPlans__3d_fullres/crossval_results_folds_0_1_2_3_4/PETCT_0e9a98ecda_02202003.nii.gz,/well/papiez/users/hri611/python/nnUnet_raw/Dataset219_PETCT/labelsTr/PETCT_0e9a98ecda_02202003.nii.gz,,0.0,0.0,0,0
37,37,0.8801375321629438,8039,2489,0.7859335922409061,52110819,38653,41142,46692,/well/papiez/users/hri611/python/nnUNet_results/Dataset219_PETCT/nnUNetTrainer_1500epochs_NoMirroring__nnUNetPlans__3d_fullres/crossval_results_folds_0_1_2_3_4/PETCT_0ea07b421b_10272001.nii.gz,/well/papiez/users/hri611/python/nnUnet_raw/Dataset219_PETCT/labelsTr/PETCT_0ea07b421b_10272001.nii.gz,0.8801375321629438,0.1119691886901855,37.63408842086792,21,27
38,38,0.4152249134948096,124,383,0.2620087336244541,45439313,180,563,304,/well/papiez/users/hri611/python/nnUNet_results/Dataset219_PETCT/nnUNetTrainer_1500epochs_NoMirroring__nnUNetPlans__3d_fullres/crossval_results_folds_0_1_2_3_4/PETCT_0f4ee9e078_02102005.nii.gz,/well/papiez/users/hri611/python/nnUnet_raw/Dataset219_PETCT/labelsTr/PETCT_0f4ee9e078_02102005.nii.gz,0.4152249134948096,4.167742023468017,1.530245578765869,5,2
39,39,0.6174698795180723,238,16,0.4466230936819172,45439541,205,221,443,/well/papiez/users/hri611/python/nnUNet_results/Dataset219_PETCT/nnUNetTrainer_1500epochs_NoMirroring__nnUNetPlans__3d_fullres/crossval_results_folds_0_1_2_3_4/PETCT_0fa313309d_04232005.nii.gz,/well/papiez/users/hri611/python/nnUnet_raw/Dataset219_PETCT/labelsTr/PETCT_0fa313309d_04232005.nii.gz,0.6174698795180723,0.0497640838623046,0.0,5,3
40,40,,0,0,,46080000,0,0,0,/well/papiez/users/hri611/python/nnUNet_results/Dataset219_PETCT/nnUNetTrainer_1500epochs_NoMirroring__nnUNetPlans__3d_fullres/crossval_results_folds_0_1_2_3_4/PETCT_0fa313309d_10032005.nii.gz,/well/papiez/users/hri611/python/nnUnet_raw/Dataset219_PETCT/labelsTr/PETCT_0fa313309d_10032005.nii.gz,,0.0,0.0,0,0
41,41,0.5368098159509203,47,255,0.3668763102725367,54079523,175,430,222,/well/papiez/users/hri611/python/nnUNet_results/Dataset219_PETCT/nnUNetTrainer_1500epochs_NoMirroring__nnUNetPlans__3d_fullres/crossval_results_folds_0_1_2_3_4/PETCT_1019ae8551_04062007.nii.gz,/well/papiez/users/hri611/python/nnUnet_raw/Dataset219_PETCT/labelsTr/PETCT_1019ae8551_04062007.nii.gz,0.5368098159509203,3.060491157531738,0.0,4,2
42,42,0.1639985335451546,6627,214,0.0893237486687966,45432488,671,885,7298,/well/papiez/users/hri611/python/nnUNet_results/Dataset219_PETCT/nnUNetTrainer_1500epochs_NoMirroring__nnUNetPlans__3d_fullres/crossval_results_folds_0_1_2_3_4/PETCT_108c1763d4_09302004.nii.gz,/well/papiez/users/hri611/python/nnUnet_raw/Dataset219_PETCT/labelsTr/PETCT_108c1763d4_09302004.nii.gz,0.1639985335451546,2.550409297943115,0.0124410209655761,6,2
43,43,0.6750291715285881,787,327,0.5094671950682519,45437729,1157,1484,1944,/well/papiez/users/hri611/python/nnUNet_results/Dataset219_PETCT/nnUNetTrainer_1500epochs_NoMirroring__nnUNetPlans__3d_fullres/crossval_results_folds_0_1_2_3_4/PETCT_119165872d_02122005.nii.gz,/well/papiez/users/hri611/python/nnUnet_raw/Dataset219_PETCT/labelsTr/PETCT_119165872d_02122005.nii.gz,0.6750291715285881,1.6546557884216309,1.891035186767578,7,9
44,44,0.0625,200,10,0.032258064516129,45439783,7,17,207,/well/papiez/users/hri611/python/nnUNet_results/Dataset219_PETCT/nnUNetTrainer_1500epochs_NoMirroring__nnUNetPlans__3d_fullres/crossval_results_folds_0_1_2_3_4/PETCT_11afab3485_05252003.nii.gz,/well/papiez/users/hri611/python/nnUnet_raw/Dataset219_PETCT/labelsTr/PETCT_11afab3485_05252003.nii.gz,0.0625,0.1244102096557617,1.2565431175231934,4,3
45,45,0.8475142248291923,4177,2764,0.735379336637438,45413770,19289,22053,23466,/well/papiez/users/hri611/python/nnUNet_results/Dataset219_PETCT/nnUNetTrainer_1500epochs_NoMirroring__nnUNetPlans__3d_fullres/crossval_results_folds_0_1_2_3_4/PETCT_11e258cc1f_03062003.nii.gz,/well/papiez/users/hri611/python/nnUnet_raw/Dataset219_PETCT/labelsTr/PETCT_11e258cc1f_03062003.nii.gz,0.8475142248291923,17.566721603393553,3.060491157531738,15,4
46,46,0.7578947368421053,227,3,0.6101694915254238,52159410,360,363,587,/well/papiez/users/hri611/python/nnUNet_results/Dataset219_PETCT/nnUNetTrainer_1500epochs_NoMirroring__nnUNetPlans__3d_fullres/crossval_results_folds_0_1_2_3_4/PETCT_12025abab5_11012004.nii.gz,/well/papiez/users/hri611/python/nnUnet_raw/Dataset219_PETCT/labelsTr/PETCT_12025abab5_11012004.nii.gz,0.7578947368421053,0.0248820419311523,0.0,7,5
47,47,0.8611471580586556,149,921,0.7561531449407475,104475612,3318,4239,3467,/well/papiez/users/hri611/python/nnUNet_results/Dataset219_PETCT/nnUNetTrainer_1500epochs_NoMirroring__nnUNetPlans__3d_fullres/crossval_results_folds_0_1_2_3_4/PETCT_1253499c80_10072005.nii.gz,/well/papiez/users/hri611/python/nnUnet_raw/Dataset219_PETCT/labelsTr/PETCT_1253499c80_10072005.nii.gz,0.8611471580586556,8.895329990386962,0.0,16,5
48,48,0.6588278508202808,80705,4746,0.4912328750811219,47832043,82506,87252,163211,/well/papiez/users/hri611/python/nnUNet_results/Dataset219_PETCT/nnUNetTrainer_1500epochs_NoMirroring__nnUNetPlans__3d_fullres/crossval_results_folds_0_1_2_3_4/PETCT_1285b86bea_02242006.nii.gz,/well/papiez/users/hri611/python/nnUnet_raw/Dataset219_PETCT/labelsTr/PETCT_1285b86bea_02242006.nii.gz,0.6588278508202808,9.044622241973876,229.23825231170653,544,1057
49,49,0.8091064772841745,1642,253,0.6794112671290814,58874089,4016,4269,5658,/well/papiez/users/hri611/python/nnUNet_results/Dataset219_PETCT/nnUNetTrainer_1500epochs_NoMirroring__nnUNetPlans__3d_fullres/crossval_results_folds_0_1_2_3_4/PETCT_1291700093_07132003.nii.gz,/well/papiez/users/hri611/python/nnUnet_raw/Dataset219_PETCT/labelsTr/PETCT_1291700093_07132003.nii.gz,0.8091064772841745,0.0622051048278808,0.6469330902099609,6,5
50,50,0.587222123150931,93450,1453,0.4156507068617309,51997592,67505,68958,160955,/well/papiez/users/hri611/python/nnUNet_results/Dataset219_PETCT/nnUNetTrainer_1500epochs_NoMirroring__nnUNetPlans__3d_fullres/crossval_results_folds_0_1_2_3_4/PETCT_13b40a817b_02182001.nii.gz,/well/papiez/users/hri611/python/nnUnet_raw/Dataset219_PETCT/labelsTr/PETCT_13b40a817b_02182001.nii.gz,0.587222123150931,5.94680802154541,77.52000163650513,103,95
51,51,0.8971974522292994,167,1447,0.8135612798891071,85591343,7043,8490,7210,/well/papiez/users/hri611/python/nnUNet_results/Dataset219_PETCT/nnUNetTrainer_1500epochs_NoMirroring__nnUNetPlans__3d_fullres/crossval_results_folds_0_1_2_3_4/PETCT_13f476b02b_11192001.nii.gz,/well/papiez/users/hri611/python/nnUnet_raw/Dataset219_PETCT/labelsTr/PETCT_13f476b02b_11192001.nii.gz,0.8971974522292994,2.003004375457764,0.0,4,2
52,52,,0,0,,105760000,0,0,0,/well/papiez/users/hri611/python/nnUNet_results/Dataset219_PETCT/nnUNetTrainer_1500epochs_NoMirroring__nnUNetPlans__3d_fullres/crossval_results_folds_0_1_2_3_4/PETCT_141fffa2a9_03012003.nii.gz,/well/papiez/users/hri611/python/nnUnet_raw/Dataset219_PETCT/labelsTr/PETCT_141fffa2a9_03012003.nii.gz,,0.0,0.0,0,0
53,53,0.8299733500548675,8900,1946,0.7093627739964629,52122682,26472,28418,35372,/well/papiez/users/hri611/python/nnUNet_results/Dataset219_PETCT/nnUNetTrainer_1500epochs_NoMirroring__nnUNetPlans__3d_fullres/crossval_results_folds_0_1_2_3_4/PETCT_1472967bef_12212002.nii.gz,/well/papiez/users/hri611/python/nnUnet_raw/Dataset219_PETCT/labelsTr/PETCT_1472967bef_12212002.nii.gz,0.8299733500548675,0.4603177757263184,0.0,12,10
54,54,0.8860695949800342,4002,991,0.7954443033307387,52135591,19416,20407,23418,/well/papiez/users/hri611/python/nnUNet_results/Dataset219_PETCT/nnUNetTrainer_1500epochs_NoMirroring__nnUNetPlans__3d_fullres/crossval_results_folds_0_1_2_3_4/PETCT_147a9fcff3_08162001.nii.gz,/well/papiez/users/hri611/python/nnUnet_raw/Dataset219_PETCT/labelsTr/PETCT_147a9fcff3_08162001.nii.gz,0.8860695949800342,1.2814251594543458,3.9935677299499512,5,3
55,55,0.0,0,371,0.0,45439629,0,371,0,/well/papiez/users/hri611/python/nnUNet_results/Dataset219_PETCT/nnUNetTrainer_1500epochs_NoMirroring__nnUNetPlans__3d_fullres/crossval_results_folds_0_1_2_3_4/PETCT_14929994cf_04302005.nii.gz,/well/papiez/users/hri611/python/nnUnet_raw/Dataset219_PETCT/labelsTr/PETCT_14929994cf_04302005.nii.gz,0.0,4.61561877822876,0.0,3,0
56,56,0.8058224163027656,658,9,0.6747927840078011,52157949,1384,1393,2042,/well/papiez/users/hri611/python/nnUNet_results/Dataset219_PETCT/nnUNetTrainer_1500epochs_NoMirroring__nnUNetPlans__3d_fullres/crossval_results_folds_0_1_2_3_4/PETCT_14c4d2c208_09222002.nii.gz,/well/papiez/users/hri611/python/nnUnet_raw/Dataset219_PETCT/labelsTr/PETCT_14c4d2c208_09222002.nii.gz,0.8058224163027656,0.0373230628967285,1.157014949798584,4,4
57,57,0.862992125984252,2541,243,0.7590027700831025,52148448,8768,9011,11309,/well/papiez/users/hri611/python/nnUNet_results/Dataset219_PETCT/nnUNetTrainer_1500epochs_NoMirroring__nnUNetPlans__3d_fullres/crossval_results_folds_0_1_2_3_4/PETCT_154e94256c_11252000.nii.gz,/well/papiez/users/hri611/python/nnUnet_raw/Dataset219_PETCT/labelsTr/PETCT_154e94256c_11252000.nii.gz,0.862992125984252,0.5598459434509278,2.712142570495605,7,5
58,58,,0,0,,50400000,0,0,0,/well/papiez/users/hri611/python/nnUNet_results/Dataset219_PETCT/nnUNetTrainer_1500epochs_NoMirroring__nnUNetPlans__3d_fullres/crossval_results_folds_0_1_2_3_4/PETCT_1553bd8c8f_06142007.nii.gz,/well/papiez/users/hri611/python/nnUnet_raw/Dataset219_PETCT/labelsTr/PETCT_1553bd8c8f_06142007.nii.gz,,0.0,0.0,0,0
59,59,0.566845035755141,76643,3252,0.3955225009835669,52187828,52277,55529,128920,/well/papiez/users/hri611/python/nnUNet_results/Dataset219_PETCT/nnUNetTrainer_1500epochs_NoMirroring__nnUNetPlans__3d_fullres/crossval_results_folds_0_1_2_3_4/PETCT_15a205ffcc_08192005.nii.gz,/well/papiez/users/hri611/python/nnUnet_raw/Dataset219_PETCT/labelsTr/PETCT_15a205ffcc_08192005.nii.gz,0.566845035755141,1.5551276206970217,56.46979416275024,40,50
60,60,0.9022584965072932,4856,5946,0.8219225506520055,45379341,49857,55803,54713,/well/papiez/users/hri611/python/nnUNet_results/Dataset219_PETCT/nnUNetTrainer_1500epochs_NoMirroring__nnUNetPlans__3d_fullres/crossval_results_folds_0_1_2_3_4/PETCT_15cfa01130_02242001.nii.gz,/well/papiez/users/hri611/python/nnUnet_raw/Dataset219_PETCT/labelsTr/PETCT_15cfa01130_02242001.nii.gz,0.9022584965072932,1.231661075592041,4.976408386230469,17,12
61,61,0.9376169920158918,1006,627,0.8825602301330456,45426095,12272,12899,13278,/well/papiez/users/hri611/python/nnUNet_results/Dataset219_PETCT/nnUNetTrainer_1500epochs_NoMirroring__nnUNetPlans__3d_fullres/crossval_results_folds_0_1_2_3_4/PETCT_15f4b7254f_07182003.nii.gz,/well/papiez/users/hri611/python/nnUnet_raw/Dataset219_PETCT/labelsTr/PETCT_15f4b7254f_07182003.nii.gz,0.9376169920158918,5.934367000579834,0.149292251586914,7,6
62,62,0.3684210526315789,0,168,0.2258064516129032,45439783,49,217,49,/well/papiez/users/hri611/python/nnUNet_results/Dataset219_PETCT/nnUNetTrainer_1500epochs_NoMirroring__nnUNetPlans__3d_fullres/crossval_results_folds_0_1_2_3_4/PETCT_15f4b7254f_10112003.nii.gz,/well/papiez/users/hri611/python/nnUnet_raw/Dataset219_PETCT/labelsTr/PETCT_15f4b7254f_10112003.nii.gz,0.3684210526315789,1.6919788513183591,0.0,6,1
63,63,0.8328258051712055,26283,672,0.7135402828995611,45505903,67142,67814,93425,/well/papiez/users/hri611/python/nnUNet_results/Dataset219_PETCT/nnUNetTrainer_1500epochs_NoMirroring__nnUNetPlans__3d_fullres/crossval_results_folds_0_1_2_3_4/PETCT_16cdbc8689_07152005.nii.gz,/well/papiez/users/hri611/python/nnUnet_raw/Dataset219_PETCT/labelsTr/PETCT_16cdbc8689_07152005.nii.gz,0.8328258051712055,4.018449771881103,2.674819507598877,13,22
64,64,0.0,0,105,0.0,92319895,0,105,0,/well/papiez/users/hri611/python/nnUNet_results/Dataset219_PETCT/nnUNetTrainer_1500epochs_NoMirroring__nnUNetPlans__3d_fullres/crossval_results_folds_0_1_2_3_4/PETCT_173b804eda_10112004.nii.gz,/well/papiez/users/hri611/python/nnUnet_raw/Dataset219_PETCT/labelsTr/PETCT_173b804eda_10112004.nii.gz,0.0,1.306307201385498,0.0,4,0
65,65,0.0,0,17,0.0,43839983,0,17,0,/well/papiez/users/hri611/python/nnUNet_results/Dataset219_PETCT/nnUNetTrainer_1500epochs_NoMirroring__nnUNetPlans__3d_fullres/crossval_results_folds_0_1_2_3_4/PETCT_176bdc5388_06222006.nii.gz,/well/papiez/users/hri611/python/nnUnet_raw/Dataset219_PETCT/labelsTr/PETCT_176bdc5388_06222006.nii.gz,0.0,0.2114973564147949,0.0,2,0
66,66,0.0,0,201,0.0,49119799,0,201,0,/well/papiez/users/hri611/python/nnUNet_results/Dataset219_PETCT/nnUNetTrainer_1500epochs_NoMirroring__nnUNetPlans__3d_fullres/crossval_results_folds_0_1_2_3_4/PETCT_1774857f8e_11232006.nii.gz,/well/papiez/users/hri611/python/nnUnet_raw/Dataset219_PETCT/labelsTr/PETCT_1774857f8e_11232006.nii.gz,0.0,2.5006452140808104,0.0,3,0
67,67,0.0,0,404,0.0,45439596,0,404,0,/well/papiez/users/hri611/python/nnUNet_results/Dataset219_PETCT/nnUNetTrainer_1500epochs_NoMirroring__nnUNetPlans__3d_fullres/crossval_results_folds_0_1_2_3_4/PETCT_1781ba966c_08082002.nii.gz,/well/papiez/users/hri611/python/nnUnet_raw/Dataset219_PETCT/labelsTr/PETCT_1781ba966c_08082002.nii.gz,0.0,5.0261724700927735,0.0,3,0
68,68,0.0,0,437,0.0,38719563,0,437,0,/well/papiez/users/hri611/python/nnUNet_results/Dataset219_PETCT/nnUNetTrainer_1500epochs_NoMirroring__nnUNetPlans__3d_fullres/crossval_results_folds_0_1_2_3_4/PETCT_17b46d7275_11132003.nii.gz,/well/papiez/users/hri611/python/nnUnet_raw/Dataset219_PETCT/labelsTr/PETCT_17b46d7275_11132003.nii.gz,0.0,5.436726161956787,0.0,2,0
69,69,0.8714676390154968,1086,5682,0.7722132471728594,52130288,22944,28626,24030,/well/papiez/users/hri611/python/nnUNet_results/Dataset219_PETCT/nnUNetTrainer_1500epochs_NoMirroring__nnUNetPlans__3d_fullres/crossval_results_folds_0_1_2_3_4/PETCT_17d334cb6c_08282000.nii.gz,/well/papiez/users/hri611/python/nnUnet_raw/Dataset219_PETCT/labelsTr/PETCT_17d334cb6c_08282000.nii.gz,0.8714676390154968,35.12100218582153,0.0,6,2
70,70,0.0,0,735,0.0,49439265,0,735,0,/well/papiez/users/hri611/python/nnUNet_results/Dataset219_PETCT/nnUNetTrainer_1500epochs_NoMirroring__nnUNetPlans__3d_fullres/crossval_results_folds_0_1_2_3_4/PETCT_182bdeba22_05102007.nii.gz,/well/papiez/users/hri611/python/nnUnet_raw/Dataset219_PETCT/labelsTr/PETCT_182bdeba22_05102007.nii.gz,0.0,9.144150409698486,0.0,12,0
71,71,0.0,0,61,0.0,52159939,0,61,0,/well/papiez/users/hri611/python/nnUNet_results/Dataset219_PETCT/nnUNetTrainer_1500epochs_NoMirroring__nnUNetPlans__3d_fullres/crossval_results_folds_0_1_2_3_4/PETCT_185bac7954_01222005.nii.gz,/well/papiez/users/hri611/python/nnUnet_raw/Dataset219_PETCT/labelsTr/PETCT_185bac7954_01222005.nii.gz,0.0,0.7589022789001465,0.0,5,0
72,72,0.773553373720493,38,2130,0.6307273036961335,52154129,3703,5833,3741,/well/papiez/users/hri611/python/nnUNet_results/Dataset219_PETCT/nnUNetTrainer_1500epochs_NoMirroring__nnUNetPlans__3d_fullres/crossval_results_folds_0_1_2_3_4/PETCT_185da4c8b6_04182003.nii.gz,/well/papiez/users/hri611/python/nnUnet_raw/Dataset219_PETCT/labelsTr/PETCT_185da4c8b6_04182003.nii.gz,0.773553373720493,0.1990563354492187,0.1368512306213379,6,9
73,73,0.9546891464699684,0,43,0.9133064516129032,52319504,453,496,453,/well/papiez/users/hri611/python/nnUNet_results/Dataset219_PETCT/nnUNetTrainer_1500epochs_NoMirroring__nnUNetPlans__3d_fullres/crossval_results_folds_0_1_2_3_4/PETCT_18e8b02af3_08142005.nii.gz,/well/papiez/users/hri611/python/nnUnet_raw/Dataset219_PETCT/labelsTr/PETCT_18e8b02af3_08142005.nii.gz,0.9546891464699684,0.0,0.0,1,1
74,74,0.0,0,203,0.0,99039797,0,203,0,/well/papiez/users/hri611/python/nnUNet_results/Dataset219_PETCT/nnUNetTrainer_1500epochs_NoMirroring__nnUNetPlans__3d_fullres/crossval_results_folds_0_1_2_3_4/PETCT_1928952a0f_06202003.nii.gz,/well/papiez/users/hri611/python/nnUnet_raw/Dataset219_PETCT/labelsTr/PETCT_1928952a0f_06202003.nii.gz,0.0,2.525527256011963,0.0,6,0
75,75,0.0,0,384,0.0,38719616,0,384,0,/well/papiez/users/hri611/python/nnUNet_results/Dataset219_PETCT/nnUNetTrainer_1500epochs_NoMirroring__nnUNetPlans__3d_fullres/crossval_results_folds_0_1_2_3_4/PETCT_193dea6ac7_04102003.nii.gz,/well/papiez/users/hri611/python/nnUnet_raw/Dataset219_PETCT/labelsTr/PETCT_193dea6ac7_04102003.nii.gz,0.0,4.77735205078125,0.0,5,0
76,76,0.0,0,33,0.0,45119967,0,33,0,/well/papiez/users/hri611/python/nnUNet_results/Dataset219_PETCT/nnUNetTrainer_1500epochs_NoMirroring__nnUNetPlans__3d_fullres/crossval_results_folds_0_1_2_3_4/PETCT_1956667fce_02102006.nii.gz,/well/papiez/users/hri611/python/nnUnet_raw/Dataset219_PETCT/labelsTr/PETCT_1956667fce_02102006.nii.gz,0.0,0.4105536918640137,0.0,1,0
77,77,0.9120901808572136,1573,11201,0.8383876722207462,47440959,66267,77468,67840,/well/papiez/users/hri611/python/nnUNet_results/Dataset219_PETCT/nnUNetTrainer_1500epochs_NoMirroring__nnUNetPlans__3d_fullres/crossval_results_folds_0_1_2_3_4/PETCT_1956667fce_07282005.nii.gz,/well/papiez/users/hri611/python/nnUnet_raw/Dataset219_PETCT/labelsTr/PETCT_1956667fce_07282005.nii.gz,0.9120901808572136,4.503649589538574,4.516090610504151,48,64
78,78,0.0075431669514997,16607,234,0.0037858621709553,52143095,64,298,16671,/well/papiez/users/hri611/python/nnUNet_results/Dataset219_PETCT/nnUNetTrainer_1500epochs_NoMirroring__nnUNetPlans__3d_fullres/crossval_results_folds_0_1_2_3_4/PETCT_19838cb8e5_07292002.nii.gz,/well/papiez/users/hri611/python/nnUnet_raw/Dataset219_PETCT/labelsTr/PETCT_19838cb8e5_07292002.nii.gz,0.0075431669514997,2.911198905944824,205.37637409973144,5,5
79,79,0.7486797373445723,25642,1341,0.5983118468455058,52092826,40191,41532,65833,/well/papiez/users/hri611/python/nnUNet_results/Dataset219_PETCT/nnUNetTrainer_1500epochs_NoMirroring__nnUNetPlans__3d_fullres/crossval_results_folds_0_1_2_3_4/PETCT_19b68a666b_04142005.nii.gz,/well/papiez/users/hri611/python/nnUnet_raw/Dataset219_PETCT/labelsTr/PETCT_19b68a666b_04142005.nii.gz,0.7486797373445723,1.0077226982116698,2.1398556060791014,6,13
80,80,0.0,1112,768,0.0,52158120,0,768,1112,/well/papiez/users/hri611/python/nnUNet_results/Dataset219_PETCT/nnUNetTrainer_1500epochs_NoMirroring__nnUNetPlans__3d_fullres/crossval_results_folds_0_1_2_3_4/PETCT_1a1712f7d0_02142005.nii.gz,/well/papiez/users/hri611/python/nnUnet_raw/Dataset219_PETCT/labelsTr/PETCT_1a1712f7d0_02142005.nii.gz,0.0,9.5547041015625,13.834415313720704,5,2
81,81,0.9242520687460216,103,16,0.8591715976331361,50399155,726,742,829,/well/papiez/users/hri611/python/nnUNet_results/Dataset219_PETCT/nnUNetTrainer_1500epochs_NoMirroring__nnUNetPlans__3d_fullres/crossval_results_folds_0_1_2_3_4/PETCT_1a1712f7d0_02162007.nii.gz,/well/papiez/users/hri611/python/nnUnet_raw/Dataset219_PETCT/labelsTr/PETCT_1a1712f7d0_02162007.nii.gz,0.9242520687460216,0.0497640838623046,0.0,2,1
82,82,0.6327935976177183,2021,1925,0.4628369180506398,52152654,3400,5325,5421,/well/papiez/users/hri611/python/nnUNet_results/Dataset219_PETCT/nnUNetTrainer_1500epochs_NoMirroring__nnUNetPlans__3d_fullres/crossval_results_folds_0_1_2_3_4/PETCT_1a1712f7d0_07052001.nii.gz,/well/papiez/users/hri611/python/nnUnet_raw/Dataset219_PETCT/labelsTr/PETCT_1a1712f7d0_07052001.nii.gz,0.6327935976177183,23.053211849212644,4.628059799194336,6,5
83,83,0.0,0,1974,0.0,52158026,0,1974,0,/well/papiez/users/hri611/python/nnUNet_results/Dataset219_PETCT/nnUNetTrainer_1500epochs_NoMirroring__nnUNetPlans__3d_fullres/crossval_results_folds_0_1_2_3_4/PETCT_1a3d4e63ee_07032004.nii.gz,/well/papiez/users/hri611/python/nnUnet_raw/Dataset219_PETCT/labelsTr/PETCT_1a3d4e63ee_07032004.nii.gz,0.0,24.55857538604736,0.0,12,0
84,84,,0,0,,45120000,0,0,0,/well/papiez/users/hri611/python/nnUNet_results/Dataset219_PETCT/nnUNetTrainer_1500epochs_NoMirroring__nnUNetPlans__3d_fullres/crossval_results_folds_0_1_2_3_4/PETCT_1a8bd52f71_05052006.nii.gz,/well/papiez/users/hri611/python/nnUnet_raw/Dataset219_PETCT/labelsTr/PETCT_1a8bd52f71_05052006.nii.gz,,0.0,0.0,0,0
85,85,0.4997573993207181,245,786,0.333117723156533,58878454,515,1301,760,/well/papiez/users/hri611/python/nnUNet_results/Dataset219_PETCT/nnUNetTrainer_1500epochs_NoMirroring__nnUNetPlans__3d_fullres/crossval_results_folds_0_1_2_3_4/PETCT_1a90052cb2_06222001.nii.gz,/well/papiez/users/hri611/python/nnUnet_raw/Dataset219_PETCT/labelsTr/PETCT_1a90052cb2_06222001.nii.gz,0.4997573993207181,9.703996353149414,0.0,5,1
86,86,0.0,0,153,0.0,52159847,0,153,0,/well/papiez/users/hri611/python/nnUNet_results/Dataset219_PETCT/nnUNetTrainer_1500epochs_NoMirroring__nnUNetPlans__3d_fullres/crossval_results_folds_0_1_2_3_4/PETCT_1a90052cb2_09062003.nii.gz,/well/papiez/users/hri611/python/nnUnet_raw/Dataset219_PETCT/labelsTr/PETCT_1a90052cb2_09062003.nii.gz,0.0,1.9034762077331544,0.0,4,0
87,87,,0,0,,45440000,0,0,0,/well/papiez/users/hri611/python/nnUNet_results/Dataset219_PETCT/nnUNetTrainer_1500epochs_NoMirroring__nnUNetPlans__3d_fullres/crossval_results_folds_0_1_2_3_4/PETCT_1ac497ed9d_10282004.nii.gz,/well/papiez/users/hri611/python/nnUnet_raw/Dataset219_PETCT/labelsTr/PETCT_1ac497ed9d_10282004.nii.gz,,0.0,0.0,0,0
88,88,0.1197183098591549,275,225,0.0636704119850187,58879466,34,259,309,/well/papiez/users/hri611/python/nnUNet_results/Dataset219_PETCT/nnUNetTrainer_1500epochs_NoMirroring__nnUNetPlans__3d_fullres/crossval_results_folds_0_1_2_3_4/PETCT_1b199d094d_03162002.nii.gz,/well/papiez/users/hri611/python/nnUnet_raw/Dataset219_PETCT/labelsTr/PETCT_1b199d094d_03162002.nii.gz,0.1197183098591549,2.2269427528381347,3.3590756607055665,7,3
89,89,0.8664646237886782,1247,2322,0.7643913387905994,52144852,11579,13901,12826,/well/papiez/users/hri611/python/nnUNet_results/Dataset219_PETCT/nnUNetTrainer_1500epochs_NoMirroring__nnUNetPlans__3d_fullres/crossval_results_folds_0_1_2_3_4/PETCT_1b1bdfc35b_10292000.nii.gz,/well/papiez/users/hri611/python/nnUnet_raw/Dataset219_PETCT/labelsTr/PETCT_1b1bdfc35b_10292000.nii.gz,0.8664646237886782,14.033471649169922,1.1196918869018555,37,35
90,90,0.8122675299628048,10012,890,0.6838808826514339,52125513,23585,24475,33597,/well/papiez/users/hri611/python/nnUNet_results/Dataset219_PETCT/nnUNetTrainer_1500epochs_NoMirroring__nnUNetPlans__3d_fullres/crossval_results_folds_0_1_2_3_4/PETCT_1bb48bfb40_12022000.nii.gz,/well/papiez/users/hri611/python/nnUnet_raw/Dataset219_PETCT/labelsTr/PETCT_1bb48bfb40_12022000.nii.gz,0.8122675299628048,0.074646125793457,3.035609115600586,30,32
91,91,0.0,0,2,0.0,52159998,0,2,0,/well/papiez/users/hri611/python/nnUNet_results/Dataset219_PETCT/nnUNetTrainer_1500epochs_NoMirroring__nnUNetPlans__3d_fullres/crossval_results_folds_0_1_2_3_4/PETCT_1bdefef7d5_01142006.nii.gz,/well/papiez/users/hri611/python/nnUnet_raw/Dataset219_PETCT/labelsTr/PETCT_1bdefef7d5_01142006.nii.gz,0.0,0.0248820419311523,0.0,1,0
92,92,,0,0,,52800000,0,0,0,/well/papiez/users/hri611/python/nnUNet_results/Dataset219_PETCT/nnUNetTrainer_1500epochs_NoMirroring__nnUNetPlans__3d_fullres/crossval_results_folds_0_1_2_3_4/PETCT_1cb2d26a19_06042007.nii.gz,/well/papiez/users/hri611/python/nnUnet_raw/Dataset219_PETCT/labelsTr/PETCT_1cb2d26a19_06042007.nii.gz,,0.0,0.0,0,0
93,93,,0,0,,47520000,0,0,0,/well/papiez/users/hri611/python/nnUNet_results/Dataset219_PETCT/nnUNetTrainer_1500epochs_NoMirroring__nnUNetPlans__3d_fullres/crossval_results_folds_0_1_2_3_4/PETCT_1f2a4f4280_06122005.nii.gz,/well/papiez/users/hri611/python/nnUnet_raw/Dataset219_PETCT/labelsTr/PETCT_1f2a4f4280_06122005.nii.gz,,0.0,0.0,0,0
94,94,,0,0,,52160000,0,0,0,/well/papiez/users/hri611/python/nnUNet_results/Dataset219_PETCT/nnUNetTrainer_1500epochs_NoMirroring__nnUNetPlans__3d_fullres/crossval_results_folds_0_1_2_3_4/PETCT_1f2a4f4280_12202002.nii.gz,/well/papiez/users/hri611/python/nnUnet_raw/Dataset219_PETCT/labelsTr/PETCT_1f2a4f4280_12202002.nii.gz,,0.0,0.0,0,0
95,95,0.5846153846153846,20,7,0.4130434782608695,105759954,19,26,39,/well/papiez/users/hri611/python/nnUNet_results/Dataset219_PETCT/nnUNetTrainer_1500epochs_NoMirroring__nnUNetPlans__3d_fullres/crossval_results_folds_0_1_2_3_4/PETCT_1f65acff65_05062007.nii.gz,/well/papiez/users/hri611/python/nnUnet_raw/Dataset219_PETCT/labelsTr/PETCT_1f65acff65_05062007.nii.gz,0.5846153846153846,0.0870871467590332,0.0,4,1
96,96,0.0,0,3,0.0,52159997,0,3,0,/well/papiez/users/hri611/python/nnUNet_results/Dataset219_PETCT/nnUNetTrainer_1500epochs_NoMirroring__nnUNetPlans__3d_fullres/crossval_results_folds_0_1_2_3_4/PETCT_1fa22c576e_10172004.nii.gz,/well/papiez/users/hri611/python/nnUnet_raw/Dataset219_PETCT/labelsTr/PETCT_1fa22c576e_10172004.nii.gz,0.0,0.0373230628967285,0.0,1,0
97,97,0.9413854351687388,21,441,0.889261744966443,52155828,3710,4151,3731,/well/papiez/users/hri611/python/nnUNet_results/Dataset219_PETCT/nnUNetTrainer_1500epochs_NoMirroring__nnUNetPlans__3d_fullres/crossval_results_folds_0_1_2_3_4/PETCT_1fc35d02da_08092003.nii.gz,/well/papiez/users/hri611/python/nnUnet_raw/Dataset219_PETCT/labelsTr/PETCT_1fc35d02da_08092003.nii.gz,0.9413854351687388,0.5971690063476562,0.0,4,1
98,98,0.8873913683900427,350,2708,0.7975772820546766,58864893,12049,14757,12399,/well/papiez/users/hri611/python/nnUNet_results/Dataset219_PETCT/nnUNetTrainer_1500epochs_NoMirroring__nnUNetPlans__3d_fullres/crossval_results_folds_0_1_2_3_4/PETCT_1fcfa34d10_09192003.nii.gz,/well/papiez/users/hri611/python/nnUnet_raw/Dataset219_PETCT/labelsTr/PETCT_1fcfa34d10_09192003.nii.gz,0.8873913683900427,0.1741742935180664,0.0,3,2
99,99,0.8557502565316916,1224,6086,0.7478701755596179,52131007,21683,27769,22907,/well/papiez/users/hri611/python/nnUNet_results/Dataset219_PETCT/nnUNetTrainer_1500epochs_NoMirroring__nnUNetPlans__3d_fullres/crossval_results_folds_0_1_2_3_4/PETCT_1fe6e48293_06262003.nii.gz,/well/papiez/users/hri611/python/nnUnet_raw/Dataset219_PETCT/labelsTr/PETCT_1fe6e48293_06262003.nii.gz,0.8557502565316916,2.550409297943115,0.1741742935180664,16,17
100,100,0.9523110785033015,1,64,0.9089635854341735,55199286,649,713,650,/well/papiez/users/hri611/python/nnUNet_results/Dataset219_PETCT/nnUNetTrainer_1500epochs_NoMirroring__nnUNetPlans__3d_fullres/crossval_results_folds_0_1_2_3_4/PETCT_20995a0fe1_12022005.nii.gz,/well/papiez/users/hri611/python/nnUnet_raw/Dataset219_PETCT/labelsTr/PETCT_20995a0fe1_12022005.nii.gz,0.9523110785033015,0.0124410209655761,0.0,2,1
101,101,,0,0,,45440000,0,0,0,/well/papiez/users/hri611/python/nnUNet_results/Dataset219_PETCT/nnUNetTrainer_1500epochs_NoMirroring__nnUNetPlans__3d_fullres/crossval_results_folds_0_1_2_3_4/PETCT_20f4a3aa02_03172005.nii.gz,/well/papiez/users/hri611/python/nnUnet_raw/Dataset219_PETCT/labelsTr/PETCT_20f4a3aa02_03172005.nii.gz,,0.0,0.0,0,0
102,102,0.0,0,486,0.0,43519514,0,486,0,/well/papiez/users/hri611/python/nnUNet_results/Dataset219_PETCT/nnUNetTrainer_1500epochs_NoMirroring__nnUNetPlans__3d_fullres/crossval_results_folds_0_1_2_3_4/PETCT_2122b88719_09092006.nii.gz,/well/papiez/users/hri611/python/nnUnet_raw/Dataset219_PETCT/labelsTr/PETCT_2122b88719_09092006.nii.gz,0.0,6.046336189270019,0.0,3,0
103,103,0.4652389413635088,56170,1012,0.3031344447694257,54637944,24874,25886,81044,/well/papiez/users/hri611/python/nnUNet_results/Dataset219_PETCT/nnUNetTrainer_1500epochs_NoMirroring__nnUNetPlans__3d_fullres/crossval_results_folds_0_1_2_3_4/PETCT_2140db0ca5_04132007.nii.gz,/well/papiez/users/hri611/python/nnUnet_raw/Dataset219_PETCT/labelsTr/PETCT_2140db0ca5_04132007.nii.gz,0.4652389413635088,0.0124410209655761,66.5719031867981,13,8
104,104,0.8612351190476191,470,276,0.7562887945115975,52156939,2315,2591,2785,/well/papiez/users/hri611/python/nnUNet_results/Dataset219_PETCT/nnUNetTrainer_1500epochs_NoMirroring__nnUNetPlans__3d_fullres/crossval_results_folds_0_1_2_3_4/PETCT_21853fc15b_10122002.nii.gz,/well/papiez/users/hri611/python/nnUnet_raw/Dataset219_PETCT/labelsTr/PETCT_21853fc15b_10122002.nii.gz,0.8612351190476191,1.3311892433166503,0.0124410209655761,5,3
105,105,0.7997360814377278,4809,1565,0.6663001937071358,45420899,12727,14292,17536,/well/papiez/users/hri611/python/nnUNet_results/Dataset219_PETCT/nnUNetTrainer_1500epochs_NoMirroring__nnUNetPlans__3d_fullres/crossval_results_folds_0_1_2_3_4/PETCT_21e4ffcb52_05062002.nii.gz,/well/papiez/users/hri611/python/nnUnet_raw/Dataset219_PETCT/labelsTr/PETCT_21e4ffcb52_05062002.nii.gz,0.7997360814377278,0.2612614402770996,4.61561877822876,5,8
106,106,0.817630408410837,925,1781,0.6915184678522572,45431228,6066,7847,6991,/well/papiez/users/hri611/python/nnUNet_results/Dataset219_PETCT/nnUNetTrainer_1500epochs_NoMirroring__nnUNetPlans__3d_fullres/crossval_results_folds_0_1_2_3_4/PETCT_2202a936e0_05312002.nii.gz,/well/papiez/users/hri611/python/nnUnet_raw/Dataset219_PETCT/labelsTr/PETCT_2202a936e0_05312002.nii.gz,0.817630408410837,0.796225341796875,0.58472798538208,15,19
107,107,0.8267090620031796,12,424,0.7046070460704607,45438524,1040,1464,1052,/well/papiez/users/hri611/python/nnUNet_results/Dataset219_PETCT/nnUNetTrainer_1500epochs_NoMirroring__nnUNetPlans__3d_fullres/crossval_results_folds_0_1_2_3_4/PETCT_223f70f0b0_11292003.nii.gz,/well/papiez/users/hri611/python/nnUnet_raw/Dataset219_PETCT/labelsTr/PETCT_223f70f0b0_11292003.nii.gz,0.8267090620031796,1.9407992706298829,0.0,5,1
108,108,0.8243375858684985,312,46,0.7011686143572621,45438802,840,886,1152,/well/papiez/users/hri611/python/nnUNet_results/Dataset219_PETCT/nnUNetTrainer_1500epochs_NoMirroring__nnUNetPlans__3d_fullres/crossval_results_folds_0_1_2_3_4/PETCT_22d07bdc49_01052003.nii.gz,/well/papiez/users/hri611/python/nnUnet_raw/Dataset219_PETCT/labelsTr/PETCT_22d07bdc49_01052003.nii.gz,0.8243375858684985,0.4478767547607422,0.0,7,5
109,109,0.0,0,7,0.0,51839993,0,7,0,/well/papiez/users/hri611/python/nnUNet_results/Dataset219_PETCT/nnUNetTrainer_1500epochs_NoMirroring__nnUNetPlans__3d_fullres/crossval_results_folds_0_1_2_3_4/PETCT_234f8427c0_12032005.nii.gz,/well/papiez/users/hri611/python/nnUnet_raw/Dataset219_PETCT/labelsTr/PETCT_234f8427c0_12032005.nii.gz,0.0,0.0870871467590332,0.0,1,0
110,110,0.0,0,543,0.0,45439457,0,543,0,/well/papiez/users/hri611/python/nnUNet_results/Dataset219_PETCT/nnUNetTrainer_1500epochs_NoMirroring__nnUNetPlans__3d_fullres/crossval_results_folds_0_1_2_3_4/PETCT_234f8427c0_12092004.nii.gz,/well/papiez/users/hri611/python/nnUnet_raw/Dataset219_PETCT/labelsTr/PETCT_234f8427c0_12092004.nii.gz,0.0,6.7554743843078615,0.0,3,0
111,111,0.124748490945674,24,846,0.0665236051502145,92319068,62,908,86,/well/papiez/users/hri611/python/nnUNet_results/Dataset219_PETCT/nnUNetTrainer_1500epochs_NoMirroring__nnUNetPlans__3d_fullres/crossval_results_folds_0_1_2_3_4/PETCT_23ed525e82_08012003.nii.gz,/well/papiez/users/hri611/python/nnUnet_raw/Dataset219_PETCT/labelsTr/PETCT_23ed525e82_08012003.nii.gz,0.124748490945674,10.30116535949707,0.0,6,3
112,112,,0,0,,99520000,0,0,0,/well/papiez/users/hri611/python/nnUNet_results/Dataset219_PETCT/nnUNetTrainer_1500epochs_NoMirroring__nnUNetPlans__3d_fullres/crossval_results_folds_0_1_2_3_4/PETCT_2428b44e92_03222007.nii.gz,/well/papiez/users/hri611/python/nnUnet_raw/Dataset219_PETCT/labelsTr/PETCT_2428b44e92_03222007.nii.gz,,0.0,0.0,0,0
113,113,0.0,154,0,0.0,45439846,0,0,154,/well/papiez/users/hri611/python/nnUNet_results/Dataset219_PETCT/nnUNetTrainer_1500epochs_NoMirroring__nnUNetPlans__3d_fullres/crossval_results_folds_0_1_2_3_4/PETCT_245182006a_11042000.nii.gz,/well/papiez/users/hri611/python/nnUnet_raw/Dataset219_PETCT/labelsTr/PETCT_245182006a_11042000.nii.gz,0.0,0.0,1.9159172286987305,0,1
114,114,0.5909475095450438,27579,491,0.4193935382451495,52111654,20276,20767,47855,/well/papiez/users/hri611/python/nnUNet_results/Dataset219_PETCT/nnUNetTrainer_1500epochs_NoMirroring__nnUNetPlans__3d_fullres/crossval_results_folds_0_1_2_3_4/PETCT_249c02c01c_03062003.nii.gz,/well/papiez/users/hri611/python/nnUnet_raw/Dataset219_PETCT/labelsTr/PETCT_249c02c01c_03062003.nii.gz,0.5909475095450438,0.4976408386230468,40.34623099136353,19,22
115,115,0.0,0,20,0.0,45439980,0,20,0,/well/papiez/users/hri611/python/nnUNet_results/Dataset219_PETCT/nnUNetTrainer_1500epochs_NoMirroring__nnUNetPlans__3d_fullres/crossval_results_folds_0_1_2_3_4/PETCT_249c02c01c_07262003.nii.gz,/well/papiez/users/hri611/python/nnUnet_raw/Dataset219_PETCT/labelsTr/PETCT_249c02c01c_07262003.nii.gz,0.0,0.2488204193115234,0.0,3,0
116,116,0.7681010048956455,679,2921,0.623509725998745,50550438,5962,8883,6641,/well/papiez/users/hri611/python/nnUNet_results/Dataset219_PETCT/nnUNetTrainer_1500epochs_NoMirroring__nnUNetPlans__3d_fullres/crossval_results_folds_0_1_2_3_4/PETCT_249dd35d0c_05202005.nii.gz,/well/papiez/users/hri611/python/nnUnet_raw/Dataset219_PETCT/labelsTr/PETCT_249dd35d0c_05202005.nii.gz,0.7681010048956455,13.622917957305908,5.051054512023926,14,9
117,117,0.0,0,54,0.0,72159946,0,54,0,/well/papiez/users/hri611/python/nnUNet_results/Dataset219_PETCT/nnUNetTrainer_1500epochs_NoMirroring__nnUNetPlans__3d_fullres/crossval_results_folds_0_1_2_3_4/PETCT_24cb79a92b_04132003.nii.gz,/well/papiez/users/hri611/python/nnUnet_raw/Dataset219_PETCT/labelsTr/PETCT_24cb79a92b_04132003.nii.gz,0.0,0.6718151321411132,0.0,8,0
118,118,0.7552922550496668,5880,3703,0.6068028885606433,52135628,14789,18492,20669,/well/papiez/users/hri611/python/nnUNet_results/Dataset219_PETCT/nnUNetTrainer_1500epochs_NoMirroring__nnUNetPlans__3d_fullres/crossval_results_folds_0_1_2_3_4/PETCT_25707f94a2_07032003.nii.gz,/well/papiez/users/hri611/python/nnUnet_raw/Dataset219_PETCT/labelsTr/PETCT_25707f94a2_07032003.nii.gz,0.7552922550496668,0.3732306289672851,0.0373230628967285,14,17
119,119,0.0,0,98,0.0,47839902,0,98,0,/well/papiez/users/hri611/python/nnUNet_results/Dataset219_PETCT/nnUNetTrainer_1500epochs_NoMirroring__nnUNetPlans__3d_fullres/crossval_results_folds_0_1_2_3_4/PETCT_265c26907a_11102005.nii.gz,/well/papiez/users/hri611/python/nnUnet_raw/Dataset219_PETCT/labelsTr/PETCT_265c26907a_11102005.nii.gz,0.0,1.2192200546264649,0.0,3,0
120,120,0.0,0,11,0.0,58879989,0,11,0,/well/papiez/users/hri611/python/nnUNet_results/Dataset219_PETCT/nnUNetTrainer_1500epochs_NoMirroring__nnUNetPlans__3d_fullres/crossval_results_folds_0_1_2_3_4/PETCT_2716c9bfff_10042003.nii.gz,/well/papiez/users/hri611/python/nnUnet_raw/Dataset219_PETCT/labelsTr/PETCT_2716c9bfff_10042003.nii.gz,0.0,0.1368512306213379,0.0,5,0
121,121,0.0,0,55,0.0,58879945,0,55,0,/well/papiez/users/hri611/python/nnUNet_results/Dataset219_PETCT/nnUNetTrainer_1500epochs_NoMirroring__nnUNetPlans__3d_fullres/crossval_results_folds_0_1_2_3_4/PETCT_2716c9bfff_10312002.nii.gz,/well/papiez/users/hri611/python/nnUnet_raw/Dataset219_PETCT/labelsTr/PETCT_2716c9bfff_10312002.nii.gz,0.0,0.6842561531066894,0.0,3,0
122,122,0.0,0,57,0.0,52159943,0,57,0,/well/papiez/users/hri611/python/nnUNet_results/Dataset219_PETCT/nnUNetTrainer_1500epochs_NoMirroring__nnUNetPlans__3d_fullres/crossval_results_folds_0_1_2_3_4/PETCT_2716c9bfff_11202004.nii.gz,/well/papiez/users/hri611/python/nnUnet_raw/Dataset219_PETCT/labelsTr/PETCT_2716c9bfff_11202004.nii.gz,0.0,0.7091381950378418,0.0,7,0
123,123,0.0,0,156,0.0,54559844,0,156,0,/well/papiez/users/hri611/python/nnUNet_results/Dataset219_PETCT/nnUNetTrainer_1500epochs_NoMirroring__nnUNetPlans__3d_fullres/crossval_results_folds_0_1_2_3_4/PETCT_274688d0a8_03242007.nii.gz,/well/papiez/users/hri611/python/nnUnet_raw/Dataset219_PETCT/labelsTr/PETCT_274688d0a8_03242007.nii.gz,0.0,1.9407992706298829,0.0,3,0
124,124,0.8393687473580386,1390,890,0.7232001942454778,52151763,5957,6847,7347,/well/papiez/users/hri611/python/nnUNet_results/Dataset219_PETCT/nnUNetTrainer_1500epochs_NoMirroring__nnUNetPlans__3d_fullres/crossval_results_folds_0_1_2_3_4/PETCT_275fb00a66_05042001.nii.gz,/well/papiez/users/hri611/python/nnUnet_raw/Dataset219_PETCT/labelsTr/PETCT_275fb00a66_05042001.nii.gz,0.8393687473580386,0.2488204193115234,1.0699278030395507,9,9
125,125,0.0,0,240,0.0,46239760,0,240,0,/well/papiez/users/hri611/python/nnUNet_results/Dataset219_PETCT/nnUNetTrainer_1500epochs_NoMirroring__nnUNetPlans__3d_fullres/crossval_results_folds_0_1_2_3_4/PETCT_2791a0b3c2_08292005.nii.gz,/well/papiez/users/hri611/python/nnUnet_raw/Dataset219_PETCT/labelsTr/PETCT_2791a0b3c2_08292005.nii.gz,0.0,2.985845031738281,0.0,1,0
126,126,0.8770536479015806,680,2478,0.7810289834974344,45425578,11264,13742,11944,/well/papiez/users/hri611/python/nnUNet_results/Dataset219_PETCT/nnUNetTrainer_1500epochs_NoMirroring__nnUNetPlans__3d_fullres/crossval_results_folds_0_1_2_3_4/PETCT_27ad42f8a9_07142002.nii.gz,/well/papiez/users/hri611/python/nnUnet_raw/Dataset219_PETCT/labelsTr/PETCT_27ad42f8a9_07142002.nii.gz,0.8770536479015806,0.0622051048278808,0.0,5,4
127,127,0.5331737130615588,14055,763,0.363487972508591,52136720,8462,9225,22517,/well/papiez/users/hri611/python/nnUNet_results/Dataset219_PETCT/nnUNetTrainer_1500epochs_NoMirroring__nnUNetPlans__3d_fullres/crossval_results_folds_0_1_2_3_4/PETCT_27d69a8466_12162001.nii.gz,/well/papiez/users/hri611/python/nnUnet_raw/Dataset219_PETCT/labelsTr/PETCT_27d69a8466_12162001.nii.gz,0.5331737130615588,0.3234665451049804,9.517381038665771,11,11
128,128,,0,0,,52160000,0,0,0,/well/papiez/users/hri611/python/nnUNet_results/Dataset219_PETCT/nnUNetTrainer_1500epochs_NoMirroring__nnUNetPlans__3d_fullres/crossval_results_folds_0_1_2_3_4/PETCT_28a0a0a163_10222004.nii.gz,/well/papiez/users/hri611/python/nnUnet_raw/Dataset219_PETCT/labelsTr/PETCT_28a0a0a163_10222004.nii.gz,,0.0,0.0,0,0
129,129,0.0,0,256,0.0,98079744,0,256,0,/well/papiez/users/hri611/python/nnUNet_results/Dataset219_PETCT/nnUNetTrainer_1500epochs_NoMirroring__nnUNetPlans__3d_fullres/crossval_results_folds_0_1_2_3_4/PETCT_2946d59a94_11062006.nii.gz,/well/papiez/users/hri611/python/nnUnet_raw/Dataset219_PETCT/labelsTr/PETCT_2946d59a94_11062006.nii.gz,0.0,3.1849013671875,0.0,3,0
130,130,0.7792450868254134,314,3932,0.6383304940374787,52148260,7494,11426,7808,/well/papiez/users/hri611/python/nnUNet_results/Dataset219_PETCT/nnUNetTrainer_1500epochs_NoMirroring__nnUNetPlans__3d_fullres/crossval_results_folds_0_1_2_3_4/PETCT_29ab45ef17_06272002.nii.gz,/well/papiez/users/hri611/python/nnUnet_raw/Dataset219_PETCT/labelsTr/PETCT_29ab45ef17_06272002.nii.gz,0.7792450868254134,4.478767547607422,0.0995281677246093,15,17
131,131,,0,0,,45440000,0,0,0,/well/papiez/users/hri611/python/nnUNet_results/Dataset219_PETCT/nnUNetTrainer_1500epochs_NoMirroring__nnUNetPlans__3d_fullres/crossval_results_folds_0_1_2_3_4/PETCT_2a41141775_09242005.nii.gz,/well/papiez/users/hri611/python/nnUnet_raw/Dataset219_PETCT/labelsTr/PETCT_2a41141775_09242005.nii.gz,,0.0,0.0,0,0
132,132,0.946236559139785,2,3,0.8979591836734694,85599951,44,47,46,/well/papiez/users/hri611/python/nnUNet_results/Dataset219_PETCT/nnUNetTrainer_1500epochs_NoMirroring__nnUNetPlans__3d_fullres/crossval_results_folds_0_1_2_3_4/PETCT_2a6f4f0753_07312003.nii.gz,/well/papiez/users/hri611/python/nnUnet_raw/Dataset219_PETCT/labelsTr/PETCT_2a6f4f0753_07312003.nii.gz,0.946236559139785,0.0248820419311523,0.0,2,1
133,133,0.8062758051197357,998,175,0.6754288876591035,45436386,2441,2616,3439,/well/papiez/users/hri611/python/nnUNet_results/Dataset219_PETCT/nnUNetTrainer_1500epochs_NoMirroring__nnUNetPlans__3d_fullres/crossval_results_folds_0_1_2_3_4/PETCT_2a78eed085_12222001.nii.gz,/well/papiez/users/hri611/python/nnUnet_raw/Dataset219_PETCT/labelsTr/PETCT_2a78eed085_12222001.nii.gz,0.8062758051197357,0.2114973564147949,3.259547492980957,4,3
134,134,0.0,0,474,0.0,31999526,0,474,0,/well/papiez/users/hri611/python/nnUNet_results/Dataset219_PETCT/nnUNetTrainer_1500epochs_NoMirroring__nnUNetPlans__3d_fullres/crossval_results_folds_0_1_2_3_4/PETCT_2ad62beb52_03082003.nii.gz,/well/papiez/users/hri611/python/nnUnet_raw/Dataset219_PETCT/labelsTr/PETCT_2ad62beb52_03082003.nii.gz,0.0,5.897043937683105,0.0,2,0
135,135,0.8156751485060733,28,2051,0.6887258571642462,51033321,4600,6651,4628,/well/papiez/users/hri611/python/nnUNet_results/Dataset219_PETCT/nnUNetTrainer_1500epochs_NoMirroring__nnUNetPlans__3d_fullres/crossval_results_folds_0_1_2_3_4/PETCT_2b29531d8c_10162005.nii.gz,/well/papiez/users/hri611/python/nnUnet_raw/Dataset219_PETCT/labelsTr/PETCT_2b29531d8c_10162005.nii.gz,0.8156751485060733,7.166028076171875,0.0,9,2
136,136,0.0,0,76,0.0,47839924,0,76,0,/well/papiez/users/hri611/python/nnUNet_results/Dataset219_PETCT/nnUNetTrainer_1500epochs_NoMirroring__nnUNetPlans__3d_fullres/crossval_results_folds_0_1_2_3_4/PETCT_2b8064fbe2_06112006.nii.gz,/well/papiez/users/hri611/python/nnUnet_raw/Dataset219_PETCT/labelsTr/PETCT_2b8064fbe2_06112006.nii.gz,0.0,0.945517593383789,0.0,2,0
137,137,0.4579831932773109,0,258,0.2970027247956403,43839633,109,367,109,/well/papiez/users/hri611/python/nnUNet_results/Dataset219_PETCT/nnUNetTrainer_1500epochs_NoMirroring__nnUNetPlans__3d_fullres/crossval_results_folds_0_1_2_3_4/PETCT_2ce074c2ea_02042006.nii.gz,/well/papiez/users/hri611/python/nnUnet_raw/Dataset219_PETCT/labelsTr/PETCT_2ce074c2ea_02042006.nii.gz,0.4579831932773109,2.3513529624938965,0.0,3,1
138,138,0.6744868035190615,111,0,0.5088495575221239,94079774,115,115,226,/well/papiez/users/hri611/python/nnUNet_results/Dataset219_PETCT/nnUNetTrainer_1500epochs_NoMirroring__nnUNetPlans__3d_fullres/crossval_results_folds_0_1_2_3_4/PETCT_2d70838805_04302007.nii.gz,/well/papiez/users/hri611/python/nnUnet_raw/Dataset219_PETCT/labelsTr/PETCT_2d70838805_04302007.nii.gz,0.6744868035190615,0.0,0.0,1,1
139,139,0.7370112479914301,968,14,0.5835453774385072,45437642,1376,1390,2344,/well/papiez/users/hri611/python/nnUNet_results/Dataset219_PETCT/nnUNetTrainer_1500epochs_NoMirroring__nnUNetPlans__3d_fullres/crossval_results_folds_0_1_2_3_4/PETCT_2dac5ef654_11042000.nii.gz,/well/papiez/users/hri611/python/nnUnet_raw/Dataset219_PETCT/labelsTr/PETCT_2dac5ef654_11042000.nii.gz,0.7370112479914301,0.0373230628967285,0.0,6,4
140,140,0.7953266245949173,383,2017,0.6602010477134362,51832937,4663,6680,5046,/well/papiez/users/hri611/python/nnUNet_results/Dataset219_PETCT/nnUNetTrainer_1500epochs_NoMirroring__nnUNetPlans__3d_fullres/crossval_results_folds_0_1_2_3_4/PETCT_2dc17aaeaf_07012005.nii.gz,/well/papiez/users/hri611/python/nnUnet_raw/Dataset219_PETCT/labelsTr/PETCT_2dc17aaeaf_07012005.nii.gz,0.7953266245949173,2.687260528564453,0.0870871467590332,8,14
141,141,0.8889430950970485,1938,1249,0.8000878183414879,78864058,12755,14004,14693,/well/papiez/users/hri611/python/nnUNet_results/Dataset219_PETCT/nnUNetTrainer_1500epochs_NoMirroring__nnUNetPlans__3d_fullres/crossval_results_folds_0_1_2_3_4/PETCT_2e44706eaf_05062005.nii.gz,/well/papiez/users/hri611/python/nnUnet_raw/Dataset219_PETCT/labelsTr/PETCT_2e44706eaf_05062005.nii.gz,0.8889430950970485,5.984131084442138,7.365084411621094,69,68
142,142,0.829051044878383,482,17,0.7080163838502048,45438291,1210,1227,1692,/well/papiez/users/hri611/python/nnUNet_results/Dataset219_PETCT/nnUNetTrainer_1500epochs_NoMirroring__nnUNetPlans__3d_fullres/crossval_results_folds_0_1_2_3_4/PETCT_2e97a9e5c2_06232003.nii.gz,/well/papiez/users/hri611/python/nnUnet_raw/Dataset219_PETCT/labelsTr/PETCT_2e97a9e5c2_06232003.nii.gz,0.829051044878383,0.1119691886901855,0.5225228805541993,6,3
143,143,0.0,0,1,0.0,52159999,0,1,0,/well/papiez/users/hri611/python/nnUNet_results/Dataset219_PETCT/nnUNetTrainer_1500epochs_NoMirroring__nnUNetPlans__3d_fullres/crossval_results_folds_0_1_2_3_4/PETCT_2f2ee78c89_05012003.nii.gz,/well/papiez/users/hri611/python/nnUnet_raw/Dataset219_PETCT/labelsTr/PETCT_2f2ee78c89_05012003.nii.gz,0.0,0.0124410209655761,0.0,1,0
144,144,0.8454194661702791,1519,17830,0.7322308331026848,46647740,52911,70741,54430,/well/papiez/users/hri611/python/nnUNet_results/Dataset219_PETCT/nnUNetTrainer_1500epochs_NoMirroring__nnUNetPlans__3d_fullres/crossval_results_folds_0_1_2_3_4/PETCT_2f7200f771_11052005.nii.gz,/well/papiez/users/hri611/python/nnUnet_raw/Dataset219_PETCT/labelsTr/PETCT_2f7200f771_11052005.nii.gz,0.8454194661702791,0.7589022789001465,0.8086663627624512,33,42
145,145,0.0,0,47,0.0,52319953,0,47,0,/well/papiez/users/hri611/python/nnUNet_results/Dataset219_PETCT/nnUNetTrainer_1500epochs_NoMirroring__nnUNetPlans__3d_fullres/crossval_results_folds_0_1_2_3_4/PETCT_302613f9a5_04062007.nii.gz,/well/papiez/users/hri611/python/nnUnet_raw/Dataset219_PETCT/labelsTr/PETCT_302613f9a5_04062007.nii.gz,0.0,0.58472798538208,0.0,2,0
146,146,0.0,0,410,0.0,99039590,0,410,0,/well/papiez/users/hri611/python/nnUNet_results/Dataset219_PETCT/nnUNetTrainer_1500epochs_NoMirroring__nnUNetPlans__3d_fullres/crossval_results_folds_0_1_2_3_4/PETCT_30287f520f_11232003.nii.gz,/well/papiez/users/hri611/python/nnUnet_raw/Dataset219_PETCT/labelsTr/PETCT_30287f520f_11232003.nii.gz,0.0,5.10081859588623,0.0,9,0
147,147,0.6510097572044474,2991,85,0.4825904121110176,52154055,2869,2954,5860,/well/papiez/users/hri611/python/nnUNet_results/Dataset219_PETCT/nnUNetTrainer_1500epochs_NoMirroring__nnUNetPlans__3d_fullres/crossval_results_folds_0_1_2_3_4/PETCT_3049d4f1a4_02242002.nii.gz,/well/papiez/users/hri611/python/nnUnet_raw/Dataset219_PETCT/labelsTr/PETCT_3049d4f1a4_02242002.nii.gz,0.6510097572044474,0.0,3.284429534912109,2,3
148,148,0.9006015840270064,10572,3208,0.8191767160497068,45363793,62427,65635,72999,/well/papiez/users/hri611/python/nnUNet_results/Dataset219_PETCT/nnUNetTrainer_1500epochs_NoMirroring__nnUNetPlans__3d_fullres/crossval_results_folds_0_1_2_3_4/PETCT_30c4b7062b_01182001.nii.gz,/well/papiez/users/hri611/python/nnUnet_raw/Dataset219_PETCT/labelsTr/PETCT_30c4b7062b_01182001.nii.gz,0.9006015840270064,10.674395988464354,0.8211073837280274,44,34
149,149,0.0,0,64,0.0,99039936,0,64,0,/well/papiez/users/hri611/python/nnUNet_results/Dataset219_PETCT/nnUNetTrainer_1500epochs_NoMirroring__nnUNetPlans__3d_fullres/crossval_results_folds_0_1_2_3_4/PETCT_30e2b83b74_04262003.nii.gz,/well/papiez/users/hri611/python/nnUnet_raw/Dataset219_PETCT/labelsTr/PETCT_30e2b83b74_04262003.nii.gz,0.0,0.796225341796875,0.0,1,0
150,150,0.0,0,63,0.0,92319937,0,63,0,/well/papiez/users/hri611/python/nnUNet_results/Dataset219_PETCT/nnUNetTrainer_1500epochs_NoMirroring__nnUNetPlans__3d_fullres/crossval_results_folds_0_1_2_3_4/PETCT_30e2b83b74_07212003.nii.gz,/well/papiez/users/hri611/python/nnUnet_raw/Dataset219_PETCT/labelsTr/PETCT_30e2b83b74_07212003.nii.gz,0.0,0.7837843208312988,0.0,2,0
151,151,,0,0,,99040000,0,0,0,/well/papiez/users/hri611/python/nnUNet_results/Dataset219_PETCT/nnUNetTrainer_1500epochs_NoMirroring__nnUNetPlans__3d_fullres/crossval_results_folds_0_1_2_3_4/PETCT_30e2b83b74_09012002.nii.gz,/well/papiez/users/hri611/python/nnUnet_raw/Dataset219_PETCT/labelsTr/PETCT_30e2b83b74_09012002.nii.gz,,0.0,0.0,0,0
152,152,0.9358329312840306,397,534,0.8794041450777202,52152280,6789,7323,7186,/well/papiez/users/hri611/python/nnUNet_results/Dataset219_PETCT/nnUNetTrainer_1500epochs_NoMirroring__nnUNetPlans__3d_fullres/crossval_results_folds_0_1_2_3_4/PETCT_31ddf5013a_02222001.nii.gz,/well/papiez/users/hri611/python/nnUnet_raw/Dataset219_PETCT/labelsTr/PETCT_31ddf5013a_02222001.nii.gz,0.9358329312840306,2.550409297943115,0.0,4,2
153,153,0.6084897386423435,4906,4022,0.4372872809781923,45424134,6938,10960,11844,/well/papiez/users/hri611/python/nnUNet_results/Dataset219_PETCT/nnUNetTrainer_1500epochs_NoMirroring__nnUNetPlans__3d_fullres/crossval_results_folds_0_1_2_3_4/PETCT_321bba14bc_03072002.nii.gz,/well/papiez/users/hri611/python/nnUnet_raw/Dataset219_PETCT/labelsTr/PETCT_321bba14bc_03072002.nii.gz,0.6084897386423435,2.699701549530029,1.1072508659362792,7,13
154,154,0.0,0,1,0.0,45439999,0,1,0,/well/papiez/users/hri611/python/nnUNet_results/Dataset219_PETCT/nnUNetTrainer_1500epochs_NoMirroring__nnUNetPlans__3d_fullres/crossval_results_folds_0_1_2_3_4/PETCT_32219760da_03132003.nii.gz,/well/papiez/users/hri611/python/nnUnet_raw/Dataset219_PETCT/labelsTr/PETCT_32219760da_03132003.nii.gz,0.0,0.0124410209655761,0.0,1,0
155,155,0.8734690838700071,2396,1003,0.775361839931267,52144869,11732,12735,14128,/well/papiez/users/hri611/python/nnUNet_results/Dataset219_PETCT/nnUNetTrainer_1500epochs_NoMirroring__nnUNetPlans__3d_fullres/crossval_results_folds_0_1_2_3_4/PETCT_323cc5aff8_11092001.nii.gz,/well/papiez/users/hri611/python/nnUnet_raw/Dataset219_PETCT/labelsTr/PETCT_323cc5aff8_11092001.nii.gz,0.8734690838700071,2.4757631721496582,2.0652094802856444,13,7
156,156,0.871244635193133,26,34,0.7718631178707225,99839737,203,237,229,/well/papiez/users/hri611/python/nnUNet_results/Dataset219_PETCT/nnUNetTrainer_1500epochs_NoMirroring__nnUNetPlans__3d_fullres/crossval_results_folds_0_1_2_3_4/PETCT_32aa845af1_01262007.nii.gz,/well/papiez/users/hri611/python/nnUnet_raw/Dataset219_PETCT/labelsTr/PETCT_32aa845af1_01262007.nii.gz,0.871244635193133,0.0,0.0,2,2
157,157,0.9034934497816594,921,405,0.8239745121465551,50872467,6207,6612,7128,/well/papiez/users/hri611/python/nnUNet_results/Dataset219_PETCT/nnUNetTrainer_1500epochs_NoMirroring__nnUNetPlans__3d_fullres/crossval_results_folds_0_1_2_3_4/PETCT_32aa845af1_06152007.nii.gz,/well/papiez/users/hri611/python/nnUnet_raw/Dataset219_PETCT/labelsTr/PETCT_32aa845af1_06152007.nii.gz,0.9034934497816594,1.0574867820739746,2.5006452140808104,14,14
158,158,0.7978446028159222,11629,1164,0.6636784268363216,45401962,25245,26409,36874,/well/papiez/users/hri611/python/nnUNet_results/Dataset219_PETCT/nnUNetTrainer_1500epochs_NoMirroring__nnUNetPlans__3d_fullres/crossval_results_folds_0_1_2_3_4/PETCT_335a00191d_02162001.nii.gz,/well/papiez/users/hri611/python/nnUnet_raw/Dataset219_PETCT/labelsTr/PETCT_335a00191d_02162001.nii.gz,0.7978446028159222,0.0,1.3311892433166503,13,13
159,159,0.0,0,234,0.0,49919766,0,234,0,/well/papiez/users/hri611/python/nnUNet_results/Dataset219_PETCT/nnUNetTrainer_1500epochs_NoMirroring__nnUNetPlans__3d_fullres/crossval_results_folds_0_1_2_3_4/PETCT_345b11778a_10142005.nii.gz,/well/papiez/users/hri611/python/nnUnet_raw/Dataset219_PETCT/labelsTr/PETCT_345b11778a_10142005.nii.gz,0.0,2.911198905944824,0.0,5,0
160,160,,0,0,,54240000,0,0,0,/well/papiez/users/hri611/python/nnUNet_results/Dataset219_PETCT/nnUNetTrainer_1500epochs_NoMirroring__nnUNetPlans__3d_fullres/crossval_results_folds_0_1_2_3_4/PETCT_3481507253_06172007.nii.gz,/well/papiez/users/hri611/python/nnUnet_raw/Dataset219_PETCT/labelsTr/PETCT_3481507253_06172007.nii.gz,,0.0,0.0,0,0
161,161,,0,0,,55360000,0,0,0,/well/papiez/users/hri611/python/nnUNet_results/Dataset219_PETCT/nnUNetTrainer_1500epochs_NoMirroring__nnUNetPlans__3d_fullres/crossval_results_folds_0_1_2_3_4/PETCT_34aa521b46_03302007.nii.gz,/well/papiez/users/hri611/python/nnUnet_raw/Dataset219_PETCT/labelsTr/PETCT_34aa521b46_03302007.nii.gz,,0.0,0.0,0,0
162,162,0.0,0,17,0.0,52159983,0,17,0,/well/papiez/users/hri611/python/nnUNet_results/Dataset219_PETCT/nnUNetTrainer_1500epochs_NoMirroring__nnUNetPlans__3d_fullres/crossval_results_folds_0_1_2_3_4/PETCT_34d3efa936_10222004.nii.gz,/well/papiez/users/hri611/python/nnUnet_raw/Dataset219_PETCT/labelsTr/PETCT_34d3efa936_10222004.nii.gz,0.0,0.2114973564147949,0.0,3,0
163,163,0.7004210059827166,2281,423,0.5389599317988065,45594135,3161,3584,5442,/well/papiez/users/hri611/python/nnUNet_results/Dataset219_PETCT/nnUNetTrainer_1500epochs_NoMirroring__nnUNetPlans__3d_fullres/crossval_results_folds_0_1_2_3_4/PETCT_350e91119a_10232005.nii.gz,/well/papiez/users/hri611/python/nnUnet_raw/Dataset219_PETCT/labelsTr/PETCT_350e91119a_10232005.nii.gz,0.7004210059827166,2.973404010772705,3.5208089332580568,17,18
164,164,0.8589983764206319,627,502,0.75284588441331,92315432,3439,3941,4066,/well/papiez/users/hri611/python/nnUNet_results/Dataset219_PETCT/nnUNetTrainer_1500epochs_NoMirroring__nnUNetPlans__3d_fullres/crossval_results_folds_0_1_2_3_4/PETCT_35c9c85a96_04082005.nii.gz,/well/papiez/users/hri611/python/nnUnet_raw/Dataset219_PETCT/labelsTr/PETCT_35c9c85a96_04082005.nii.gz,0.8589983764206319,0.7340202369689941,0.4851998176574706,23,23
165,165,0.8696580626217868,2791,2092,0.7693760921928872,90378827,16290,18382,19081,/well/papiez/users/hri611/python/nnUNet_results/Dataset219_PETCT/nnUNetTrainer_1500epochs_NoMirroring__nnUNetPlans__3d_fullres/crossval_results_folds_0_1_2_3_4/PETCT_35c9c85a96_09232005.nii.gz,/well/papiez/users/hri611/python/nnUnet_raw/Dataset219_PETCT/labelsTr/PETCT_35c9c85a96_09232005.nii.gz,0.8696580626217868,0.0,3.956244667053223,65,75
166,166,0.0,0,2,0.0,52799998,0,2,0,/well/papiez/users/hri611/python/nnUNet_results/Dataset219_PETCT/nnUNetTrainer_1500epochs_NoMirroring__nnUNetPlans__3d_fullres/crossval_results_folds_0_1_2_3_4/PETCT_35de69968e_10272006.nii.gz,/well/papiez/users/hri611/python/nnUnet_raw/Dataset219_PETCT/labelsTr/PETCT_35de69968e_10272006.nii.gz,0.0,0.0248820419311523,0.0,1,0
167,167,0.4578313253012048,45,45,0.296875,49919872,38,83,83,/well/papiez/users/hri611/python/nnUNet_results/Dataset219_PETCT/nnUNetTrainer_1500epochs_NoMirroring__nnUNetPlans__3d_fullres/crossval_results_folds_0_1_2_3_4/PETCT_36870de2f2_05142006.nii.gz,/well/papiez/users/hri611/python/nnUnet_raw/Dataset219_PETCT/labelsTr/PETCT_36870de2f2_05142006.nii.gz,0.4578313253012048,0.4105536918640137,0.0,2,1
168,168,0.106276695866213,12250,95,0.0561204985090603,52146921,734,829,12984,/well/papiez/users/hri611/python/nnUNet_results/Dataset219_PETCT/nnUNetTrainer_1500epochs_NoMirroring__nnUNetPlans__3d_fullres/crossval_results_folds_0_1_2_3_4/PETCT_36bb0257fc_08032003.nii.gz,/well/papiez/users/hri611/python/nnUnet_raw/Dataset219_PETCT/labelsTr/PETCT_36bb0257fc_08032003.nii.gz,0.106276695866213,0.0870871467590332,7.825402187347412,15,32
169,169,0.6463772515685084,2421,11557,0.4775165402010989,100933247,12775,24332,15196,/well/papiez/users/hri611/python/nnUNet_results/Dataset219_PETCT/nnUNetTrainer_1500epochs_NoMirroring__nnUNetPlans__3d_fullres/crossval_results_folds_0_1_2_3_4/PETCT_36d8219e3f_02092006.nii.gz,/well/papiez/users/hri611/python/nnUnet_raw/Dataset219_PETCT/labelsTr/PETCT_36d8219e3f_02092006.nii.gz,0.6463772515685084,103.40976626586914,8.54698140335083,16,11
170,170,0.8149768615902397,1680,519,0.687730758307299,99032958,4843,5362,6523,/well/papiez/users/hri611/python/nnUNet_results/Dataset219_PETCT/nnUNetTrainer_1500epochs_NoMirroring__nnUNetPlans__3d_fullres/crossval_results_folds_0_1_2_3_4/PETCT_3708f576ec_03082002.nii.gz,/well/papiez/users/hri611/python/nnUnet_raw/Dataset219_PETCT/labelsTr/PETCT_3708f576ec_03082002.nii.gz,0.8149768615902397,2.674819507598877,0.1866153144836425,12,8
171,171,0.0,0,30,0.0,48799970,0,30,0,/well/papiez/users/hri611/python/nnUNet_results/Dataset219_PETCT/nnUNetTrainer_1500epochs_NoMirroring__nnUNetPlans__3d_fullres/crossval_results_folds_0_1_2_3_4/PETCT_372746cc99_07152006.nii.gz,/well/papiez/users/hri611/python/nnUnet_raw/Dataset219_PETCT/labelsTr/PETCT_372746cc99_07152006.nii.gz,0.0,0.3732306289672851,0.0,1,0
172,172,0.7806603773584906,889,227,0.6402321083172147,45436898,1986,2213,2875,/well/papiez/users/hri611/python/nnUNet_results/Dataset219_PETCT/nnUNetTrainer_1500epochs_NoMirroring__nnUNetPlans__3d_fullres/crossval_results_folds_0_1_2_3_4/PETCT_37472e737f_06202003.nii.gz,/well/papiez/users/hri611/python/nnUnet_raw/Dataset219_PETCT/labelsTr/PETCT_37472e737f_06202003.nii.gz,0.7806603773584906,0.0248820419311523,0.0,4,3
173,173,0.8560941964725589,5279,563,0.7483957104095783,52136781,17377,17940,22656,/well/papiez/users/hri611/python/nnUNet_results/Dataset219_PETCT/nnUNetTrainer_1500epochs_NoMirroring__nnUNetPlans__3d_fullres/crossval_results_folds_0_1_2_3_4/PETCT_37952b7ffb_08242002.nii.gz,/well/papiez/users/hri611/python/nnUnet_raw/Dataset219_PETCT/labelsTr/PETCT_37952b7ffb_08242002.nii.gz,0.8560941964725589,0.4727587966918945,4.1553010025024415,15,9
174,174,0.7882218529289572,10708,1526,0.6504671295105854,52124999,22767,24293,33475,/well/papiez/users/hri611/python/nnUNet_results/Dataset219_PETCT/nnUNetTrainer_1500epochs_NoMirroring__nnUNetPlans__3d_fullres/crossval_results_folds_0_1_2_3_4/PETCT_380f71df1e_08192001.nii.gz,/well/papiez/users/hri611/python/nnUnet_raw/Dataset219_PETCT/labelsTr/PETCT_380f71df1e_08192001.nii.gz,0.7882218529289572,3.744747310638428,17.106403827667236,11,6
175,175,0.0,0,90,0.0,52159910,0,90,0,/well/papiez/users/hri611/python/nnUNet_results/Dataset219_PETCT/nnUNetTrainer_1500epochs_NoMirroring__nnUNetPlans__3d_fullres/crossval_results_folds_0_1_2_3_4/PETCT_389462c0ac_03032005.nii.gz,/well/papiez/users/hri611/python/nnUnet_raw/Dataset219_PETCT/labelsTr/PETCT_389462c0ac_03032005.nii.gz,0.0,1.1196918869018555,0.0,3,0
176,176,0.0,0,3,0.0,52159997,0,3,0,/well/papiez/users/hri611/python/nnUNet_results/Dataset219_PETCT/nnUNetTrainer_1500epochs_NoMirroring__nnUNetPlans__3d_fullres/crossval_results_folds_0_1_2_3_4/PETCT_389462c0ac_04272003.nii.gz,/well/papiez/users/hri611/python/nnUnet_raw/Dataset219_PETCT/labelsTr/PETCT_389462c0ac_04272003.nii.gz,0.0,0.0373230628967285,0.0,3,0
177,177,0.0,0,145,0.0,56159855,0,145,0,/well/papiez/users/hri611/python/nnUNet_results/Dataset219_PETCT/nnUNetTrainer_1500epochs_NoMirroring__nnUNetPlans__3d_fullres/crossval_results_folds_0_1_2_3_4/PETCT_389462c0ac_08292005.nii.gz,/well/papiez/users/hri611/python/nnUnet_raw/Dataset219_PETCT/labelsTr/PETCT_389462c0ac_08292005.nii.gz,0.0,1.8039480400085448,0.0,2,0
178,178,0.0,0,209,0.0,97279791,0,209,0,/well/papiez/users/hri611/python/nnUNet_results/Dataset219_PETCT/nnUNetTrainer_1500epochs_NoMirroring__nnUNetPlans__3d_fullres/crossval_results_folds_0_1_2_3_4/PETCT_389c968170_02172006.nii.gz,/well/papiez/users/hri611/python/nnUnet_raw/Dataset219_PETCT/labelsTr/PETCT_389c968170_02172006.nii.gz,0.0,2.60017338180542,0.0,4,0
179,179,0.0,0,632,0.0,100959368,0,632,0,/well/papiez/users/hri611/python/nnUNet_results/Dataset219_PETCT/nnUNetTrainer_1500epochs_NoMirroring__nnUNetPlans__3d_fullres/crossval_results_folds_0_1_2_3_4/PETCT_389c968170_08192005.nii.gz,/well/papiez/users/hri611/python/nnUnet_raw/Dataset219_PETCT/labelsTr/PETCT_389c968170_08192005.nii.gz,0.0,7.86272525024414,0.0,2,0
180,180,0.0,0,1075,0.0,52798925,0,1075,0,/well/papiez/users/hri611/python/nnUNet_results/Dataset219_PETCT/nnUNetTrainer_1500epochs_NoMirroring__nnUNetPlans__3d_fullres/crossval_results_folds_0_1_2_3_4/PETCT_38a374d01a_05242007.nii.gz,/well/papiez/users/hri611/python/nnUnet_raw/Dataset219_PETCT/labelsTr/PETCT_38a374d01a_05242007.nii.gz,0.0,13.374097537994384,0.0,6,0
181,181,0.0,0,32,0.0,71519968,0,32,0,/well/papiez/users/hri611/python/nnUNet_results/Dataset219_PETCT/nnUNetTrainer_1500epochs_NoMirroring__nnUNetPlans__3d_fullres/crossval_results_folds_0_1_2_3_4/PETCT_390129c0d2_04272007.nii.gz,/well/papiez/users/hri611/python/nnUnet_raw/Dataset219_PETCT/labelsTr/PETCT_390129c0d2_04272007.nii.gz,0.0,0.3981126708984375,0.0,1,0
182,182,0.7004799479378508,20139,1953,0.5390297339593114,52112075,25833,27786,45972,/well/papiez/users/hri611/python/nnUNet_results/Dataset219_PETCT/nnUNetTrainer_1500epochs_NoMirroring__nnUNetPlans__3d_fullres/crossval_results_folds_0_1_2_3_4/PETCT_39159c05c2_02232001.nii.gz,/well/papiez/users/hri611/python/nnUnet_raw/Dataset219_PETCT/labelsTr/PETCT_39159c05c2_02232001.nii.gz,0.7004799479378508,0.0,34.31233582305908,19,32
183,183,0.0,0,1835,0.0,65438165,0,1835,0,/well/papiez/users/hri611/python/nnUNet_results/Dataset219_PETCT/nnUNetTrainer_1500epochs_NoMirroring__nnUNetPlans__3d_fullres/crossval_results_folds_0_1_2_3_4/PETCT_39eca178a1_06082003.nii.gz,/well/papiez/users/hri611/python/nnUnet_raw/Dataset219_PETCT/labelsTr/PETCT_39eca178a1_06082003.nii.gz,0.0,22.829273471832277,0.0,3,0
184,184,0.0,0,48,0.0,49439952,0,48,0,/well/papiez/users/hri611/python/nnUNet_results/Dataset219_PETCT/nnUNetTrainer_1500epochs_NoMirroring__nnUNetPlans__3d_fullres/crossval_results_folds_0_1_2_3_4/PETCT_3a40a26443_10022005.nii.gz,/well/papiez/users/hri611/python/nnUnet_raw/Dataset219_PETCT/labelsTr/PETCT_3a40a26443_10022005.nii.gz,0.0,0.5971690063476562,0.0,1,0
185,185,0.0,0,1,0.0,52159999,0,1,0,/well/papiez/users/hri611/python/nnUNet_results/Dataset219_PETCT/nnUNetTrainer_1500epochs_NoMirroring__nnUNetPlans__3d_fullres/crossval_results_folds_0_1_2_3_4/PETCT_3b14690fce_09072002.nii.gz,/well/papiez/users/hri611/python/nnUnet_raw/Dataset219_PETCT/labelsTr/PETCT_3b14690fce_09072002.nii.gz,0.0,0.0124410209655761,0.0,1,0
186,186,0.699748088303248,14868,5275,0.5381634758683939,58836385,23472,28747,38340,/well/papiez/users/hri611/python/nnUNet_results/Dataset219_PETCT/nnUNetTrainer_1500epochs_NoMirroring__nnUNetPlans__3d_fullres/crossval_results_folds_0_1_2_3_4/PETCT_3b1c9155f5_01312003.nii.gz,/well/papiez/users/hri611/python/nnUnet_raw/Dataset219_PETCT/labelsTr/PETCT_3b1c9155f5_01312003.nii.gz,0.699748088303248,10.027462898254395,37.6962935256958,63,66
187,187,0.9048689475340556,3313,919,0.8262654460363726,52135641,20127,21046,23440,/well/papiez/users/hri611/python/nnUNet_results/Dataset219_PETCT/nnUNetTrainer_1500epochs_NoMirroring__nnUNetPlans__3d_fullres/crossval_results_folds_0_1_2_3_4/PETCT_3b26172779_11102001.nii.gz,/well/papiez/users/hri611/python/nnUnet_raw/Dataset219_PETCT/labelsTr/PETCT_3b26172779_11102001.nii.gz,0.9048689475340556,1.4680404739379882,11.707000728607175,8,6
188,188,0.0,0,56,0.0,45439944,0,56,0,/well/papiez/users/hri611/python/nnUNet_results/Dataset219_PETCT/nnUNetTrainer_1500epochs_NoMirroring__nnUNetPlans__3d_fullres/crossval_results_folds_0_1_2_3_4/PETCT_3b2a4af482_01262003.nii.gz,/well/papiez/users/hri611/python/nnUnet_raw/Dataset219_PETCT/labelsTr/PETCT_3b2a4af482_01262003.nii.gz,0.0,0.6966971740722656,0.0,1,0
189,189,0.9033182364358998,695,1397,0.8236831015592078,45428135,9773,11170,10468,/well/papiez/users/hri611/python/nnUNet_results/Dataset219_PETCT/nnUNetTrainer_1500epochs_NoMirroring__nnUNetPlans__3d_fullres/crossval_results_folds_0_1_2_3_4/PETCT_3b73c2480a_10192001.nii.gz,/well/papiez/users/hri611/python/nnUnet_raw/Dataset219_PETCT/labelsTr/PETCT_3b73c2480a_10192001.nii.gz,0.9033182364358998,0.149292251586914,0.0,6,4
190,190,0.0,0,23,0.0,48479977,0,23,0,/well/papiez/users/hri611/python/nnUNet_results/Dataset219_PETCT/nnUNetTrainer_1500epochs_NoMirroring__nnUNetPlans__3d_fullres/crossval_results_folds_0_1_2_3_4/PETCT_3bce0eb7aa_06032007.nii.gz,/well/papiez/users/hri611/python/nnUnet_raw/Dataset219_PETCT/labelsTr/PETCT_3bce0eb7aa_06032007.nii.gz,0.0,0.2861434822082519,0.0,1,0
191,191,0.8839506172839506,26,21,0.7920353982300885,45439774,179,200,205,/well/papiez/users/hri611/python/nnUNet_results/Dataset219_PETCT/nnUNetTrainer_1500epochs_NoMirroring__nnUNetPlans__3d_fullres/crossval_results_folds_0_1_2_3_4/PETCT_3c3050f75e_09052002.nii.gz,/well/papiez/users/hri611/python/nnUnet_raw/Dataset219_PETCT/labelsTr/PETCT_3c3050f75e_09052002.nii.gz,0.8839506172839506,0.1741742935180664,0.0,3,1
192,192,0.0683962264150943,182,2188,0.0354090354090354,78877543,87,2275,269,/well/papiez/users/hri611/python/nnUNet_results/Dataset219_PETCT/nnUNetTrainer_1500epochs_NoMirroring__nnUNetPlans__3d_fullres/crossval_results_folds_0_1_2_3_4/PETCT_3c3ee87fc6_06132003.nii.gz,/well/papiez/users/hri611/python/nnUnet_raw/Dataset219_PETCT/labelsTr/PETCT_3c3ee87fc6_06132003.nii.gz,0.0683962264150943,27.220953872680663,2.027886417388916,7,3
193,193,0.8587333663781599,6805,4310,0.7524388614192169,52115102,33783,38093,40588,/well/papiez/users/hri611/python/nnUNet_results/Dataset219_PETCT/nnUNetTrainer_1500epochs_NoMirroring__nnUNetPlans__3d_fullres/crossval_results_folds_0_1_2_3_4/PETCT_3c71e8f518_12112000.nii.gz,/well/papiez/users/hri611/python/nnUnet_raw/Dataset219_PETCT/labelsTr/PETCT_3c71e8f518_12112000.nii.gz,0.8587333663781599,2.2767068367004395,6.170746398925781,18,11
194,194,0.0,0,54,0.0,94719946,0,54,0,/well/papiez/users/hri611/python/nnUNet_results/Dataset219_PETCT/nnUNetTrainer_1500epochs_NoMirroring__nnUNetPlans__3d_fullres/crossval_results_folds_0_1_2_3_4/PETCT_3c94a00f90_05112007.nii.gz,/well/papiez/users/hri611/python/nnUnet_raw/Dataset219_PETCT/labelsTr/PETCT_3c94a00f90_05112007.nii.gz,0.0,0.6718151321411132,0.0,3,0
195,195,0.0,0,15,0.0,45439985,0,15,0,/well/papiez/users/hri611/python/nnUNet_results/Dataset219_PETCT/nnUNetTrainer_1500epochs_NoMirroring__nnUNetPlans__3d_fullres/crossval_results_folds_0_1_2_3_4/PETCT_3cd49210eb_12292002.nii.gz,/well/papiez/users/hri611/python/nnUnet_raw/Dataset219_PETCT/labelsTr/PETCT_3cd49210eb_12292002.nii.gz,0.0,0.1866153144836425,0.0,1,0
196,196,0.0,0,185,0.0,52159815,0,185,0,/well/papiez/users/hri611/python/nnUNet_results/Dataset219_PETCT/nnUNetTrainer_1500epochs_NoMirroring__nnUNetPlans__3d_fullres/crossval_results_folds_0_1_2_3_4/PETCT_3cf68da275_03202003.nii.gz,/well/papiez/users/hri611/python/nnUnet_raw/Dataset219_PETCT/labelsTr/PETCT_3cf68da275_03202003.nii.gz,0.0,2.301588878631592,0.0,1,0
197,197,0.8094096999561241,2130,3517,0.6798389840117928,52142362,11991,15508,14121,/well/papiez/users/hri611/python/nnUNet_results/Dataset219_PETCT/nnUNetTrainer_1500epochs_NoMirroring__nnUNetPlans__3d_fullres/crossval_results_folds_0_1_2_3_4/PETCT_3d6f425a76_01282002.nii.gz,/well/papiez/users/hri611/python/nnUnet_raw/Dataset219_PETCT/labelsTr/PETCT_3d6f425a76_01282002.nii.gz,0.8094096999561241,10.66195496749878,0.870871467590332,20,9
198,198,0.0,0,224,0.0,52159776,0,224,0,/well/papiez/users/hri611/python/nnUNet_results/Dataset219_PETCT/nnUNetTrainer_1500epochs_NoMirroring__nnUNetPlans__3d_fullres/crossval_results_folds_0_1_2_3_4/PETCT_3d6f425a76_07222002.nii.gz,/well/papiez/users/hri611/python/nnUnet_raw/Dataset219_PETCT/labelsTr/PETCT_3d6f425a76_07222002.nii.gz,0.0,2.7867886962890625,0.0,4,0
199,199,,0,0,,45440000,0,0,0,/well/papiez/users/hri611/python/nnUNet_results/Dataset219_PETCT/nnUNetTrainer_1500epochs_NoMirroring__nnUNetPlans__3d_fullres/crossval_results_folds_0_1_2_3_4/PETCT_3d8b79d739_11282004.nii.gz,/well/papiez/users/hri611/python/nnUnet_raw/Dataset219_PETCT/labelsTr/PETCT_3d8b79d739_11282004.nii.gz,,0.0,0.0,0,0
200,200,0.8503947368421053,2243,31,0.7397275952844226,45431263,6463,6494,8706,/well/papiez/users/hri611/python/nnUNet_results/Dataset219_PETCT/nnUNetTrainer_1500epochs_NoMirroring__nnUNetPlans__3d_fullres/crossval_results_folds_0_1_2_3_4/PETCT_3eac8f16d4_09302001.nii.gz,/well/papiez/users/hri611/python/nnUnet_raw/Dataset219_PETCT/labelsTr/PETCT_3eac8f16d4_09302001.nii.gz,0.8503947368421053,0.0,9.741319416046142,3,5
201,201,0.0,0,130,0.0,52159870,0,130,0,/well/papiez/users/hri611/python/nnUNet_results/Dataset219_PETCT/nnUNetTrainer_1500epochs_NoMirroring__nnUNetPlans__3d_fullres/crossval_results_folds_0_1_2_3_4/PETCT_3f2ee0274d_09162002.nii.gz,/well/papiez/users/hri611/python/nnUnet_raw/Dataset219_PETCT/labelsTr/PETCT_3f2ee0274d_09162002.nii.gz,0.0,1.6173327255249024,0.0,4,0
202,202,0.0,0,3,0.0,52159997,0,3,0,/well/papiez/users/hri611/python/nnUNet_results/Dataset219_PETCT/nnUNetTrainer_1500epochs_NoMirroring__nnUNetPlans__3d_fullres/crossval_results_folds_0_1_2_3_4/PETCT_3f3df20439_05092005.nii.gz,/well/papiez/users/hri611/python/nnUnet_raw/Dataset219_PETCT/labelsTr/PETCT_3f3df20439_05092005.nii.gz,0.0,0.0373230628967285,0.0,2,0
203,203,0.6499754540991655,1121,6722,0.4814545454545454,45584875,7282,14004,8403,/well/papiez/users/hri611/python/nnUNet_results/Dataset219_PETCT/nnUNetTrainer_1500epochs_NoMirroring__nnUNetPlans__3d_fullres/crossval_results_folds_0_1_2_3_4/PETCT_3f5a9f616f_06032007.nii.gz,/well/papiez/users/hri611/python/nnUnet_raw/Dataset219_PETCT/labelsTr/PETCT_3f5a9f616f_06032007.nii.gz,0.6499754540991655,1.965681312561035,4.279711212158203,47,64
204,204,0.7235978520286396,3588,118,0.566904288886292,45431443,4851,4969,8439,/well/papiez/users/hri611/python/nnUNet_results/Dataset219_PETCT/nnUNetTrainer_1500epochs_NoMirroring__nnUNetPlans__3d_fullres/crossval_results_folds_0_1_2_3_4/PETCT_3fd361ec14_10242004.nii.gz,/well/papiez/users/hri611/python/nnUnet_raw/Dataset219_PETCT/labelsTr/PETCT_3fd361ec14_10242004.nii.gz,0.7235978520286396,0.0,2.301588878631592,1,3
205,205,0.0,0,113,0.0,58879887,0,113,0,/well/papiez/users/hri611/python/nnUNet_results/Dataset219_PETCT/nnUNetTrainer_1500epochs_NoMirroring__nnUNetPlans__3d_fullres/crossval_results_folds_0_1_2_3_4/PETCT_402c061122_02222003.nii.gz,/well/papiez/users/hri611/python/nnUnet_raw/Dataset219_PETCT/labelsTr/PETCT_402c061122_02222003.nii.gz,0.0,1.405835369110107,0.0,5,0
206,206,0.0,0,54,0.0,45439946,0,54,0,/well/papiez/users/hri611/python/nnUNet_results/Dataset219_PETCT/nnUNetTrainer_1500epochs_NoMirroring__nnUNetPlans__3d_fullres/crossval_results_folds_0_1_2_3_4/PETCT_402c061122_08252003.nii.gz,/well/papiez/users/hri611/python/nnUnet_raw/Dataset219_PETCT/labelsTr/PETCT_402c061122_08252003.nii.gz,0.0,0.6718151321411132,0.0,6,0
207,207,,0,0,,45120000,0,0,0,/well/papiez/users/hri611/python/nnUNet_results/Dataset219_PETCT/nnUNetTrainer_1500epochs_NoMirroring__nnUNetPlans__3d_fullres/crossval_results_folds_0_1_2_3_4/PETCT_404f8c732f_06142007.nii.gz,/well/papiez/users/hri611/python/nnUnet_raw/Dataset219_PETCT/labelsTr/PETCT_404f8c732f_06142007.nii.gz,,0.0,0.0,0,0
208,208,0.144927536231884,294,1,0.078125,52159680,25,26,319,/well/papiez/users/hri611/python/nnUNet_results/Dataset219_PETCT/nnUNetTrainer_1500epochs_NoMirroring__nnUNetPlans__3d_fullres/crossval_results_folds_0_1_2_3_4/PETCT_4076ea9a15_04292005.nii.gz,/well/papiez/users/hri611/python/nnUnet_raw/Dataset219_PETCT/labelsTr/PETCT_4076ea9a15_04292005.nii.gz,0.144927536231884,0.0,2.5628503189086915,2,4
209,209,0.0,0,3,0.0,79519997,0,3,0,/well/papiez/users/hri611/python/nnUNet_results/Dataset219_PETCT/nnUNetTrainer_1500epochs_NoMirroring__nnUNetPlans__3d_fullres/crossval_results_folds_0_1_2_3_4/PETCT_4095c12e2d_11302006.nii.gz,/well/papiez/users/hri611/python/nnUnet_raw/Dataset219_PETCT/labelsTr/PETCT_4095c12e2d_11302006.nii.gz,0.0,0.0373230628967285,0.0,3,0
210,210,0.6815486571328915,323,590,0.5169312169312169,52158110,977,1567,1300,/well/papiez/users/hri611/python/nnUNet_results/Dataset219_PETCT/nnUNetTrainer_1500epochs_NoMirroring__nnUNetPlans__3d_fullres/crossval_results_folds_0_1_2_3_4/PETCT_40a125468a_07032004.nii.gz,/well/papiez/users/hri611/python/nnUnet_raw/Dataset219_PETCT/labelsTr/PETCT_40a125468a_07032004.nii.gz,0.6815486571328915,6.942089698791504,0.0,9,3
211,211,0.8902868646200301,1345,1707,0.8022675736961451,45424565,12383,14090,13728,/well/papiez/users/hri611/python/nnUNet_results/Dataset219_PETCT/nnUNetTrainer_1500epochs_NoMirroring__nnUNetPlans__3d_fullres/crossval_results_folds_0_1_2_3_4/PETCT_40f0749cb7_10062001.nii.gz,/well/papiez/users/hri611/python/nnUnet_raw/Dataset219_PETCT/labelsTr/PETCT_40f0749cb7_10062001.nii.gz,0.8902868646200301,0.2114973564147949,0.3981126708984375,3,3
212,212,0.0,0,943,0.0,52159057,0,943,0,/well/papiez/users/hri611/python/nnUNet_results/Dataset219_PETCT/nnUNetTrainer_1500epochs_NoMirroring__nnUNetPlans__3d_fullres/crossval_results_folds_0_1_2_3_4/PETCT_411801de5a_08252002.nii.gz,/well/papiez/users/hri611/python/nnUnet_raw/Dataset219_PETCT/labelsTr/PETCT_411801de5a_08252002.nii.gz,0.0,11.73188277053833,0.0,6,0
213,213,,0,0,,53600000,0,0,0,/well/papiez/users/hri611/python/nnUNet_results/Dataset219_PETCT/nnUNetTrainer_1500epochs_NoMirroring__nnUNetPlans__3d_fullres/crossval_results_folds_0_1_2_3_4/PETCT_416d3b9b78_08142006.nii.gz,/well/papiez/users/hri611/python/nnUnet_raw/Dataset219_PETCT/labelsTr/PETCT_416d3b9b78_08142006.nii.gz,,0.0,0.0,0,0
214,214,,0,0,,93760000,0,0,0,/well/papiez/users/hri611/python/nnUNet_results/Dataset219_PETCT/nnUNetTrainer_1500epochs_NoMirroring__nnUNetPlans__3d_fullres/crossval_results_folds_0_1_2_3_4/PETCT_41bd54f97a_03252007.nii.gz,/well/papiez/users/hri611/python/nnUnet_raw/Dataset219_PETCT/labelsTr/PETCT_41bd54f97a_03252007.nii.gz,,0.0,0.0,0,0
215,215,0.0,0,2452,0.0,52157548,0,2452,0,/well/papiez/users/hri611/python/nnUNet_results/Dataset219_PETCT/nnUNetTrainer_1500epochs_NoMirroring__nnUNetPlans__3d_fullres/crossval_results_folds_0_1_2_3_4/PETCT_41f4d41517_11132004.nii.gz,/well/papiez/users/hri611/python/nnUnet_raw/Dataset219_PETCT/labelsTr/PETCT_41f4d41517_11132004.nii.gz,0.0,30.50538340759277,0.0,8,0
216,216,0.0658873538788522,0,879,0.034065934065934,45439090,31,910,31,/well/papiez/users/hri611/python/nnUNet_results/Dataset219_PETCT/nnUNetTrainer_1500epochs_NoMirroring__nnUNetPlans__3d_fullres/crossval_results_folds_0_1_2_3_4/PETCT_41fadf6520_02272003.nii.gz,/well/papiez/users/hri611/python/nnUnet_raw/Dataset219_PETCT/labelsTr/PETCT_41fadf6520_02272003.nii.gz,0.0658873538788522,10.699278030395508,0.0,3,1
217,217,0.7923526287838556,1410,545,0.6561125769569042,92314315,3730,4275,5140,/well/papiez/users/hri611/python/nnUNet_results/Dataset219_PETCT/nnUNetTrainer_1500epochs_NoMirroring__nnUNetPlans__3d_fullres/crossval_results_folds_0_1_2_3_4/PETCT_424e9b79c5_05112003.nii.gz,/well/papiez/users/hri611/python/nnUnet_raw/Dataset219_PETCT/labelsTr/PETCT_424e9b79c5_05112003.nii.gz,0.7923526287838556,6.556418048858642,0.0124410209655761,9,6
218,218,0.8628918330724294,2092,1499,0.7588476260828688,52145109,11300,12799,13392,/well/papiez/users/hri611/python/nnUNet_results/Dataset219_PETCT/nnUNetTrainer_1500epochs_NoMirroring__nnUNetPlans__3d_fullres/crossval_results_folds_0_1_2_3_4/PETCT_4250de48c8_02122001.nii.gz,/well/papiez/users/hri611/python/nnUnet_raw/Dataset219_PETCT/labelsTr/PETCT_4250de48c8_02122001.nii.gz,0.8628918330724294,0.4478767547607422,5.187905742645263,12,11
219,219,0.7568375429681662,2922,332,0.6088001923539312,52151682,5064,5396,7986,/well/papiez/users/hri611/python/nnUNet_results/Dataset219_PETCT/nnUNetTrainer_1500epochs_NoMirroring__nnUNetPlans__3d_fullres/crossval_results_folds_0_1_2_3_4/PETCT_42e9f16c09_01052003.nii.gz,/well/papiez/users/hri611/python/nnUnet_raw/Dataset219_PETCT/labelsTr/PETCT_42e9f16c09_01052003.nii.gz,0.7568375429681662,1.3436302642822264,15.066076389312745,4,5
220,220,0.8143498042199712,10325,1386,0.6868381645095732,45402604,25685,27071,36010,/well/papiez/users/hri611/python/nnUNet_results/Dataset219_PETCT/nnUNetTrainer_1500epochs_NoMirroring__nnUNetPlans__3d_fullres/crossval_results_folds_0_1_2_3_4/PETCT_43323b7d42_05272001.nii.gz,/well/papiez/users/hri611/python/nnUnet_raw/Dataset219_PETCT/labelsTr/PETCT_43323b7d42_05272001.nii.gz,0.8143498042199712,0.5100818595886231,13.672682041168212,9,8
221,221,0.8787995382839554,140,175,0.7838023335621139,50878543,1142,1317,1282,/well/papiez/users/hri611/python/nnUNet_results/Dataset219_PETCT/nnUNetTrainer_1500epochs_NoMirroring__nnUNetPlans__3d_fullres/crossval_results_folds_0_1_2_3_4/PETCT_43647ff727_03022006.nii.gz,/well/papiez/users/hri611/python/nnUnet_raw/Dataset219_PETCT/labelsTr/PETCT_43647ff727_03022006.nii.gz,0.8787995382839554,0.0,0.0,1,1
222,222,,0,0,,45440000,0,0,0,/well/papiez/users/hri611/python/nnUNet_results/Dataset219_PETCT/nnUNetTrainer_1500epochs_NoMirroring__nnUNetPlans__3d_fullres/crossval_results_folds_0_1_2_3_4/PETCT_437d2c96fe_11162003.nii.gz,/well/papiez/users/hri611/python/nnUnet_raw/Dataset219_PETCT/labelsTr/PETCT_437d2c96fe_11162003.nii.gz,,0.0,0.0,0,0
223,223,0.0,0,135,0.0,46399865,0,135,0,/well/papiez/users/hri611/python/nnUNet_results/Dataset219_PETCT/nnUNetTrainer_1500epochs_NoMirroring__nnUNetPlans__3d_fullres/crossval_results_folds_0_1_2_3_4/PETCT_43c9c71b31_05142007.nii.gz,/well/papiez/users/hri611/python/nnUnet_raw/Dataset219_PETCT/labelsTr/PETCT_43c9c71b31_05142007.nii.gz,0.0,1.6795378303527833,0.0,3,0
224,224,0.7028571428571428,0,104,0.5418502202643172,101759773,123,227,123,/well/papiez/users/hri611/python/nnUNet_results/Dataset219_PETCT/nnUNetTrainer_1500epochs_NoMirroring__nnUNetPlans__3d_fullres/crossval_results_folds_0_1_2_3_4/PETCT_4404466919_09102005.nii.gz,/well/papiez/users/hri611/python/nnUnet_raw/Dataset219_PETCT/labelsTr/PETCT_4404466919_09102005.nii.gz,0.7028571428571428,0.796225341796875,0.0,3,1
225,225,0.0,0,24,0.0,45439976,0,24,0,/well/papiez/users/hri611/python/nnUNet_results/Dataset219_PETCT/nnUNetTrainer_1500epochs_NoMirroring__nnUNetPlans__3d_fullres/crossval_results_folds_0_1_2_3_4/PETCT_4481687483_10172003.nii.gz,/well/papiez/users/hri611/python/nnUnet_raw/Dataset219_PETCT/labelsTr/PETCT_4481687483_10172003.nii.gz,0.0,0.2985845031738281,0.0,2,0
226,226,0.0,0,79,0.0,87839921,0,79,0,/well/papiez/users/hri611/python/nnUNet_results/Dataset219_PETCT/nnUNetTrainer_1500epochs_NoMirroring__nnUNetPlans__3d_fullres/crossval_results_folds_0_1_2_3_4/PETCT_448225c237_01162006.nii.gz,/well/papiez/users/hri611/python/nnUnet_raw/Dataset219_PETCT/labelsTr/PETCT_448225c237_01162006.nii.gz,0.0,0.9828406562805176,0.0,1,0
227,227,0.9031383872571064,4966,11404,0.8233840775944846,45347313,76317,87721,81283,/well/papiez/users/hri611/python/nnUNet_results/Dataset219_PETCT/nnUNetTrainer_1500epochs_NoMirroring__nnUNetPlans__3d_fullres/crossval_results_folds_0_1_2_3_4/PETCT_44b08f570e_02102001.nii.gz,/well/papiez/users/hri611/python/nnUnet_raw/Dataset219_PETCT/labelsTr/PETCT_44b08f570e_02102001.nii.gz,0.9031383872571064,42.24970719909668,0.1741742935180664,19,12
228,228,0.0,0,34,0.0,52159966,0,34,0,/well/papiez/users/hri611/python/nnUNet_results/Dataset219_PETCT/nnUNetTrainer_1500epochs_NoMirroring__nnUNetPlans__3d_fullres/crossval_results_folds_0_1_2_3_4/PETCT_44b95650c3_10022003.nii.gz,/well/papiez/users/hri611/python/nnUnet_raw/Dataset219_PETCT/labelsTr/PETCT_44b95650c3_10022003.nii.gz,0.0,0.4229947128295898,0.0,2,0
229,229,0.0,0,313,0.0,52159687,0,313,0,/well/papiez/users/hri611/python/nnUNet_results/Dataset219_PETCT/nnUNetTrainer_1500epochs_NoMirroring__nnUNetPlans__3d_fullres/crossval_results_folds_0_1_2_3_4/PETCT_44bf7dc508_07252002.nii.gz,/well/papiez/users/hri611/python/nnUnet_raw/Dataset219_PETCT/labelsTr/PETCT_44bf7dc508_07252002.nii.gz,0.0,3.8940395622253416,0.0,4,0
230,230,0.0,0,265,0.0,99039735,0,265,0,/well/papiez/users/hri611/python/nnUNet_results/Dataset219_PETCT/nnUNetTrainer_1500epochs_NoMirroring__nnUNetPlans__3d_fullres/crossval_results_folds_0_1_2_3_4/PETCT_44c04dcf65_10032003.nii.gz,/well/papiez/users/hri611/python/nnUnet_raw/Dataset219_PETCT/labelsTr/PETCT_44c04dcf65_10032003.nii.gz,0.0,3.2968705558776854,0.0,3,0
231,231,,0,0,,93600000,0,0,0,/well/papiez/users/hri611/python/nnUNet_results/Dataset219_PETCT/nnUNetTrainer_1500epochs_NoMirroring__nnUNetPlans__3d_fullres/crossval_results_folds_0_1_2_3_4/PETCT_44cfacfd6e_04152007.nii.gz,/well/papiez/users/hri611/python/nnUnet_raw/Dataset219_PETCT/labelsTr/PETCT_44cfacfd6e_04152007.nii.gz,,0.0,0.0,0,0
232,232,0.0,0,100,0.0,38719900,0,100,0,/well/papiez/users/hri611/python/nnUNet_results/Dataset219_PETCT/nnUNetTrainer_1500epochs_NoMirroring__nnUNetPlans__3d_fullres/crossval_results_folds_0_1_2_3_4/PETCT_44d6ba6772_07132003.nii.gz,/well/papiez/users/hri611/python/nnUnet_raw/Dataset219_PETCT/labelsTr/PETCT_44d6ba6772_07132003.nii.gz,0.0,1.2441020965576173,0.0,1,0
233,233,0.9471682163989856,8,242,0.8996386993175431,52157509,2241,2483,2249,/well/papiez/users/hri611/python/nnUNet_results/Dataset219_PETCT/nnUNetTrainer_1500epochs_NoMirroring__nnUNetPlans__3d_fullres/crossval_results_folds_0_1_2_3_4/PETCT_456d14846b_09012003.nii.gz,/well/papiez/users/hri611/python/nnUnet_raw/Dataset219_PETCT/labelsTr/PETCT_456d14846b_09012003.nii.gz,0.9471682163989856,0.1866153144836425,0.0,2,1
234,234,0.6515151515151515,74,18,0.4831460674157303,52479822,86,104,160,/well/papiez/users/hri611/python/nnUNet_results/Dataset219_PETCT/nnUNetTrainer_1500epochs_NoMirroring__nnUNetPlans__3d_fullres/crossval_results_folds_0_1_2_3_4/PETCT_456e6f9dc2_07282005.nii.gz,/well/papiez/users/hri611/python/nnUnet_raw/Dataset219_PETCT/labelsTr/PETCT_456e6f9dc2_07282005.nii.gz,0.6515151515151515,0.2239383773803711,0.0,2,1
235,235,0.6771212545505461,2296,10,0.5118543607112617,45435276,2418,2428,4714,/well/papiez/users/hri611/python/nnUNet_results/Dataset219_PETCT/nnUNetTrainer_1500epochs_NoMirroring__nnUNetPlans__3d_fullres/crossval_results_folds_0_1_2_3_4/PETCT_465176d213_05162002.nii.gz,/well/papiez/users/hri611/python/nnUnet_raw/Dataset219_PETCT/labelsTr/PETCT_465176d213_05162002.nii.gz,0.6771212545505461,0.0,9.927934730529785,3,4
236,236,0.8561946902654868,103,157,0.7485493230174082,48638966,774,931,877,/well/papiez/users/hri611/python/nnUNet_results/Dataset219_PETCT/nnUNetTrainer_1500epochs_NoMirroring__nnUNetPlans__3d_fullres/crossval_results_folds_0_1_2_3_4/PETCT_46ee4ddd68_03192007.nii.gz,/well/papiez/users/hri611/python/nnUnet_raw/Dataset219_PETCT/labelsTr/PETCT_46ee4ddd68_03192007.nii.gz,0.8561946902654868,0.2861434822082519,0.1866153144836425,11,10
237,237,0.0,0,177,0.0,45439823,0,177,0,/well/papiez/users/hri611/python/nnUNet_results/Dataset219_PETCT/nnUNetTrainer_1500epochs_NoMirroring__nnUNetPlans__3d_fullres/crossval_results_folds_0_1_2_3_4/PETCT_474d7af918_12092004.nii.gz,/well/papiez/users/hri611/python/nnUnet_raw/Dataset219_PETCT/labelsTr/PETCT_474d7af918_12092004.nii.gz,0.0,2.2020607109069825,0.0,2,0
238,238,0.9369940974024724,1556,1721,0.8814570973809869,103812356,24367,26088,25923,/well/papiez/users/hri611/python/nnUNet_results/Dataset219_PETCT/nnUNetTrainer_1500epochs_NoMirroring__nnUNetPlans__3d_fullres/crossval_results_folds_0_1_2_3_4/PETCT_4776e75543_04012007.nii.gz,/well/papiez/users/hri611/python/nnUnet_raw/Dataset219_PETCT/labelsTr/PETCT_4776e75543_04012007.nii.gz,0.9369940974024724,1.443158432006836,0.0,7,4
239,239,0.0,0,1831,0.0,51838169,0,1831,0,/well/papiez/users/hri611/python/nnUNet_results/Dataset219_PETCT/nnUNetTrainer_1500epochs_NoMirroring__nnUNetPlans__3d_fullres/crossval_results_folds_0_1_2_3_4/PETCT_4785066413_08242006.nii.gz,/well/papiez/users/hri611/python/nnUnet_raw/Dataset219_PETCT/labelsTr/PETCT_4785066413_08242006.nii.gz,0.0,22.77950938796997,0.0,3,0
240,240,0.519185360094451,8357,1417,0.3506079330277058,52144949,5277,6694,13634,/well/papiez/users/hri611/python/nnUNet_results/Dataset219_PETCT/nnUNetTrainer_1500epochs_NoMirroring__nnUNetPlans__3d_fullres/crossval_results_folds_0_1_2_3_4/PETCT_47cd731006_01252002.nii.gz,/well/papiez/users/hri611/python/nnUnet_raw/Dataset219_PETCT/labelsTr/PETCT_47cd731006_01252002.nii.gz,0.519185360094451,1.3436302642822264,0.0,26,12
241,241,,0,0,,50400000,0,0,0,/well/papiez/users/hri611/python/nnUNet_results/Dataset219_PETCT/nnUNetTrainer_1500epochs_NoMirroring__nnUNetPlans__3d_fullres/crossval_results_folds_0_1_2_3_4/PETCT_47f4460050_08062006.nii.gz,/well/papiez/users/hri611/python/nnUnet_raw/Dataset219_PETCT/labelsTr/PETCT_47f4460050_08062006.nii.gz,,0.0,0.0,0,0
242,242,0.872389409636573,591,5617,0.7736619512906519,52132572,21220,26837,21811,/well/papiez/users/hri611/python/nnUNet_results/Dataset219_PETCT/nnUNetTrainer_1500epochs_NoMirroring__nnUNetPlans__3d_fullres/crossval_results_folds_0_1_2_3_4/PETCT_4848bebb10_02232003.nii.gz,/well/papiez/users/hri611/python/nnUnet_raw/Dataset219_PETCT/labelsTr/PETCT_4848bebb10_02232003.nii.gz,0.872389409636573,1.59245068359375,0.7340202369689941,9,21
243,243,0.0,0,319,0.0,52159681,0,319,0,/well/papiez/users/hri611/python/nnUNet_results/Dataset219_PETCT/nnUNetTrainer_1500epochs_NoMirroring__nnUNetPlans__3d_fullres/crossval_results_folds_0_1_2_3_4/PETCT_48a34ccdf0_02152003.nii.gz,/well/papiez/users/hri611/python/nnUnet_raw/Dataset219_PETCT/labelsTr/PETCT_48a34ccdf0_02152003.nii.gz,0.0,3.968685688018799,0.0,5,0
244,244,,0,0,,58400000,0,0,0,/well/papiez/users/hri611/python/nnUNet_results/Dataset219_PETCT/nnUNetTrainer_1500epochs_NoMirroring__nnUNetPlans__3d_fullres/crossval_results_folds_0_1_2_3_4/PETCT_48c70dc4a3_04132007.nii.gz,/well/papiez/users/hri611/python/nnUnet_raw/Dataset219_PETCT/labelsTr/PETCT_48c70dc4a3_04132007.nii.gz,,0.0,0.0,0,0
245,245,,0,0,,44960000,0,0,0,/well/papiez/users/hri611/python/nnUNet_results/Dataset219_PETCT/nnUNetTrainer_1500epochs_NoMirroring__nnUNetPlans__3d_fullres/crossval_results_folds_0_1_2_3_4/PETCT_48c70dc4a3_10202006.nii.gz,/well/papiez/users/hri611/python/nnUnet_raw/Dataset219_PETCT/labelsTr/PETCT_48c70dc4a3_10202006.nii.gz,,0.0,0.0,0,0
246,246,0.701779359430605,1565,530,0.5405701754385965,92315440,2465,2995,4030,/well/papiez/users/hri611/python/nnUNet_results/Dataset219_PETCT/nnUNetTrainer_1500epochs_NoMirroring__nnUNetPlans__3d_fullres/crossval_results_folds_0_1_2_3_4/PETCT_48cb8662f7_03072003.nii.gz,/well/papiez/users/hri611/python/nnUnet_raw/Dataset219_PETCT/labelsTr/PETCT_48cb8662f7_03072003.nii.gz,0.701779359430605,2.003004375457764,3.0729321784973145,11,14
247,247,,0,0,,49120000,0,0,0,/well/papiez/users/hri611/python/nnUNet_results/Dataset219_PETCT/nnUNetTrainer_1500epochs_NoMirroring__nnUNetPlans__3d_fullres/crossval_results_folds_0_1_2_3_4/PETCT_48d5467561_01272006.nii.gz,/well/papiez/users/hri611/python/nnUnet_raw/Dataset219_PETCT/labelsTr/PETCT_48d5467561_01272006.nii.gz,,0.0,0.0,0,0
248,248,0.0,0,87,0.0,51039913,0,87,0,/well/papiez/users/hri611/python/nnUNet_results/Dataset219_PETCT/nnUNetTrainer_1500epochs_NoMirroring__nnUNetPlans__3d_fullres/crossval_results_folds_0_1_2_3_4/PETCT_48d5467561_10282005.nii.gz,/well/papiez/users/hri611/python/nnUnet_raw/Dataset219_PETCT/labelsTr/PETCT_48d5467561_10282005.nii.gz,0.0,1.082368824005127,0.0,1,0
249,249,0.878774800835151,10000,393,0.7837629777583588,52111937,37670,38063,47670,/well/papiez/users/hri611/python/nnUNet_results/Dataset219_PETCT/nnUNetTrainer_1500epochs_NoMirroring__nnUNetPlans__3d_fullres/crossval_results_folds_0_1_2_3_4/PETCT_49479d6e64_06072002.nii.gz,/well/papiez/users/hri611/python/nnUnet_raw/Dataset219_PETCT/labelsTr/PETCT_49479d6e64_06072002.nii.gz,0.878774800835151,0.0,2.314029899597168,8,9
250,250,0.6313659359190557,536,557,0.4613109906357812,52157971,936,1493,1472,/well/papiez/users/hri611/python/nnUNet_results/Dataset219_PETCT/nnUNetTrainer_1500epochs_NoMirroring__nnUNetPlans__3d_fullres/crossval_results_folds_0_1_2_3_4/PETCT_49f3d297b0_07242003.nii.gz,/well/papiez/users/hri611/python/nnUnet_raw/Dataset219_PETCT/labelsTr/PETCT_49f3d297b0_07242003.nii.gz,0.6313659359190557,5.623341476440429,0.8957535095214844,9,8
251,251,,0,0,,36160000,0,0,0,/well/papiez/users/hri611/python/nnUNet_results/Dataset219_PETCT/nnUNetTrainer_1500epochs_NoMirroring__nnUNetPlans__3d_fullres/crossval_results_folds_0_1_2_3_4/PETCT_4a0d2e5166_11242006.nii.gz,/well/papiez/users/hri611/python/nnUnet_raw/Dataset219_PETCT/labelsTr/PETCT_4a0d2e5166_11242006.nii.gz,,0.0,0.0,0,0
252,252,0.5799930289299408,840,365,0.4084437898870888,45437963,832,1197,1672,/well/papiez/users/hri611/python/nnUNet_results/Dataset219_PETCT/nnUNetTrainer_1500epochs_NoMirroring__nnUNetPlans__3d_fullres/crossval_results_folds_0_1_2_3_4/PETCT_4a255db7bd_05242003.nii.gz,/well/papiez/users/hri611/python/nnUnet_raw/Dataset219_PETCT/labelsTr/PETCT_4a255db7bd_05242003.nii.gz,0.5799930289299408,1.4804814949035645,3.495926891326904,11,13
253,253,0.3855403661661025,2657,95914,0.238804587049693,52030505,30924,126838,33581,/well/papiez/users/hri611/python/nnUNet_results/Dataset219_PETCT/nnUNetTrainer_1500epochs_NoMirroring__nnUNetPlans__3d_fullres/crossval_results_folds_0_1_2_3_4/PETCT_4b688f46b0_02182005.nii.gz,/well/papiez/users/hri611/python/nnUnet_raw/Dataset219_PETCT/labelsTr/PETCT_4b688f46b0_02182005.nii.gz,0.3855403661661025,2.699701549530029,0.1866153144836425,14,127
254,254,,0,0,,44960000,0,0,0,/well/papiez/users/hri611/python/nnUNet_results/Dataset219_PETCT/nnUNetTrainer_1500epochs_NoMirroring__nnUNetPlans__3d_fullres/crossval_results_folds_0_1_2_3_4/PETCT_4bab91dccd_01052006.nii.gz,/well/papiez/users/hri611/python/nnUnet_raw/Dataset219_PETCT/labelsTr/PETCT_4bab91dccd_01052006.nii.gz,,0.0,0.0,0,0
255,255,0.6680032076984763,1539,117,0.5015051173991572,45436678,1666,1783,3205,/well/papiez/users/hri611/python/nnUNet_results/Dataset219_PETCT/nnUNetTrainer_1500epochs_NoMirroring__nnUNetPlans__3d_fullres/crossval_results_folds_0_1_2_3_4/PETCT_4be28f9cd7_02032002.nii.gz,/well/papiez/users/hri611/python/nnUnet_raw/Dataset219_PETCT/labelsTr/PETCT_4be28f9cd7_02032002.nii.gz,0.6680032076984763,0.6966971740722656,3.0729321784973145,10,6
256,256,0.8853987221073131,17382,2509,0.7943636344839706,98943271,76838,79347,94220,/well/papiez/users/hri611/python/nnUNet_results/Dataset219_PETCT/nnUNetTrainer_1500epochs_NoMirroring__nnUNetPlans__3d_fullres/crossval_results_folds_0_1_2_3_4/PETCT_4c670a5445_06222001.nii.gz,/well/papiez/users/hri611/python/nnUnet_raw/Dataset219_PETCT/labelsTr/PETCT_4c670a5445_06222001.nii.gz,0.8853987221073131,6.606182132720948,0.0,16,4
257,257,0.36900739310485,90688,8658,0.2262471280034269,52031605,29049,37707,119737,/well/papiez/users/hri611/python/nnUNet_results/Dataset219_PETCT/nnUNetTrainer_1500epochs_NoMirroring__nnUNetPlans__3d_fullres/crossval_results_folds_0_1_2_3_4/PETCT_4c75fa4a5d_04192001.nii.gz,/well/papiez/users/hri611/python/nnUnet_raw/Dataset219_PETCT/labelsTr/PETCT_4c75fa4a5d_04192001.nii.gz,0.36900739310485,0.0124410209655761,302.00578393936155,41,162
258,258,0.8639969480381047,4539,7582,0.7605586503891588,52109378,38501,46083,43040,/well/papiez/users/hri611/python/nnUNet_results/Dataset219_PETCT/nnUNetTrainer_1500epochs_NoMirroring__nnUNetPlans__3d_fullres/crossval_results_folds_0_1_2_3_4/PETCT_4c9e7be363_09172000.nii.gz,/well/papiez/users/hri611/python/nnUnet_raw/Dataset219_PETCT/labelsTr/PETCT_4c9e7be363_09172000.nii.gz,0.8639969480381047,2.985845031738281,1.6297737464904785,18,9
259,259,0.0254237288135593,51,179,0.0128755364806866,85599767,3,182,54,/well/papiez/users/hri611/python/nnUNet_results/Dataset219_PETCT/nnUNetTrainer_1500epochs_NoMirroring__nnUNetPlans__3d_fullres/crossval_results_folds_0_1_2_3_4/PETCT_4cb875dc0b_01132005.nii.gz,/well/papiez/users/hri611/python/nnUnet_raw/Dataset219_PETCT/labelsTr/PETCT_4cb875dc0b_01132005.nii.gz,0.0254237288135593,2.2269427528381347,0.0,3,1
260,260,,0,0,,48160000,0,0,0,/well/papiez/users/hri611/python/nnUNet_results/Dataset219_PETCT/nnUNetTrainer_1500epochs_NoMirroring__nnUNetPlans__3d_fullres/crossval_results_folds_0_1_2_3_4/PETCT_4cc808d16f_06112006.nii.gz,/well/papiez/users/hri611/python/nnUnet_raw/Dataset219_PETCT/labelsTr/PETCT_4cc808d16f_06112006.nii.gz,,0.0,0.0,0,0
261,261,0.5387982491046558,3357,120,0.3687363834422658,45434492,2031,2151,5388,/well/papiez/users/hri611/python/nnUNet_results/Dataset219_PETCT/nnUNetTrainer_1500epochs_NoMirroring__nnUNetPlans__3d_fullres/crossval_results_folds_0_1_2_3_4/PETCT_4dcf62f869_11032000.nii.gz,/well/papiez/users/hri611/python/nnUnet_raw/Dataset219_PETCT/labelsTr/PETCT_4dcf62f869_11032000.nii.gz,0.5387982491046558,1.1818969917297364,14.282292068481445,5,7
262,262,0.0,0,2,0.0,52159998,0,2,0,/well/papiez/users/hri611/python/nnUNet_results/Dataset219_PETCT/nnUNetTrainer_1500epochs_NoMirroring__nnUNetPlans__3d_fullres/crossval_results_folds_0_1_2_3_4/PETCT_4ea806706c_10302003.nii.gz,/well/papiez/users/hri611/python/nnUnet_raw/Dataset219_PETCT/labelsTr/PETCT_4ea806706c_10302003.nii.gz,0.0,0.0248820419311523,0.0,1,0
263,263,0.0,0,461,0.0,38719539,0,461,0,/well/papiez/users/hri611/python/nnUNet_results/Dataset219_PETCT/nnUNetTrainer_1500epochs_NoMirroring__nnUNetPlans__3d_fullres/crossval_results_folds_0_1_2_3_4/PETCT_4ef69de4e1_10252002.nii.gz,/well/papiez/users/hri611/python/nnUnet_raw/Dataset219_PETCT/labelsTr/PETCT_4ef69de4e1_10252002.nii.gz,0.0,5.735310665130615,0.0,4,0
264,264,0.0,0,491,0.0,89439509,0,491,0,/well/papiez/users/hri611/python/nnUNet_results/Dataset219_PETCT/nnUNetTrainer_1500epochs_NoMirroring__nnUNetPlans__3d_fullres/crossval_results_folds_0_1_2_3_4/PETCT_4f6ff86453_08252006.nii.gz,/well/papiez/users/hri611/python/nnUnet_raw/Dataset219_PETCT/labelsTr/PETCT_4f6ff86453_08252006.nii.gz,0.0,6.1085412940979005,0.0,6,0
265,265,0.7053338306602014,15668,1712,0.5447997695188707,52121819,20801,22513,36469,/well/papiez/users/hri611/python/nnUNet_results/Dataset219_PETCT/nnUNetTrainer_1500epochs_NoMirroring__nnUNetPlans__3d_fullres/crossval_results_folds_0_1_2_3_4/PETCT_4f7a8f41c0_05272001.nii.gz,/well/papiez/users/hri611/python/nnUnet_raw/Dataset219_PETCT/labelsTr/PETCT_4f7a8f41c0_05272001.nii.gz,0.7053338306602014,0.9206355514526368,15.52639416503906,24,31
266,266,0.0,0,17,0.0,42399983,0,17,0,/well/papiez/users/hri611/python/nnUNet_results/Dataset219_PETCT/nnUNetTrainer_1500epochs_NoMirroring__nnUNetPlans__3d_fullres/crossval_results_folds_0_1_2_3_4/PETCT_4fb1817df3_06062005.nii.gz,/well/papiez/users/hri611/python/nnUnet_raw/Dataset219_PETCT/labelsTr/PETCT_4fb1817df3_06062005.nii.gz,0.0,0.2114973564147949,0.0,2,0
267,267,,0,0,,45440000,0,0,0,/well/papiez/users/hri611/python/nnUNet_results/Dataset219_PETCT/nnUNetTrainer_1500epochs_NoMirroring__nnUNetPlans__3d_fullres/crossval_results_folds_0_1_2_3_4/PETCT_5001354a69_11282002.nii.gz,/well/papiez/users/hri611/python/nnUnet_raw/Dataset219_PETCT/labelsTr/PETCT_5001354a69_11282002.nii.gz,,0.0,0.0,0,0
268,268,0.6320754716981132,156,0,0.4620689655172413,52159710,134,134,290,/well/papiez/users/hri611/python/nnUNet_results/Dataset219_PETCT/nnUNetTrainer_1500epochs_NoMirroring__nnUNetPlans__3d_fullres/crossval_results_folds_0_1_2_3_4/PETCT_5060603ba4_09192003.nii.gz,/well/papiez/users/hri611/python/nnUnet_raw/Dataset219_PETCT/labelsTr/PETCT_5060603ba4_09192003.nii.gz,0.6320754716981132,0.0,0.7464612579345703,2,3
269,269,0.0,0,7,0.0,52159993,0,7,0,/well/papiez/users/hri611/python/nnUNet_results/Dataset219_PETCT/nnUNetTrainer_1500epochs_NoMirroring__nnUNetPlans__3d_fullres/crossval_results_folds_0_1_2_3_4/PETCT_5109748328_08032002.nii.gz,/well/papiez/users/hri611/python/nnUnet_raw/Dataset219_PETCT/labelsTr/PETCT_5109748328_08032002.nii.gz,0.0,0.0870871467590332,0.0,2,0
270,270,0.9075475039850214,6893,415,0.8307432197697848,45396823,35869,36284,42762,/well/papiez/users/hri611/python/nnUNet_results/Dataset219_PETCT/nnUNetTrainer_1500epochs_NoMirroring__nnUNetPlans__3d_fullres/crossval_results_folds_0_1_2_3_4/PETCT_510fb36781_02062003.nii.gz,/well/papiez/users/hri611/python/nnUnet_raw/Dataset219_PETCT/labelsTr/PETCT_510fb36781_02062003.nii.gz,0.9075475039850214,0.149292251586914,0.0,5,2
271,271,,0,0,,43680000,0,0,0,/well/papiez/users/hri611/python/nnUNet_results/Dataset219_PETCT/nnUNetTrainer_1500epochs_NoMirroring__nnUNetPlans__3d_fullres/crossval_results_folds_0_1_2_3_4/PETCT_515c40c4a6_07242006.nii.gz,/well/papiez/users/hri611/python/nnUnet_raw/Dataset219_PETCT/labelsTr/PETCT_515c40c4a6_07242006.nii.gz,,0.0,0.0,0,0
272,272,0.6395859120063013,5925,481,0.4701406120760959,45427910,5684,6165,11609,/well/papiez/users/hri611/python/nnUNet_results/Dataset219_PETCT/nnUNetTrainer_1500epochs_NoMirroring__nnUNetPlans__3d_fullres/crossval_results_folds_0_1_2_3_4/PETCT_5255c79083_10202001.nii.gz,/well/papiez/users/hri611/python/nnUnet_raw/Dataset219_PETCT/labelsTr/PETCT_5255c79083_10202001.nii.gz,0.6395859120063013,0.8833124885559082,19.258700454711917,11,10
273,273,0.9100301334481274,2417,300,0.834913112164297,45423542,13741,14041,16158,/well/papiez/users/hri611/python/nnUNet_results/Dataset219_PETCT/nnUNetTrainer_1500epochs_NoMirroring__nnUNetPlans__3d_fullres/crossval_results_folds_0_1_2_3_4/PETCT_527c5afc5d_07182003.nii.gz,/well/papiez/users/hri611/python/nnUnet_raw/Dataset219_PETCT/labelsTr/PETCT_527c5afc5d_07182003.nii.gz,0.9100301334481274,2.164737648010254,0.4976408386230468,19,16
274,274,0.0,0,296,0.0,41439704,0,296,0,/well/papiez/users/hri611/python/nnUNet_results/Dataset219_PETCT/nnUNetTrainer_1500epochs_NoMirroring__nnUNetPlans__3d_fullres/crossval_results_folds_0_1_2_3_4/PETCT_52f84711a5_04012006.nii.gz,/well/papiez/users/hri611/python/nnUnet_raw/Dataset219_PETCT/labelsTr/PETCT_52f84711a5_04012006.nii.gz,0.0,3.682542205810547,0.0,3,0
275,275,0.0,0,7,0.0,48479993,0,7,0,/well/papiez/users/hri611/python/nnUNet_results/Dataset219_PETCT/nnUNetTrainer_1500epochs_NoMirroring__nnUNetPlans__3d_fullres/crossval_results_folds_0_1_2_3_4/PETCT_53ccb9efbb_12152005.nii.gz,/well/papiez/users/hri611/python/nnUnet_raw/Dataset219_PETCT/labelsTr/PETCT_53ccb9efbb_12152005.nii.gz,0.0,0.0870871467590332,0.0,1,0
276,276,0.6355528834109926,224,14324,0.4657951749715419,50052767,12685,27009,12909,/well/papiez/users/hri611/python/nnUNet_results/Dataset219_PETCT/nnUNetTrainer_1500epochs_NoMirroring__nnUNetPlans__3d_fullres/crossval_results_folds_0_1_2_3_4/PETCT_53dad1785b_12112005.nii.gz,/well/papiez/users/hri611/python/nnUnet_raw/Dataset219_PETCT/labelsTr/PETCT_53dad1785b_12112005.nii.gz,0.6355528834109926,63.47408896636963,0.2737024612426758,79,46
277,277,0.0,0,13,0.0,46079987,0,13,0,/well/papiez/users/hri611/python/nnUNet_results/Dataset219_PETCT/nnUNetTrainer_1500epochs_NoMirroring__nnUNetPlans__3d_fullres/crossval_results_folds_0_1_2_3_4/PETCT_5420205a5f_12072006.nii.gz,/well/papiez/users/hri611/python/nnUnet_raw/Dataset219_PETCT/labelsTr/PETCT_5420205a5f_12072006.nii.gz,0.0,0.1617332725524902,0.0,2,0
278,278,,0,0,,52480000,0,0,0,/well/papiez/users/hri611/python/nnUNet_results/Dataset219_PETCT/nnUNetTrainer_1500epochs_NoMirroring__nnUNetPlans__3d_fullres/crossval_results_folds_0_1_2_3_4/PETCT_544676de40_03232007.nii.gz,/well/papiez/users/hri611/python/nnUnet_raw/Dataset219_PETCT/labelsTr/PETCT_544676de40_03232007.nii.gz,,0.0,0.0,0,0
279,279,0.8916236601826122,65,481,0.8044412607449857,53437208,2246,2727,2311,/well/papiez/users/hri611/python/nnUNet_results/Dataset219_PETCT/nnUNetTrainer_1500epochs_NoMirroring__nnUNetPlans__3d_fullres/crossval_results_folds_0_1_2_3_4/PETCT_544676de40_07032005.nii.gz,/well/papiez/users/hri611/python/nnUnet_raw/Dataset219_PETCT/labelsTr/PETCT_544676de40_07032005.nii.gz,0.8916236601826122,0.0,0.0,4,4
280,280,0.0,0,22,0.0,50559978,0,22,0,/well/papiez/users/hri611/python/nnUNet_results/Dataset219_PETCT/nnUNetTrainer_1500epochs_NoMirroring__nnUNetPlans__3d_fullres/crossval_results_folds_0_1_2_3_4/PETCT_544676de40_12152005.nii.gz,/well/papiez/users/hri611/python/nnUnet_raw/Dataset219_PETCT/labelsTr/PETCT_544676de40_12152005.nii.gz,0.0,0.2737024612426758,0.0,1,0
281,281,0.9131258457374832,1117,167,0.8401394422310757,48791968,6748,6915,7865,/well/papiez/users/hri611/python/nnUNet_results/Dataset219_PETCT/nnUNetTrainer_1500epochs_NoMirroring__nnUNetPlans__3d_fullres/crossval_results_folds_0_1_2_3_4/PETCT_548213edf7_09192005.nii.gz,/well/papiez/users/hri611/python/nnUnet_raw/Dataset219_PETCT/labelsTr/PETCT_548213edf7_09192005.nii.gz,0.9131258457374832,0.0,0.8211073837280274,7,10
282,282,0.772614792411328,311,516,0.6294802867383512,52157768,1405,1921,1716,/well/papiez/users/hri611/python/nnUNet_results/Dataset219_PETCT/nnUNetTrainer_1500epochs_NoMirroring__nnUNetPlans__3d_fullres/crossval_results_folds_0_1_2_3_4/PETCT_548bd05667_04242004.nii.gz,/well/papiez/users/hri611/python/nnUnet_raw/Dataset219_PETCT/labelsTr/PETCT_548bd05667_04242004.nii.gz,0.772614792411328,0.9828406562805176,0.0,11,6
283,283,0.0,0,2,0.0,45439998,0,2,0,/well/papiez/users/hri611/python/nnUNet_results/Dataset219_PETCT/nnUNetTrainer_1500epochs_NoMirroring__nnUNetPlans__3d_fullres/crossval_results_folds_0_1_2_3_4/PETCT_54977a7e76_02212003.nii.gz,/well/papiez/users/hri611/python/nnUnet_raw/Dataset219_PETCT/labelsTr/PETCT_54977a7e76_02212003.nii.gz,0.0,0.0248820419311523,0.0,1,0
284,284,0.9555708865125906,34,1254,0.914921725345135,58864861,13851,15105,13885,/well/papiez/users/hri611/python/nnUNet_results/Dataset219_PETCT/nnUNetTrainer_1500epochs_NoMirroring__nnUNetPlans__3d_fullres/crossval_results_folds_0_1_2_3_4/PETCT_556b56485a_08292003.nii.gz,/well/papiez/users/hri611/python/nnUnet_raw/Dataset219_PETCT/labelsTr/PETCT_556b56485a_08292003.nii.gz,0.9555708865125906,1.2565431175231934,0.0248820419311523,4,3
285,285,0.0,0,61,0.0,50879939,0,61,0,/well/papiez/users/hri611/python/nnUNet_results/Dataset219_PETCT/nnUNetTrainer_1500epochs_NoMirroring__nnUNetPlans__3d_fullres/crossval_results_folds_0_1_2_3_4/PETCT_55819a54c2_04142007.nii.gz,/well/papiez/users/hri611/python/nnUnet_raw/Dataset219_PETCT/labelsTr/PETCT_55819a54c2_04142007.nii.gz,0.0,0.7589022789001465,0.0,2,0
286,286,0.0,58,2,0.0,52159940,0,2,58,/well/papiez/users/hri611/python/nnUNet_results/Dataset219_PETCT/nnUNetTrainer_1500epochs_NoMirroring__nnUNetPlans__3d_fullres/crossval_results_folds_0_1_2_3_4/PETCT_55ae7986e1_05102003.nii.gz,/well/papiez/users/hri611/python/nnUnet_raw/Dataset219_PETCT/labelsTr/PETCT_55ae7986e1_05102003.nii.gz,0.0,0.0248820419311523,0.721579216003418,1,1
287,287,0.8845648984634391,467,5513,0.7930222899072408,52131108,22912,28425,23379,/well/papiez/users/hri611/python/nnUNet_results/Dataset219_PETCT/nnUNetTrainer_1500epochs_NoMirroring__nnUNetPlans__3d_fullres/crossval_results_folds_0_1_2_3_4/PETCT_55ca11402a_06052003.nii.gz,/well/papiez/users/hri611/python/nnUnet_raw/Dataset219_PETCT/labelsTr/PETCT_55ca11402a_06052003.nii.gz,0.8845648984634391,0.5225228805541993,0.2737024612426758,17,27
288,288,0.0,0,311,0.0,92959689,0,311,0,/well/papiez/users/hri611/python/nnUNet_results/Dataset219_PETCT/nnUNetTrainer_1500epochs_NoMirroring__nnUNetPlans__3d_fullres/crossval_results_folds_0_1_2_3_4/PETCT_55d55902c6_05112006.nii.gz,/well/papiez/users/hri611/python/nnUnet_raw/Dataset219_PETCT/labelsTr/PETCT_55d55902c6_05112006.nii.gz,0.0,3.8691575202941895,0.0,1,0
289,289,,0,0,,51520000,0,0,0,/well/papiez/users/hri611/python/nnUNet_results/Dataset219_PETCT/nnUNetTrainer_1500epochs_NoMirroring__nnUNetPlans__3d_fullres/crossval_results_folds_0_1_2_3_4/PETCT_55e3e62722_03032007.nii.gz,/well/papiez/users/hri611/python/nnUnet_raw/Dataset219_PETCT/labelsTr/PETCT_55e3e62722_03032007.nii.gz,,0.0,0.0,0,0
290,290,0.0,0,1,0.0,55999999,0,1,0,/well/papiez/users/hri611/python/nnUNet_results/Dataset219_PETCT/nnUNetTrainer_1500epochs_NoMirroring__nnUNetPlans__3d_fullres/crossval_results_folds_0_1_2_3_4/PETCT_57c05962c1_09302005.nii.gz,/well/papiez/users/hri611/python/nnUnet_raw/Dataset219_PETCT/labelsTr/PETCT_57c05962c1_09302005.nii.gz,0.0,0.0124410209655761,0.0,1,0
291,291,0.8323465703971119,1121,40,0.7128370022260697,52155957,2882,2922,4003,/well/papiez/users/hri611/python/nnUNet_results/Dataset219_PETCT/nnUNetTrainer_1500epochs_NoMirroring__nnUNetPlans__3d_fullres/crossval_results_folds_0_1_2_3_4/PETCT_581fa95eb0_03242003.nii.gz,/well/papiez/users/hri611/python/nnUnet_raw/Dataset219_PETCT/labelsTr/PETCT_581fa95eb0_03242003.nii.gz,0.8323465703971119,0.2861434822082519,0.0,3,2
292,292,0.0,0,2,0.0,52159998,0,2,0,/well/papiez/users/hri611/python/nnUNet_results/Dataset219_PETCT/nnUNetTrainer_1500epochs_NoMirroring__nnUNetPlans__3d_fullres/crossval_results_folds_0_1_2_3_4/PETCT_591b3025ff_11132004.nii.gz,/well/papiez/users/hri611/python/nnUnet_raw/Dataset219_PETCT/labelsTr/PETCT_591b3025ff_11132004.nii.gz,0.0,0.0248820419311523,0.0,1,0
293,293,0.7139107611548556,6,103,0.5551020408163265,44319755,136,239,142,/well/papiez/users/hri611/python/nnUNet_results/Dataset219_PETCT/nnUNetTrainer_1500epochs_NoMirroring__nnUNetPlans__3d_fullres/crossval_results_folds_0_1_2_3_4/PETCT_59309d6625_03032006.nii.gz,/well/papiez/users/hri611/python/nnUnet_raw/Dataset219_PETCT/labelsTr/PETCT_59309d6625_03032006.nii.gz,0.7139107611548556,1.1196918869018555,0.0,3,2
294,294,0.0,0,476,0.0,48799524,0,476,0,/well/papiez/users/hri611/python/nnUNet_results/Dataset219_PETCT/nnUNetTrainer_1500epochs_NoMirroring__nnUNetPlans__3d_fullres/crossval_results_folds_0_1_2_3_4/PETCT_5951afb86e_03172006.nii.gz,/well/papiez/users/hri611/python/nnUnet_raw/Dataset219_PETCT/labelsTr/PETCT_5951afb86e_03172006.nii.gz,0.0,5.921925979614258,0.0,4,0
295,295,0.0,0,255,0.0,48159745,0,255,0,/well/papiez/users/hri611/python/nnUNet_results/Dataset219_PETCT/nnUNetTrainer_1500epochs_NoMirroring__nnUNetPlans__3d_fullres/crossval_results_folds_0_1_2_3_4/PETCT_595975bc57_03102006.nii.gz,/well/papiez/users/hri611/python/nnUnet_raw/Dataset219_PETCT/labelsTr/PETCT_595975bc57_03102006.nii.gz,0.0,3.172460346221924,0.0,2,0
296,296,0.787762447510498,1506,263,0.6498416468725258,51194948,3283,3546,4789,/well/papiez/users/hri611/python/nnUNet_results/Dataset219_PETCT/nnUNetTrainer_1500epochs_NoMirroring__nnUNetPlans__3d_fullres/crossval_results_folds_0_1_2_3_4/PETCT_59e6d1de22_08062005.nii.gz,/well/papiez/users/hri611/python/nnUnet_raw/Dataset219_PETCT/labelsTr/PETCT_59e6d1de22_08062005.nii.gz,0.787762447510498,0.7091381950378418,0.3110255241394043,10,11
297,297,0.0,0,130,0.0,52159870,0,130,0,/well/papiez/users/hri611/python/nnUNet_results/Dataset219_PETCT/nnUNetTrainer_1500epochs_NoMirroring__nnUNetPlans__3d_fullres/crossval_results_folds_0_1_2_3_4/PETCT_5a274a0f26_11082004.nii.gz,/well/papiez/users/hri611/python/nnUnet_raw/Dataset219_PETCT/labelsTr/PETCT_5a274a0f26_11082004.nii.gz,0.0,1.6173327255249024,0.0,1,0
298,298,0.8464638768021495,7261,396,0.7337991934362398,52131236,21107,21503,28368,/well/papiez/users/hri611/python/nnUNet_results/Dataset219_PETCT/nnUNetTrainer_1500epochs_NoMirroring__nnUNetPlans__3d_fullres/crossval_results_folds_0_1_2_3_4/PETCT_5ac322455f_05262003.nii.gz,/well/papiez/users/hri611/python/nnUnet_raw/Dataset219_PETCT/labelsTr/PETCT_5ac322455f_05262003.nii.gz,0.8464638768021495,0.5100818595886231,0.2488204193115234,6,11
299,299,0.0,0,213,0.0,52159787,0,213,0,/well/papiez/users/hri611/python/nnUNet_results/Dataset219_PETCT/nnUNetTrainer_1500epochs_NoMirroring__nnUNetPlans__3d_fullres/crossval_results_folds_0_1_2_3_4/PETCT_5ac4fd9091_11142004.nii.gz,/well/papiez/users/hri611/python/nnUnet_raw/Dataset219_PETCT/labelsTr/PETCT_5ac4fd9091_11142004.nii.gz,0.0,2.6499374656677244,0.0,7,0
300,300,,0,0,,47520000,0,0,0,/well/papiez/users/hri611/python/nnUNet_results/Dataset219_PETCT/nnUNetTrainer_1500epochs_NoMirroring__nnUNetPlans__3d_fullres/crossval_results_folds_0_1_2_3_4/PETCT_5b0aa4e971_09102006.nii.gz,/well/papiez/users/hri611/python/nnUnet_raw/Dataset219_PETCT/labelsTr/PETCT_5b0aa4e971_09102006.nii.gz,,0.0,0.0,0,0
301,301,0.0,0,1,0.0,58879999,0,1,0,/well/papiez/users/hri611/python/nnUNet_results/Dataset219_PETCT/nnUNetTrainer_1500epochs_NoMirroring__nnUNetPlans__3d_fullres/crossval_results_folds_0_1_2_3_4/PETCT_5b10c3f524_09122002.nii.gz,/well/papiez/users/hri611/python/nnUnet_raw/Dataset219_PETCT/labelsTr/PETCT_5b10c3f524_09122002.nii.gz,0.0,0.0124410209655761,0.0,1,0
302,302,0.0,0,618,0.0,50399382,0,618,0,/well/papiez/users/hri611/python/nnUNet_results/Dataset219_PETCT/nnUNetTrainer_1500epochs_NoMirroring__nnUNetPlans__3d_fullres/crossval_results_folds_0_1_2_3_4/PETCT_5bd311a5e9_09122005.nii.gz,/well/papiez/users/hri611/python/nnUnet_raw/Dataset219_PETCT/labelsTr/PETCT_5bd311a5e9_09122005.nii.gz,0.0,7.688550956726074,0.0,2,0
303,303,0.7350928641251222,235,36,0.5811437403400309,52159353,376,412,611,/well/papiez/users/hri611/python/nnUNet_results/Dataset219_PETCT/nnUNetTrainer_1500epochs_NoMirroring__nnUNetPlans__3d_fullres/crossval_results_folds_0_1_2_3_4/PETCT_5c1baad5d8_03062003.nii.gz,/well/papiez/users/hri611/python/nnUnet_raw/Dataset219_PETCT/labelsTr/PETCT_5c1baad5d8_03062003.nii.gz,0.7350928641251222,0.2861434822082519,0.0,3,1
304,304,0.8490566037735849,135,41,0.7377049180327869,45439329,495,536,630,/well/papiez/users/hri611/python/nnUNet_results/Dataset219_PETCT/nnUNetTrainer_1500epochs_NoMirroring__nnUNetPlans__3d_fullres/crossval_results_folds_0_1_2_3_4/PETCT_5c35fcbe89_08102002.nii.gz,/well/papiez/users/hri611/python/nnUnet_raw/Dataset219_PETCT/labelsTr/PETCT_5c35fcbe89_08102002.nii.gz,0.8490566037735849,0.0,0.0,2,2
305,305,0.858884957576174,3288,4928,0.7526716638068576,45406781,25003,29931,28291,/well/papiez/users/hri611/python/nnUNet_results/Dataset219_PETCT/nnUNetTrainer_1500epochs_NoMirroring__nnUNetPlans__3d_fullres/crossval_results_folds_0_1_2_3_4/PETCT_5c55b3087d_12112000.nii.gz,/well/papiez/users/hri611/python/nnUnet_raw/Dataset219_PETCT/labelsTr/PETCT_5c55b3087d_12112000.nii.gz,0.858884957576174,34.44918705368042,3.8193934364318847,12,14
306,306,,0,0,,45440000,0,0,0,/well/papiez/users/hri611/python/nnUNet_results/Dataset219_PETCT/nnUNetTrainer_1500epochs_NoMirroring__nnUNetPlans__3d_fullres/crossval_results_folds_0_1_2_3_4/PETCT_5c57a98a43_02242005.nii.gz,/well/papiez/users/hri611/python/nnUnet_raw/Dataset219_PETCT/labelsTr/PETCT_5c57a98a43_02242005.nii.gz,,0.0,0.0,0,0
307,307,0.8570742772103741,5168,6741,0.7498949932795699,52112384,35707,42448,40875,/well/papiez/users/hri611/python/nnUNet_results/Dataset219_PETCT/nnUNetTrainer_1500epochs_NoMirroring__nnUNetPlans__3d_fullres/crossval_results_folds_0_1_2_3_4/PETCT_5cf118ac06_02282004.nii.gz,/well/papiez/users/hri611/python/nnUnet_raw/Dataset219_PETCT/labelsTr/PETCT_5cf118ac06_02282004.nii.gz,0.8570742772103741,22.8168324508667,4.702705924987793,23,19
308,308,0.8876828865828169,1841,7348,0.7980483945407794,47314499,36312,43660,38153,/well/papiez/users/hri611/python/nnUNet_results/Dataset219_PETCT/nnUNetTrainer_1500epochs_NoMirroring__nnUNetPlans__3d_fullres/crossval_results_folds_0_1_2_3_4/PETCT_5d10be5b89_05302005.nii.gz,/well/papiez/users/hri611/python/nnUnet_raw/Dataset219_PETCT/labelsTr/PETCT_5d10be5b89_05302005.nii.gz,0.8876828865828169,6.046336189270019,1.0077226982116698,15,49
309,309,0.6658818088170371,14947,946,0.4991175543649543,52128270,15837,16783,30784,/well/papiez/users/hri611/python/nnUNet_results/Dataset219_PETCT/nnUNetTrainer_1500epochs_NoMirroring__nnUNetPlans__3d_fullres/crossval_results_folds_0_1_2_3_4/PETCT_5d553bf6b4_09162001.nii.gz,/well/papiez/users/hri611/python/nnUnet_raw/Dataset219_PETCT/labelsTr/PETCT_5d553bf6b4_09162001.nii.gz,0.6658818088170371,0.8459894256591797,25.155744392395015,9,12
310,310,0.0,12,412,0.0,46719576,0,412,12,/well/papiez/users/hri611/python/nnUNet_results/Dataset219_PETCT/nnUNetTrainer_1500epochs_NoMirroring__nnUNetPlans__3d_fullres/crossval_results_folds_0_1_2_3_4/PETCT_5d994c3f44_03052006.nii.gz,/well/papiez/users/hri611/python/nnUnet_raw/Dataset219_PETCT/labelsTr/PETCT_5d994c3f44_03052006.nii.gz,0.0,5.125700637817383,0.149292251586914,2,1
311,311,0.9255398361876396,182,18,0.8613998613998614,47518557,1243,1261,1425,/well/papiez/users/hri611/python/nnUNet_results/Dataset219_PETCT/nnUNetTrainer_1500epochs_NoMirroring__nnUNetPlans__3d_fullres/crossval_results_folds_0_1_2_3_4/PETCT_5de3ac617a_11132005.nii.gz,/well/papiez/users/hri611/python/nnUnet_raw/Dataset219_PETCT/labelsTr/PETCT_5de3ac617a_11132005.nii.gz,0.9255398361876396,0.0,0.0,1,1
312,312,0.6947777974280589,11460,621,0.5323061437807286,52134169,13750,14371,25210,/well/papiez/users/hri611/python/nnUNet_results/Dataset219_PETCT/nnUNetTrainer_1500epochs_NoMirroring__nnUNetPlans__3d_fullres/crossval_results_folds_0_1_2_3_4/PETCT_5e2da717db_06282002.nii.gz,/well/papiez/users/hri611/python/nnUnet_raw/Dataset219_PETCT/labelsTr/PETCT_5e2da717db_06282002.nii.gz,0.6947777974280589,1.306307201385498,45.48437265014648,34,50
313,313,,0,0,,45440000,0,0,0,/well/papiez/users/hri611/python/nnUNet_results/Dataset219_PETCT/nnUNetTrainer_1500epochs_NoMirroring__nnUNetPlans__3d_fullres/crossval_results_folds_0_1_2_3_4/PETCT_5e339b2ecf_04032003.nii.gz,/well/papiez/users/hri611/python/nnUnet_raw/Dataset219_PETCT/labelsTr/PETCT_5e339b2ecf_04032003.nii.gz,,0.0,0.0,0,0
314,314,,0,0,,46400000,0,0,0,/well/papiez/users/hri611/python/nnUNet_results/Dataset219_PETCT/nnUNetTrainer_1500epochs_NoMirroring__nnUNetPlans__3d_fullres/crossval_results_folds_0_1_2_3_4/PETCT_5e339b2ecf_05272006.nii.gz,/well/papiez/users/hri611/python/nnUnet_raw/Dataset219_PETCT/labelsTr/PETCT_5e339b2ecf_05272006.nii.gz,,0.0,0.0,0,0
315,315,,0,0,,43840000,0,0,0,/well/papiez/users/hri611/python/nnUNet_results/Dataset219_PETCT/nnUNetTrainer_1500epochs_NoMirroring__nnUNetPlans__3d_fullres/crossval_results_folds_0_1_2_3_4/PETCT_5e339b2ecf_11112005.nii.gz,/well/papiez/users/hri611/python/nnUnet_raw/Dataset219_PETCT/labelsTr/PETCT_5e339b2ecf_11112005.nii.gz,,0.0,0.0,0,0
316,316,0.0,0,2,0.0,52159998,0,2,0,/well/papiez/users/hri611/python/nnUNet_results/Dataset219_PETCT/nnUNetTrainer_1500epochs_NoMirroring__nnUNetPlans__3d_fullres/crossval_results_folds_0_1_2_3_4/PETCT_5e81863014_10182002.nii.gz,/well/papiez/users/hri611/python/nnUnet_raw/Dataset219_PETCT/labelsTr/PETCT_5e81863014_10182002.nii.gz,0.0,0.0248820419311523,0.0,1,0
317,317,0.5974025974025974,1827,281,0.4259259259259259,45436328,1564,1845,3391,/well/papiez/users/hri611/python/nnUNet_results/Dataset219_PETCT/nnUNetTrainer_1500epochs_NoMirroring__nnUNetPlans__3d_fullres/crossval_results_folds_0_1_2_3_4/PETCT_5e8b013935_12162001.nii.gz,/well/papiez/users/hri611/python/nnUnet_raw/Dataset219_PETCT/labelsTr/PETCT_5e8b013935_12162001.nii.gz,0.5974025974025974,0.0124410209655761,9.75376043701172,4,3
318,318,0.91675845124121,1174,6686,0.8463102733565367,45388858,43282,49968,44456,/well/papiez/users/hri611/python/nnUNet_results/Dataset219_PETCT/nnUNetTrainer_1500epochs_NoMirroring__nnUNetPlans__3d_fullres/crossval_results_folds_0_1_2_3_4/PETCT_5ef99b0b6b_09072000.nii.gz,/well/papiez/users/hri611/python/nnUnet_raw/Dataset219_PETCT/labelsTr/PETCT_5ef99b0b6b_09072000.nii.gz,0.91675845124121,1.3560712852478027,0.2737024612426758,12,13
319,319,0.8834468790278034,485,148,0.7912269129287599,52156968,2399,2547,2884,/well/papiez/users/hri611/python/nnUNet_results/Dataset219_PETCT/nnUNetTrainer_1500epochs_NoMirroring__nnUNetPlans__3d_fullres/crossval_results_folds_0_1_2_3_4/PETCT_5f569fb737_09122002.nii.gz,/well/papiez/users/hri611/python/nnUnet_raw/Dataset219_PETCT/labelsTr/PETCT_5f569fb737_09122002.nii.gz,0.8834468790278034,0.7713432998657226,0.0,3,2
320,320,0.0,0,245,0.0,45439755,0,245,0,/well/papiez/users/hri611/python/nnUNet_results/Dataset219_PETCT/nnUNetTrainer_1500epochs_NoMirroring__nnUNetPlans__3d_fullres/crossval_results_folds_0_1_2_3_4/PETCT_5fa9d9a820_03242003.nii.gz,/well/papiez/users/hri611/python/nnUnet_raw/Dataset219_PETCT/labelsTr/PETCT_5fa9d9a820_03242003.nii.gz,0.0,3.048050136566162,0.0,3,0
321,321,0.0,0,24,0.0,45439976,0,24,0,/well/papiez/users/hri611/python/nnUNet_results/Dataset219_PETCT/nnUNetTrainer_1500epochs_NoMirroring__nnUNetPlans__3d_fullres/crossval_results_folds_0_1_2_3_4/PETCT_5fa9d9a820_09132003.nii.gz,/well/papiez/users/hri611/python/nnUnet_raw/Dataset219_PETCT/labelsTr/PETCT_5fa9d9a820_09132003.nii.gz,0.0,0.2985845031738281,0.0,1,0
322,322,0.0,0,131,0.0,45439869,0,131,0,/well/papiez/users/hri611/python/nnUNet_results/Dataset219_PETCT/nnUNetTrainer_1500epochs_NoMirroring__nnUNetPlans__3d_fullres/crossval_results_folds_0_1_2_3_4/PETCT_5fa9d9a820_09152002.nii.gz,/well/papiez/users/hri611/python/nnUnet_raw/Dataset219_PETCT/labelsTr/PETCT_5fa9d9a820_09152002.nii.gz,0.0,1.6297737464904785,0.0,2,0
323,323,0.0,0,17,0.0,52159983,0,17,0,/well/papiez/users/hri611/python/nnUNet_results/Dataset219_PETCT/nnUNetTrainer_1500epochs_NoMirroring__nnUNetPlans__3d_fullres/crossval_results_folds_0_1_2_3_4/PETCT_5fa9d9a820_09272004.nii.gz,/well/papiez/users/hri611/python/nnUnet_raw/Dataset219_PETCT/labelsTr/PETCT_5fa9d9a820_09272004.nii.gz,0.0,0.2114973564147949,0.0,2,0
324,324,0.0,0,227,0.0,52159773,0,227,0,/well/papiez/users/hri611/python/nnUNet_results/Dataset219_PETCT/nnUNetTrainer_1500epochs_NoMirroring__nnUNetPlans__3d_fullres/crossval_results_folds_0_1_2_3_4/PETCT_6016a6c3af_07012002.nii.gz,/well/papiez/users/hri611/python/nnUnet_raw/Dataset219_PETCT/labelsTr/PETCT_6016a6c3af_07012002.nii.gz,0.0,2.824111759185791,0.0,4,0
325,325,0.8494686679748222,9136,2678,0.7383272791707274,52114852,33334,36012,42470,/well/papiez/users/hri611/python/nnUNet_results/Dataset219_PETCT/nnUNetTrainer_1500epochs_NoMirroring__nnUNetPlans__3d_fullres/crossval_results_folds_0_1_2_3_4/PETCT_605369e88d_09152002.nii.gz,/well/papiez/users/hri611/python/nnUnet_raw/Dataset219_PETCT/labelsTr/PETCT_605369e88d_09152002.nii.gz,0.8494686679748222,3.881598541259765,0.0,16,8
326,326,0.0,0,219,0.0,50879781,0,219,0,/well/papiez/users/hri611/python/nnUNet_results/Dataset219_PETCT/nnUNetTrainer_1500epochs_NoMirroring__nnUNetPlans__3d_fullres/crossval_results_folds_0_1_2_3_4/PETCT_607c1b38e3_04142007.nii.gz,/well/papiez/users/hri611/python/nnUnet_raw/Dataset219_PETCT/labelsTr/PETCT_607c1b38e3_04142007.nii.gz,0.0,2.724583591461182,0.0,3,0
327,327,0.0,0,43,0.0,48639957,0,43,0,/well/papiez/users/hri611/python/nnUNet_results/Dataset219_PETCT/nnUNetTrainer_1500epochs_NoMirroring__nnUNetPlans__3d_fullres/crossval_results_folds_0_1_2_3_4/PETCT_607c1b38e3_10162006.nii.gz,/well/papiez/users/hri611/python/nnUnet_raw/Dataset219_PETCT/labelsTr/PETCT_607c1b38e3_10162006.nii.gz,0.0,0.5349639015197754,0.0,1,0
328,328,0.7109501810463229,2098,217,0.5515304145679969,45434838,2847,3064,4945,/well/papiez/users/hri611/python/nnUNet_results/Dataset219_PETCT/nnUNetTrainer_1500epochs_NoMirroring__nnUNetPlans__3d_fullres/crossval_results_folds_0_1_2_3_4/PETCT_60baa6979c_08162003.nii.gz,/well/papiez/users/hri611/python/nnUnet_raw/Dataset219_PETCT/labelsTr/PETCT_60baa6979c_08162003.nii.gz,0.7109501810463229,0.360789608001709,0.4727587966918945,10,11
329,329,0.7726971504307488,2170,231,0.6295896328293736,45433518,4081,4312,6251,/well/papiez/users/hri611/python/nnUNet_results/Dataset219_PETCT/nnUNetTrainer_1500epochs_NoMirroring__nnUNetPlans__3d_fullres/crossval_results_folds_0_1_2_3_4/PETCT_61663450f8_08162003.nii.gz,/well/papiez/users/hri611/python/nnUnet_raw/Dataset219_PETCT/labelsTr/PETCT_61663450f8_08162003.nii.gz,0.7726971504307488,1.8039480400085448,0.0,9,7
330,330,0.9113217702692312,3648,4425,0.8370901019069721,45390445,41482,45907,45130,/well/papiez/users/hri611/python/nnUNet_results/Dataset219_PETCT/nnUNetTrainer_1500epochs_NoMirroring__nnUNetPlans__3d_fullres/crossval_results_folds_0_1_2_3_4/PETCT_6170317f2e_02182000.nii.gz,/well/papiez/users/hri611/python/nnUnet_raw/Dataset219_PETCT/labelsTr/PETCT_6170317f2e_02182000.nii.gz,0.9113217702692312,10.375811485290528,6.120982315063476,13,26
331,331,0.0,0,204,0.0,58079796,0,204,0,/well/papiez/users/hri611/python/nnUNet_results/Dataset219_PETCT/nnUNetTrainer_1500epochs_NoMirroring__nnUNetPlans__3d_fullres/crossval_results_folds_0_1_2_3_4/PETCT_61d5bc58fc_06152007.nii.gz,/well/papiez/users/hri611/python/nnUnet_raw/Dataset219_PETCT/labelsTr/PETCT_61d5bc58fc_06152007.nii.gz,0.0,2.537968276977539,0.0,4,0
332,332,0.0,0,124,0.0,59839876,0,124,0,/well/papiez/users/hri611/python/nnUNet_results/Dataset219_PETCT/nnUNetTrainer_1500epochs_NoMirroring__nnUNetPlans__3d_fullres/crossval_results_folds_0_1_2_3_4/PETCT_61d5bc58fc_06182005.nii.gz,/well/papiez/users/hri611/python/nnUnet_raw/Dataset219_PETCT/labelsTr/PETCT_61d5bc58fc_06182005.nii.gz,0.0,1.5426865997314452,0.0,3,0
333,333,0.0,0,106,0.0,59199894,0,106,0,/well/papiez/users/hri611/python/nnUNet_results/Dataset219_PETCT/nnUNetTrainer_1500epochs_NoMirroring__nnUNetPlans__3d_fullres/crossval_results_folds_0_1_2_3_4/PETCT_61d5bc58fc_06232006.nii.gz,/well/papiez/users/hri611/python/nnUnet_raw/Dataset219_PETCT/labelsTr/PETCT_61d5bc58fc_06232006.nii.gz,0.0,1.3187482223510745,0.0,3,0
334,334,0.0,0,314,0.0,55999686,0,314,0,/well/papiez/users/hri611/python/nnUNet_results/Dataset219_PETCT/nnUNetTrainer_1500epochs_NoMirroring__nnUNetPlans__3d_fullres/crossval_results_folds_0_1_2_3_4/PETCT_61d5bc58fc_12152005.nii.gz,/well/papiez/users/hri611/python/nnUnet_raw/Dataset219_PETCT/labelsTr/PETCT_61d5bc58fc_12152005.nii.gz,0.0,3.906480583190918,0.0,4,0
335,335,0.9296536680816484,5804,775,0.8685540748436594,52109949,43472,44247,49276,/well/papiez/users/hri611/python/nnUNet_results/Dataset219_PETCT/nnUNetTrainer_1500epochs_NoMirroring__nnUNetPlans__3d_fullres/crossval_results_folds_0_1_2_3_4/PETCT_62011ff15b_05052005.nii.gz,/well/papiez/users/hri611/python/nnUnet_raw/Dataset219_PETCT/labelsTr/PETCT_62011ff15b_05052005.nii.gz,0.9296536680816484,0.2114973564147949,29.89577338027954,16,59
336,336,0.9616336633663366,451,355,0.9261025029797376,52149093,10101,10456,10552,/well/papiez/users/hri611/python/nnUNet_results/Dataset219_PETCT/nnUNetTrainer_1500epochs_NoMirroring__nnUNetPlans__3d_fullres/crossval_results_folds_0_1_2_3_4/PETCT_62405d117c_03112001.nii.gz,/well/papiez/users/hri611/python/nnUnet_raw/Dataset219_PETCT/labelsTr/PETCT_62405d117c_03112001.nii.gz,0.9616336633663366,0.2239383773803711,0.0124410209655761,7,6
337,337,0.9065520945220192,221,40,0.8290766208251473,52158473,1266,1306,1487,/well/papiez/users/hri611/python/nnUNet_results/Dataset219_PETCT/nnUNetTrainer_1500epochs_NoMirroring__nnUNetPlans__3d_fullres/crossval_results_folds_0_1_2_3_4/PETCT_62b114e09b_03272003.nii.gz,/well/papiez/users/hri611/python/nnUnet_raw/Dataset219_PETCT/labelsTr/PETCT_62b114e09b_03272003.nii.gz,0.9065520945220192,0.0,0.0,2,2
338,338,0.0,0,6,0.0,52159994,0,6,0,/well/papiez/users/hri611/python/nnUNet_results/Dataset219_PETCT/nnUNetTrainer_1500epochs_NoMirroring__nnUNetPlans__3d_fullres/crossval_results_folds_0_1_2_3_4/PETCT_62b114e09b_06092003.nii.gz,/well/papiez/users/hri611/python/nnUnet_raw/Dataset219_PETCT/labelsTr/PETCT_62b114e09b_06092003.nii.gz,0.0,0.074646125793457,0.0,2,0
339,339,0.921330699526542,632,1877,0.8541363874193361,52142799,14692,16569,15324,/well/papiez/users/hri611/python/nnUNet_results/Dataset219_PETCT/nnUNetTrainer_1500epochs_NoMirroring__nnUNetPlans__3d_fullres/crossval_results_folds_0_1_2_3_4/PETCT_62ced197ca_04142003.nii.gz,/well/papiez/users/hri611/python/nnUnet_raw/Dataset219_PETCT/labelsTr/PETCT_62ced197ca_04142003.nii.gz,0.921330699526542,0.0,0.0,3,3
340,340,,0,0,,101600000,0,0,0,/well/papiez/users/hri611/python/nnUNet_results/Dataset219_PETCT/nnUNetTrainer_1500epochs_NoMirroring__nnUNetPlans__3d_fullres/crossval_results_folds_0_1_2_3_4/PETCT_631b419cef_11232006.nii.gz,/well/papiez/users/hri611/python/nnUnet_raw/Dataset219_PETCT/labelsTr/PETCT_631b419cef_11232006.nii.gz,,0.0,0.0,0,0
341,341,,0,0,,52160000,0,0,0,/well/papiez/users/hri611/python/nnUNet_results/Dataset219_PETCT/nnUNetTrainer_1500epochs_NoMirroring__nnUNetPlans__3d_fullres/crossval_results_folds_0_1_2_3_4/PETCT_63464433c8_01042003.nii.gz,/well/papiez/users/hri611/python/nnUnet_raw/Dataset219_PETCT/labelsTr/PETCT_63464433c8_01042003.nii.gz,,0.0,0.0,0,0
342,342,0.9179639002960558,483,1235,0.8483671668137688,45428670,9612,10847,10095,/well/papiez/users/hri611/python/nnUNet_results/Dataset219_PETCT/nnUNetTrainer_1500epochs_NoMirroring__nnUNetPlans__3d_fullres/crossval_results_folds_0_1_2_3_4/PETCT_63508c679d_02172005.nii.gz,/well/papiez/users/hri611/python/nnUnet_raw/Dataset219_PETCT/labelsTr/PETCT_63508c679d_02172005.nii.gz,0.9179639002960558,1.8412711029052733,2.7867886962890625,13,9
343,343,0.0,0,147,0.0,45759853,0,147,0,/well/papiez/users/hri611/python/nnUNet_results/Dataset219_PETCT/nnUNetTrainer_1500epochs_NoMirroring__nnUNetPlans__3d_fullres/crossval_results_folds_0_1_2_3_4/PETCT_63508c679d_08212005.nii.gz,/well/papiez/users/hri611/python/nnUnet_raw/Dataset219_PETCT/labelsTr/PETCT_63508c679d_08212005.nii.gz,0.0,1.8288300819396968,0.0,1,0
344,344,0.7212435233160622,8185,692,0.5640194489465153,52139639,11484,12176,19669,/well/papiez/users/hri611/python/nnUNet_results/Dataset219_PETCT/nnUNetTrainer_1500epochs_NoMirroring__nnUNetPlans__3d_fullres/crossval_results_folds_0_1_2_3_4/PETCT_63dd9503eb_01182001.nii.gz,/well/papiez/users/hri611/python/nnUnet_raw/Dataset219_PETCT/labelsTr/PETCT_63dd9503eb_01182001.nii.gz,0.7212435233160622,0.2488204193115234,70.88893746185303,6,6
345,345,0.7800661072972286,816,914,0.6394330971238016,52155202,3068,3982,3884,/well/papiez/users/hri611/python/nnUNet_results/Dataset219_PETCT/nnUNetTrainer_1500epochs_NoMirroring__nnUNetPlans__3d_fullres/crossval_results_folds_0_1_2_3_4/PETCT_644d80e987_02152003.nii.gz,/well/papiez/users/hri611/python/nnUnet_raw/Dataset219_PETCT/labelsTr/PETCT_644d80e987_02152003.nii.gz,0.7800661072972286,5.088377574920655,0.0,7,4
346,346,0.8897058823529411,468,612,0.8013245033112583,52154564,4356,4968,4824,/well/papiez/users/hri611/python/nnUNet_results/Dataset219_PETCT/nnUNetTrainer_1500epochs_NoMirroring__nnUNetPlans__3d_fullres/crossval_results_folds_0_1_2_3_4/PETCT_64909533c5_04142003.nii.gz,/well/papiez/users/hri611/python/nnUnet_raw/Dataset219_PETCT/labelsTr/PETCT_64909533c5_04142003.nii.gz,0.8897058823529411,2.5006452140808104,0.0,10,5
347,347,,0,0,,49920000,0,0,0,/well/papiez/users/hri611/python/nnUNet_results/Dataset219_PETCT/nnUNetTrainer_1500epochs_NoMirroring__nnUNetPlans__3d_fullres/crossval_results_folds_0_1_2_3_4/PETCT_64aff75516_01202006.nii.gz,/well/papiez/users/hri611/python/nnUnet_raw/Dataset219_PETCT/labelsTr/PETCT_64aff75516_01202006.nii.gz,,0.0,0.0,0,0
348,348,,0,0,,47840000,0,0,0,/well/papiez/users/hri611/python/nnUNet_results/Dataset219_PETCT/nnUNetTrainer_1500epochs_NoMirroring__nnUNetPlans__3d_fullres/crossval_results_folds_0_1_2_3_4/PETCT_64aff75516_10162005.nii.gz,/well/papiez/users/hri611/python/nnUnet_raw/Dataset219_PETCT/labelsTr/PETCT_64aff75516_10162005.nii.gz,,0.0,0.0,0,0
349,349,0.0,0,3,0.0,41919997,0,3,0,/well/papiez/users/hri611/python/nnUNet_results/Dataset219_PETCT/nnUNetTrainer_1500epochs_NoMirroring__nnUNetPlans__3d_fullres/crossval_results_folds_0_1_2_3_4/PETCT_64c0cba177_08072006.nii.gz,/well/papiez/users/hri611/python/nnUnet_raw/Dataset219_PETCT/labelsTr/PETCT_64c0cba177_08072006.nii.gz,0.0,0.0373230628967285,0.0,1,0
350,350,0.475438596491228,170,428,0.3118527042577675,92319131,271,699,441,/well/papiez/users/hri611/python/nnUNet_results/Dataset219_PETCT/nnUNetTrainer_1500epochs_NoMirroring__nnUNetPlans__3d_fullres/crossval_results_folds_0_1_2_3_4/PETCT_65346b03b8_03142004.nii.gz,/well/papiez/users/hri611/python/nnUnet_raw/Dataset219_PETCT/labelsTr/PETCT_65346b03b8_03142004.nii.gz,0.475438596491228,4.864439197540283,0.0,10,2
351,351,0.4696531791907514,568,166,0.3068932955618508,52158941,325,491,893,/well/papiez/users/hri611/python/nnUNet_results/Dataset219_PETCT/nnUNetTrainer_1500epochs_NoMirroring__nnUNetPlans__3d_fullres/crossval_results_folds_0_1_2_3_4/PETCT_6543c58e13_02252001.nii.gz,/well/papiez/users/hri611/python/nnUnet_raw/Dataset219_PETCT/labelsTr/PETCT_6543c58e13_02252001.nii.gz,0.4696531791907514,1.9283582496643064,0.0,6,3
352,352,0.7023420668566266,3477,806,0.5412382176520995,45430664,5053,5859,8530,/well/papiez/users/hri611/python/nnUNet_results/Dataset219_PETCT/nnUNetTrainer_1500epochs_NoMirroring__nnUNetPlans__3d_fullres/crossval_results_folds_0_1_2_3_4/PETCT_65a1330e90_06162001.nii.gz,/well/papiez/users/hri611/python/nnUnet_raw/Dataset219_PETCT/labelsTr/PETCT_65a1330e90_06162001.nii.gz,0.7023420668566266,0.1244102096557617,33.030910663604736,4,9
353,353,0.8053238810119544,5262,340,0.6740938972598755,49102811,11587,11927,16849,/well/papiez/users/hri611/python/nnUNet_results/Dataset219_PETCT/nnUNetTrainer_1500epochs_NoMirroring__nnUNetPlans__3d_fullres/crossval_results_folds_0_1_2_3_4/PETCT_65bd1a4c38_09302005.nii.gz,/well/papiez/users/hri611/python/nnUnet_raw/Dataset219_PETCT/labelsTr/PETCT_65bd1a4c38_09302005.nii.gz,0.8053238810119544,0.7091381950378418,29.59718887710571,9,20
354,354,,0,0,,52160000,0,0,0,/well/papiez/users/hri611/python/nnUNet_results/Dataset219_PETCT/nnUNetTrainer_1500epochs_NoMirroring__nnUNetPlans__3d_fullres/crossval_results_folds_0_1_2_3_4/PETCT_6604b228c6_10232004.nii.gz,/well/papiez/users/hri611/python/nnUnet_raw/Dataset219_PETCT/labelsTr/PETCT_6604b228c6_10232004.nii.gz,,0.0,0.0,0,0
355,355,0.0,0,4784,0.0,52155216,0,4784,0,/well/papiez/users/hri611/python/nnUNet_results/Dataset219_PETCT/nnUNetTrainer_1500epochs_NoMirroring__nnUNetPlans__3d_fullres/crossval_results_folds_0_1_2_3_4/PETCT_674c49778c_12222002.nii.gz,/well/papiez/users/hri611/python/nnUnet_raw/Dataset219_PETCT/labelsTr/PETCT_674c49778c_12222002.nii.gz,0.0,59.51784429931641,0.0,34,0
356,356,0.7361176768065435,5030,18973,0.5824258028600258,52102518,33479,52452,38509,/well/papiez/users/hri611/python/nnUNet_results/Dataset219_PETCT/nnUNetTrainer_1500epochs_NoMirroring__nnUNetPlans__3d_fullres/crossval_results_folds_0_1_2_3_4/PETCT_685d7c09b5_12232000.nii.gz,/well/papiez/users/hri611/python/nnUnet_raw/Dataset219_PETCT/labelsTr/PETCT_685d7c09b5_12232000.nii.gz,0.7361176768065435,2.363793983459473,2.0403274383544923,30,53
357,357,0.7206292819081451,1865,337,0.5632685442284807,52154958,2840,3177,4705,/well/papiez/users/hri611/python/nnUNet_results/Dataset219_PETCT/nnUNetTrainer_1500epochs_NoMirroring__nnUNetPlans__3d_fullres/crossval_results_folds_0_1_2_3_4/PETCT_68b75093c5_11122000.nii.gz,/well/papiez/users/hri611/python/nnUnet_raw/Dataset219_PETCT/labelsTr/PETCT_68b75093c5_11122000.nii.gz,0.7206292819081451,0.0,9.853288604736328,3,5
358,358,0.9083025435891172,2993,10,0.8320093980756321,45422124,14873,14883,17866,/well/papiez/users/hri611/python/nnUNet_results/Dataset219_PETCT/nnUNetTrainer_1500epochs_NoMirroring__nnUNetPlans__3d_fullres/crossval_results_folds_0_1_2_3_4/PETCT_68f73c4518_11132004.nii.gz,/well/papiez/users/hri611/python/nnUnet_raw/Dataset219_PETCT/labelsTr/PETCT_68f73c4518_11132004.nii.gz,0.9083025435891172,0.0373230628967285,0.0,4,1
359,359,,0,0,,50560000,0,0,0,/well/papiez/users/hri611/python/nnUNet_results/Dataset219_PETCT/nnUNetTrainer_1500epochs_NoMirroring__nnUNetPlans__3d_fullres/crossval_results_folds_0_1_2_3_4/PETCT_69606f6a25_08132006.nii.gz,/well/papiez/users/hri611/python/nnUnet_raw/Dataset219_PETCT/labelsTr/PETCT_69606f6a25_08132006.nii.gz,,0.0,0.0,0,0
360,360,0.0,0,17,0.0,38719983,0,17,0,/well/papiez/users/hri611/python/nnUNet_results/Dataset219_PETCT/nnUNetTrainer_1500epochs_NoMirroring__nnUNetPlans__3d_fullres/crossval_results_folds_0_1_2_3_4/PETCT_69aa8dbfd2_05242003.nii.gz,/well/papiez/users/hri611/python/nnUnet_raw/Dataset219_PETCT/labelsTr/PETCT_69aa8dbfd2_05242003.nii.gz,0.0,0.2114973564147949,0.0,6,0
361,361,,0,0,,44320000,0,0,0,/well/papiez/users/hri611/python/nnUNet_results/Dataset219_PETCT/nnUNetTrainer_1500epochs_NoMirroring__nnUNetPlans__3d_fullres/crossval_results_folds_0_1_2_3_4/PETCT_69c90b6820_11212005.nii.gz,/well/papiez/users/hri611/python/nnUnet_raw/Dataset219_PETCT/labelsTr/PETCT_69c90b6820_11212005.nii.gz,,0.0,0.0,0,0
362,362,0.0,0,178,0.0,52159822,0,178,0,/well/papiez/users/hri611/python/nnUNet_results/Dataset219_PETCT/nnUNetTrainer_1500epochs_NoMirroring__nnUNetPlans__3d_fullres/crossval_results_folds_0_1_2_3_4/PETCT_69ee62b035_12262002.nii.gz,/well/papiez/users/hri611/python/nnUnet_raw/Dataset219_PETCT/labelsTr/PETCT_69ee62b035_12262002.nii.gz,0.0,2.2145017318725584,0.0,6,0
363,363,0.8489908053993825,25104,10404,0.7376055807216807,45304677,99815,110219,124919,/well/papiez/users/hri611/python/nnUNet_results/Dataset219_PETCT/nnUNetTrainer_1500epochs_NoMirroring__nnUNetPlans__3d_fullres/crossval_results_folds_0_1_2_3_4/PETCT_6a3477cd9a_01152005.nii.gz,/well/papiez/users/hri611/python/nnUnet_raw/Dataset219_PETCT/labelsTr/PETCT_6a3477cd9a_01152005.nii.gz,0.8489908053993825,3.6701011848449703,17.96483427429199,110,157
364,364,0.4832402234636871,2550,40,0.3186003683241252,45436199,1211,1251,3761,/well/papiez/users/hri611/python/nnUNet_results/Dataset219_PETCT/nnUNetTrainer_1500epochs_NoMirroring__nnUNetPlans__3d_fullres/crossval_results_folds_0_1_2_3_4/PETCT_6aea5c3a03_12272001.nii.gz,/well/papiez/users/hri611/python/nnUnet_raw/Dataset219_PETCT/labelsTr/PETCT_6aea5c3a03_12272001.nii.gz,0.4832402234636871,0.2488204193115234,2.5628503189086915,7,6
365,365,0.0,0,7,0.0,51839993,0,7,0,/well/papiez/users/hri611/python/nnUNet_results/Dataset219_PETCT/nnUNetTrainer_1500epochs_NoMirroring__nnUNetPlans__3d_fullres/crossval_results_folds_0_1_2_3_4/PETCT_6b177a3c28_06302005.nii.gz,/well/papiez/users/hri611/python/nnUnet_raw/Dataset219_PETCT/labelsTr/PETCT_6b177a3c28_06302005.nii.gz,0.0,0.0870871467590332,0.0,2,0
366,366,0.0,0,5,0.0,38719995,0,5,0,/well/papiez/users/hri611/python/nnUNet_results/Dataset219_PETCT/nnUNetTrainer_1500epochs_NoMirroring__nnUNetPlans__3d_fullres/crossval_results_folds_0_1_2_3_4/PETCT_6b20c7eabb_07312003.nii.gz,/well/papiez/users/hri611/python/nnUnet_raw/Dataset219_PETCT/labelsTr/PETCT_6b20c7eabb_07312003.nii.gz,0.0,0.0622051048278808,0.0,2,0
367,367,0.8918964499536217,1426,1138,0.8048854729472643,51666859,10577,11715,12003,/well/papiez/users/hri611/python/nnUNet_results/Dataset219_PETCT/nnUNetTrainer_1500epochs_NoMirroring__nnUNetPlans__3d_fullres/crossval_results_folds_0_1_2_3_4/PETCT_6c23f2686d_04212007.nii.gz,/well/papiez/users/hri611/python/nnUnet_raw/Dataset219_PETCT/labelsTr/PETCT_6c23f2686d_04212007.nii.gz,0.8918964499536217,2.985845031738281,0.0,13,12
368,368,0.8187555574833547,5238,3119,0.6931296588697536,45412767,18876,21995,24114,/well/papiez/users/hri611/python/nnUNet_results/Dataset219_PETCT/nnUNetTrainer_1500epochs_NoMirroring__nnUNetPlans__3d_fullres/crossval_results_folds_0_1_2_3_4/PETCT_6c469107a0_06232002.nii.gz,/well/papiez/users/hri611/python/nnUnet_raw/Dataset219_PETCT/labelsTr/PETCT_6c469107a0_06232002.nii.gz,0.8187555574833547,2.973404010772705,9.94037575149536,41,45
369,369,0.862776025236593,101,421,0.7586685159500693,95837837,1641,2062,1742,/well/papiez/users/hri611/python/nnUNet_results/Dataset219_PETCT/nnUNetTrainer_1500epochs_NoMirroring__nnUNetPlans__3d_fullres/crossval_results_folds_0_1_2_3_4/PETCT_6c660140ca_08062006.nii.gz,/well/papiez/users/hri611/python/nnUnet_raw/Dataset219_PETCT/labelsTr/PETCT_6c660140ca_08062006.nii.gz,0.862776025236593,1.0450457611083983,0.0,3,1
370,370,0.9370988446726572,37,12,0.8816425120772947,54079586,365,377,402,/well/papiez/users/hri611/python/nnUNet_results/Dataset219_PETCT/nnUNetTrainer_1500epochs_NoMirroring__nnUNetPlans__3d_fullres/crossval_results_folds_0_1_2_3_4/PETCT_6d62e15c29_02232007.nii.gz,/well/papiez/users/hri611/python/nnUnet_raw/Dataset219_PETCT/labelsTr/PETCT_6d62e15c29_02232007.nii.gz,0.9370988446726572,0.0,0.0,1,1
371,371,0.0,0,12,0.0,54879988,0,12,0,/well/papiez/users/hri611/python/nnUNet_results/Dataset219_PETCT/nnUNetTrainer_1500epochs_NoMirroring__nnUNetPlans__3d_fullres/crossval_results_folds_0_1_2_3_4/PETCT_6d62e15c29_08242006.nii.gz,/well/papiez/users/hri611/python/nnUnet_raw/Dataset219_PETCT/labelsTr/PETCT_6d62e15c29_08242006.nii.gz,0.0,0.149292251586914,0.0,1,0
372,372,0.8416029499484844,1430,1491,0.7265237337327966,52149319,7760,9251,9190,/well/papiez/users/hri611/python/nnUNet_results/Dataset219_PETCT/nnUNetTrainer_1500epochs_NoMirroring__nnUNetPlans__3d_fullres/crossval_results_folds_0_1_2_3_4/PETCT_6d6a193655_11172002.nii.gz,/well/papiez/users/hri611/python/nnUnet_raw/Dataset219_PETCT/labelsTr/PETCT_6d6a193655_11172002.nii.gz,0.8416029499484844,0.1119691886901855,8.099104648590087,4,4
373,373,0.0,0,174,0.0,45439826,0,174,0,/well/papiez/users/hri611/python/nnUNet_results/Dataset219_PETCT/nnUNetTrainer_1500epochs_NoMirroring__nnUNetPlans__3d_fullres/crossval_results_folds_0_1_2_3_4/PETCT_6dd36a2c19_11282003.nii.gz,/well/papiez/users/hri611/python/nnUnet_raw/Dataset219_PETCT/labelsTr/PETCT_6dd36a2c19_11282003.nii.gz,0.0,2.164737648010254,0.0,2,0
374,374,0.0,0,2129,0.0,52157871,0,2129,0,/well/papiez/users/hri611/python/nnUNet_results/Dataset219_PETCT/nnUNetTrainer_1500epochs_NoMirroring__nnUNetPlans__3d_fullres/crossval_results_folds_0_1_2_3_4/PETCT_6e1dba94e8_11152002.nii.gz,/well/papiez/users/hri611/python/nnUnet_raw/Dataset219_PETCT/labelsTr/PETCT_6e1dba94e8_11152002.nii.gz,0.0,26.48693363571167,0.0,1,0
375,375,0.9045123249529112,3169,1495,0.825670927711744,52133246,22090,23585,25259,/well/papiez/users/hri611/python/nnUNet_results/Dataset219_PETCT/nnUNetTrainer_1500epochs_NoMirroring__nnUNetPlans__3d_fullres/crossval_results_folds_0_1_2_3_4/PETCT_6e7c7f8087_03232003.nii.gz,/well/papiez/users/hri611/python/nnUnet_raw/Dataset219_PETCT/labelsTr/PETCT_6e7c7f8087_03232003.nii.gz,0.9045123249529112,0.0124410209655761,2.4384401092529298,6,8
376,376,0.7015610651974288,130,195,0.5403111739745403,52159293,382,577,512,/well/papiez/users/hri611/python/nnUNet_results/Dataset219_PETCT/nnUNetTrainer_1500epochs_NoMirroring__nnUNetPlans__3d_fullres/crossval_results_folds_0_1_2_3_4/PETCT_6efefcb92a_03262005.nii.gz,/well/papiez/users/hri611/python/nnUnet_raw/Dataset219_PETCT/labelsTr/PETCT_6efefcb92a_03262005.nii.gz,0.7015610651974288,2.052768459320068,0.8957535095214844,4,4
377,377,0.0,0,948,0.0,94239052,0,948,0,/well/papiez/users/hri611/python/nnUNet_results/Dataset219_PETCT/nnUNetTrainer_1500epochs_NoMirroring__nnUNetPlans__3d_fullres/crossval_results_folds_0_1_2_3_4/PETCT_6f46454a8d_09032005.nii.gz,/well/papiez/users/hri611/python/nnUnet_raw/Dataset219_PETCT/labelsTr/PETCT_6f46454a8d_09032005.nii.gz,0.0,11.79408787536621,0.0,5,0
378,378,0.0,0,403,0.0,99039597,0,403,0,/well/papiez/users/hri611/python/nnUNet_results/Dataset219_PETCT/nnUNetTrainer_1500epochs_NoMirroring__nnUNetPlans__3d_fullres/crossval_results_folds_0_1_2_3_4/PETCT_6f46454a8d_09072003.nii.gz,/well/papiez/users/hri611/python/nnUnet_raw/Dataset219_PETCT/labelsTr/PETCT_6f46454a8d_09072003.nii.gz,0.0,5.013731449127198,0.0,4,0
379,379,0.0,0,156,0.0,99039844,0,156,0,/well/papiez/users/hri611/python/nnUNet_results/Dataset219_PETCT/nnUNetTrainer_1500epochs_NoMirroring__nnUNetPlans__3d_fullres/crossval_results_folds_0_1_2_3_4/PETCT_6f46454a8d_09122002.nii.gz,/well/papiez/users/hri611/python/nnUnet_raw/Dataset219_PETCT/labelsTr/PETCT_6f46454a8d_09122002.nii.gz,0.0,1.9407992706298829,0.0,2,0
380,380,0.8450693284654522,3196,793,0.7317056766209309,52145132,10879,11672,14075,/well/papiez/users/hri611/python/nnUNet_results/Dataset219_PETCT/nnUNetTrainer_1500epochs_NoMirroring__nnUNetPlans__3d_fullres/crossval_results_folds_0_1_2_3_4/PETCT_6fe855c937_12292001.nii.gz,/well/papiez/users/hri611/python/nnUnet_raw/Dataset219_PETCT/labelsTr/PETCT_6fe855c937_12292001.nii.gz,0.8450693284654522,0.2861434822082519,1.2192200546264649,8,4
381,381,0.4989517819706499,936,20,0.3324022346368715,52158568,476,496,1412,/well/papiez/users/hri611/python/nnUNet_results/Dataset219_PETCT/nnUNetTrainer_1500epochs_NoMirroring__nnUNetPlans__3d_fullres/crossval_results_folds_0_1_2_3_4/PETCT_7094acd4c0_08232001.nii.gz,/well/papiez/users/hri611/python/nnUnet_raw/Dataset219_PETCT/labelsTr/PETCT_7094acd4c0_08232001.nii.gz,0.4989517819706499,0.2363793983459472,9.281001640319824,4,3
382,382,0.8554211173078741,2894,9342,0.7473675517198662,45391566,36198,45540,39092,/well/papiez/users/hri611/python/nnUNet_results/Dataset219_PETCT/nnUNetTrainer_1500epochs_NoMirroring__nnUNetPlans__3d_fullres/crossval_results_folds_0_1_2_3_4/PETCT_7147385005_05092002.nii.gz,/well/papiez/users/hri611/python/nnUnet_raw/Dataset219_PETCT/labelsTr/PETCT_7147385005_05092002.nii.gz,0.8554211173078741,45.9446904258728,0.0,37,6
383,383,0.0,0,73,0.0,87999927,0,73,0,/well/papiez/users/hri611/python/nnUNet_results/Dataset219_PETCT/nnUNetTrainer_1500epochs_NoMirroring__nnUNetPlans__3d_fullres/crossval_results_folds_0_1_2_3_4/PETCT_71ac560ffe_03192007.nii.gz,/well/papiez/users/hri611/python/nnUnet_raw/Dataset219_PETCT/labelsTr/PETCT_71ac560ffe_03192007.nii.gz,0.0,0.9081945304870606,0.0,4,0
384,384,,0,0,,45440000,0,0,0,/well/papiez/users/hri611/python/nnUNet_results/Dataset219_PETCT/nnUNetTrainer_1500epochs_NoMirroring__nnUNetPlans__3d_fullres/crossval_results_folds_0_1_2_3_4/PETCT_71ae114917_04132003.nii.gz,/well/papiez/users/hri611/python/nnUnet_raw/Dataset219_PETCT/labelsTr/PETCT_71ae114917_04132003.nii.gz,,0.0,0.0,0,0
385,385,,0,0,,50880000,0,0,0,/well/papiez/users/hri611/python/nnUNet_results/Dataset219_PETCT/nnUNetTrainer_1500epochs_NoMirroring__nnUNetPlans__3d_fullres/crossval_results_folds_0_1_2_3_4/PETCT_72725f2bda_07062007.nii.gz,/well/papiez/users/hri611/python/nnUnet_raw/Dataset219_PETCT/labelsTr/PETCT_72725f2bda_07062007.nii.gz,,0.0,0.0,0,0
386,386,0.0,0,910,0.0,38239090,0,910,0,/well/papiez/users/hri611/python/nnUNet_results/Dataset219_PETCT/nnUNetTrainer_1500epochs_NoMirroring__nnUNetPlans__3d_fullres/crossval_results_folds_0_1_2_3_4/PETCT_72d2d6de52_08052005.nii.gz,/well/papiez/users/hri611/python/nnUnet_raw/Dataset219_PETCT/labelsTr/PETCT_72d2d6de52_08052005.nii.gz,0.0,11.321329078674315,0.0,8,0
387,387,0.8469904648390941,1487,567,0.7345910324331308,45432261,5685,6252,7172,/well/papiez/users/hri611/python/nnUNet_results/Dataset219_PETCT/nnUNetTrainer_1500epochs_NoMirroring__nnUNetPlans__3d_fullres/crossval_results_folds_0_1_2_3_4/PETCT_72ee9ec897_11122001.nii.gz,/well/papiez/users/hri611/python/nnUnet_raw/Dataset219_PETCT/labelsTr/PETCT_72ee9ec897_11122001.nii.gz,0.8469904648390941,0.4603177757263184,0.0,3,2
388,388,0.6762260308840998,13187,9709,0.5108319446224843,45073194,23910,33619,37097,/well/papiez/users/hri611/python/nnUNet_results/Dataset219_PETCT/nnUNetTrainer_1500epochs_NoMirroring__nnUNetPlans__3d_fullres/crossval_results_folds_0_1_2_3_4/PETCT_7323c415d0_02262006.nii.gz,/well/papiez/users/hri611/python/nnUnet_raw/Dataset219_PETCT/labelsTr/PETCT_7323c415d0_02262006.nii.gz,0.6762260308840998,2.090091522216797,93.32009826278686,83,113
389,389,0.8328731665228646,863,3011,0.7136098174022326,84306473,9653,12664,10516,/well/papiez/users/hri611/python/nnUNet_results/Dataset219_PETCT/nnUNetTrainer_1500epochs_NoMirroring__nnUNetPlans__3d_fullres/crossval_results_folds_0_1_2_3_4/PETCT_73597f33fe_02102007.nii.gz,/well/papiez/users/hri611/python/nnUnet_raw/Dataset219_PETCT/labelsTr/PETCT_73597f33fe_02102007.nii.gz,0.8328731665228646,15.824978668212893,0.0870871467590332,53,44
390,390,0.8273094254600075,6274,1084,0.7054797262138254,84455017,17625,18709,23899,/well/papiez/users/hri611/python/nnUNet_results/Dataset219_PETCT/nnUNetTrainer_1500epochs_NoMirroring__nnUNetPlans__3d_fullres/crossval_results_folds_0_1_2_3_4/PETCT_73597f33fe_05172007.nii.gz,/well/papiez/users/hri611/python/nnUnet_raw/Dataset219_PETCT/labelsTr/PETCT_73597f33fe_05172007.nii.gz,0.8273094254600075,0.149292251586914,0.4851998176574706,52,51
391,391,0.0,0,1,0.0,51839999,0,1,0,/well/papiez/users/hri611/python/nnUNet_results/Dataset219_PETCT/nnUNetTrainer_1500epochs_NoMirroring__nnUNetPlans__3d_fullres/crossval_results_folds_0_1_2_3_4/PETCT_7365362464_03222007.nii.gz,/well/papiez/users/hri611/python/nnUnet_raw/Dataset219_PETCT/labelsTr/PETCT_7365362464_03222007.nii.gz,0.0,0.0124410209655761,0.0,1,0
392,392,0.9501873434016044,1027,1140,0.9051018173855924,48137165,20668,21808,21695,/well/papiez/users/hri611/python/nnUNet_results/Dataset219_PETCT/nnUNetTrainer_1500epochs_NoMirroring__nnUNetPlans__3d_fullres/crossval_results_folds_0_1_2_3_4/PETCT_73fda3a382_08122005.nii.gz,/well/papiez/users/hri611/python/nnUnet_raw/Dataset219_PETCT/labelsTr/PETCT_73fda3a382_08122005.nii.gz,0.9501873434016044,0.0,0.3856716499328613,6,10
393,393,,0,0,,38720000,0,0,0,/well/papiez/users/hri611/python/nnUNet_results/Dataset219_PETCT/nnUNetTrainer_1500epochs_NoMirroring__nnUNetPlans__3d_fullres/crossval_results_folds_0_1_2_3_4/PETCT_741f6130ed_11282004.nii.gz,/well/papiez/users/hri611/python/nnUnet_raw/Dataset219_PETCT/labelsTr/PETCT_741f6130ed_11282004.nii.gz,,0.0,0.0,0,0
394,394,0.9089377775509162,2187,1381,0.8330760233918129,52138625,17807,19188,19994,/well/papiez/users/hri611/python/nnUNet_results/Dataset219_PETCT/nnUNetTrainer_1500epochs_NoMirroring__nnUNetPlans__3d_fullres/crossval_results_folds_0_1_2_3_4/PETCT_742a9413db_11102001.nii.gz,/well/papiez/users/hri611/python/nnUnet_raw/Dataset219_PETCT/labelsTr/PETCT_742a9413db_11102001.nii.gz,0.9089377775509162,2.425999088287353,1.8039480400085448,3,3
395,395,0.1253218884120171,27,992,0.0668498168498168,45118908,73,1065,100,/well/papiez/users/hri611/python/nnUNet_results/Dataset219_PETCT/nnUNetTrainer_1500epochs_NoMirroring__nnUNetPlans__3d_fullres/crossval_results_folds_0_1_2_3_4/PETCT_74bbceaeeb_06032005.nii.gz,/well/papiez/users/hri611/python/nnUnet_raw/Dataset219_PETCT/labelsTr/PETCT_74bbceaeeb_06032005.nii.gz,0.1253218884120171,11.955821147918702,0.3234665451049804,6,3
396,396,0.0,0,7,0.0,52159993,0,7,0,/well/papiez/users/hri611/python/nnUNet_results/Dataset219_PETCT/nnUNetTrainer_1500epochs_NoMirroring__nnUNetPlans__3d_fullres/crossval_results_folds_0_1_2_3_4/PETCT_75046e0c12_10292004.nii.gz,/well/papiez/users/hri611/python/nnUnet_raw/Dataset219_PETCT/labelsTr/PETCT_75046e0c12_10292004.nii.gz,0.0,0.0870871467590332,0.0,3,0
397,397,0.0,0,607,0.0,46079393,0,607,0,/well/papiez/users/hri611/python/nnUNet_results/Dataset219_PETCT/nnUNetTrainer_1500epochs_NoMirroring__nnUNetPlans__3d_fullres/crossval_results_folds_0_1_2_3_4/PETCT_75210090cd_07022005.nii.gz,/well/papiez/users/hri611/python/nnUnet_raw/Dataset219_PETCT/labelsTr/PETCT_75210090cd_07022005.nii.gz,0.0,7.551699726104736,0.0,2,0
398,398,0.0,0,315,0.0,52159685,0,315,0,/well/papiez/users/hri611/python/nnUNet_results/Dataset219_PETCT/nnUNetTrainer_1500epochs_NoMirroring__nnUNetPlans__3d_fullres/crossval_results_folds_0_1_2_3_4/PETCT_75d1080946_07282003.nii.gz,/well/papiez/users/hri611/python/nnUnet_raw/Dataset219_PETCT/labelsTr/PETCT_75d1080946_07282003.nii.gz,0.0,3.9189216041564943,0.0,5,0
399,399,0.0,0,2,0.0,38719998,0,2,0,/well/papiez/users/hri611/python/nnUNet_results/Dataset219_PETCT/nnUNetTrainer_1500epochs_NoMirroring__nnUNetPlans__3d_fullres/crossval_results_folds_0_1_2_3_4/PETCT_75d5e740f0_07112002.nii.gz,/well/papiez/users/hri611/python/nnUnet_raw/Dataset219_PETCT/labelsTr/PETCT_75d5e740f0_07112002.nii.gz,0.0,0.0248820419311523,0.0,2,0
400,400,0.0,0,7,0.0,52159993,0,7,0,/well/papiez/users/hri611/python/nnUNet_results/Dataset219_PETCT/nnUNetTrainer_1500epochs_NoMirroring__nnUNetPlans__3d_fullres/crossval_results_folds_0_1_2_3_4/PETCT_75e42ff05f_09212002.nii.gz,/well/papiez/users/hri611/python/nnUnet_raw/Dataset219_PETCT/labelsTr/PETCT_75e42ff05f_09212002.nii.gz,0.0,0.0870871467590332,0.0,2,0
401,401,0.3010640153497296,4003,4,0.1772073921971252,45435130,863,867,4866,/well/papiez/users/hri611/python/nnUNet_results/Dataset219_PETCT/nnUNetTrainer_1500epochs_NoMirroring__nnUNetPlans__3d_fullres/crossval_results_folds_0_1_2_3_4/PETCT_760c77b289_01202002.nii.gz,/well/papiez/users/hri611/python/nnUnet_raw/Dataset219_PETCT/labelsTr/PETCT_760c77b289_01202002.nii.gz,0.3010640153497296,0.0,11.520385414123536,3,6
402,402,0.0,0,1221,0.0,45438779,0,1221,0,/well/papiez/users/hri611/python/nnUNet_results/Dataset219_PETCT/nnUNetTrainer_1500epochs_NoMirroring__nnUNetPlans__3d_fullres/crossval_results_folds_0_1_2_3_4/PETCT_777fa0ba88_04072003.nii.gz,/well/papiez/users/hri611/python/nnUnet_raw/Dataset219_PETCT/labelsTr/PETCT_777fa0ba88_04072003.nii.gz,0.0,15.190486598968503,0.0,4,0
403,403,0.0,0,67,0.0,45439933,0,67,0,/well/papiez/users/hri611/python/nnUNet_results/Dataset219_PETCT/nnUNetTrainer_1500epochs_NoMirroring__nnUNetPlans__3d_fullres/crossval_results_folds_0_1_2_3_4/PETCT_777fa0ba88_11042002.nii.gz,/well/papiez/users/hri611/python/nnUnet_raw/Dataset219_PETCT/labelsTr/PETCT_777fa0ba88_11042002.nii.gz,0.0,0.8335484046936035,0.0,11,0
404,404,0.8115107913669065,56,75,0.6828087167070218,97279587,282,357,338,/well/papiez/users/hri611/python/nnUNet_results/Dataset219_PETCT/nnUNetTrainer_1500epochs_NoMirroring__nnUNetPlans__3d_fullres/crossval_results_folds_0_1_2_3_4/PETCT_7785c10e91_12152006.nii.gz,/well/papiez/users/hri611/python/nnUnet_raw/Dataset219_PETCT/labelsTr/PETCT_7785c10e91_12152006.nii.gz,0.8115107913669065,0.0497640838623046,0.0,2,1
405,405,0.8175287356321839,351,157,0.6913730255164034,45438354,1138,1295,1489,/well/papiez/users/hri611/python/nnUNet_results/Dataset219_PETCT/nnUNetTrainer_1500epochs_NoMirroring__nnUNetPlans__3d_fullres/crossval_results_folds_0_1_2_3_4/PETCT_77bceab232_11212002.nii.gz,/well/papiez/users/hri611/python/nnUnet_raw/Dataset219_PETCT/labelsTr/PETCT_77bceab232_11212002.nii.gz,0.8175287356321839,1.8039480400085448,1.1321329078674316,4,3
406,406,0.0,0,11,0.0,52959989,0,11,0,/well/papiez/users/hri611/python/nnUNet_results/Dataset219_PETCT/nnUNetTrainer_1500epochs_NoMirroring__nnUNetPlans__3d_fullres/crossval_results_folds_0_1_2_3_4/PETCT_78355d1d4f_01232006.nii.gz,/well/papiez/users/hri611/python/nnUnet_raw/Dataset219_PETCT/labelsTr/PETCT_78355d1d4f_01232006.nii.gz,0.0,0.1368512306213379,0.0,1,0
407,407,0.0,0,1,0.0,52159999,0,1,0,/well/papiez/users/hri611/python/nnUNet_results/Dataset219_PETCT/nnUNetTrainer_1500epochs_NoMirroring__nnUNetPlans__3d_fullres/crossval_results_folds_0_1_2_3_4/PETCT_78b89bc739_11082004.nii.gz,/well/papiez/users/hri611/python/nnUnet_raw/Dataset219_PETCT/labelsTr/PETCT_78b89bc739_11082004.nii.gz,0.0,0.0124410209655761,0.0,1,0
408,408,0.7903744880046811,90,2776,0.6534042810497037,45431731,5403,8179,5493,/well/papiez/users/hri611/python/nnUNet_results/Dataset219_PETCT/nnUNetTrainer_1500epochs_NoMirroring__nnUNetPlans__3d_fullres/crossval_results_folds_0_1_2_3_4/PETCT_790246c76c_02072004.nii.gz,/well/papiez/users/hri611/python/nnUnet_raw/Dataset219_PETCT/labelsTr/PETCT_790246c76c_02072004.nii.gz,0.7903744880046811,4.603177757263183,0.0,6,3
409,409,0.8791733599617939,57,2726,0.7843972730089867,72147092,10125,12851,10182,/well/papiez/users/hri611/python/nnUNet_results/Dataset219_PETCT/nnUNetTrainer_1500epochs_NoMirroring__nnUNetPlans__3d_fullres/crossval_results_folds_0_1_2_3_4/PETCT_791ec15924_04162001.nii.gz,/well/papiez/users/hri611/python/nnUnet_raw/Dataset219_PETCT/labelsTr/PETCT_791ec15924_04162001.nii.gz,0.8791733599617939,3.620337100982666,0.4976408386230468,17,14
410,410,0.0,0,119,0.0,31999881,0,119,0,/well/papiez/users/hri611/python/nnUNet_results/Dataset219_PETCT/nnUNetTrainer_1500epochs_NoMirroring__nnUNetPlans__3d_fullres/crossval_results_folds_0_1_2_3_4/PETCT_792d7b6ad0_04042005.nii.gz,/well/papiez/users/hri611/python/nnUnet_raw/Dataset219_PETCT/labelsTr/PETCT_792d7b6ad0_04042005.nii.gz,0.0,1.4804814949035645,0.0,3,0
411,411,0.6829997978572873,7003,838,0.518602652259332,45423712,8447,9285,15450,/well/papiez/users/hri611/python/nnUNet_results/Dataset219_PETCT/nnUNetTrainer_1500epochs_NoMirroring__nnUNetPlans__3d_fullres/crossval_results_folds_0_1_2_3_4/PETCT_7948aa0e26_08102001.nii.gz,/well/papiez/users/hri611/python/nnUnet_raw/Dataset219_PETCT/labelsTr/PETCT_7948aa0e26_08102001.nii.gz,0.6829997978572873,0.2488204193115234,39.99788240432739,23,26
412,412,0.7369942196531792,113,69,0.5835240274599542,52159563,255,324,368,/well/papiez/users/hri611/python/nnUNet_results/Dataset219_PETCT/nnUNetTrainer_1500epochs_NoMirroring__nnUNetPlans__3d_fullres/crossval_results_folds_0_1_2_3_4/PETCT_7958ce0f7c_08312003.nii.gz,/well/papiez/users/hri611/python/nnUnet_raw/Dataset219_PETCT/labelsTr/PETCT_7958ce0f7c_08312003.nii.gz,0.7369942196531792,0.8584304466247559,0.0,4,2
413,413,0.0,0,1,0.0,45439999,0,1,0,/well/papiez/users/hri611/python/nnUNet_results/Dataset219_PETCT/nnUNetTrainer_1500epochs_NoMirroring__nnUNetPlans__3d_fullres/crossval_results_folds_0_1_2_3_4/PETCT_7978e9fe62_03232003.nii.gz,/well/papiez/users/hri611/python/nnUnet_raw/Dataset219_PETCT/labelsTr/PETCT_7978e9fe62_03232003.nii.gz,0.0,0.0124410209655761,0.0,1,0
414,414,,0,0,,49120000,0,0,0,/well/papiez/users/hri611/python/nnUNet_results/Dataset219_PETCT/nnUNetTrainer_1500epochs_NoMirroring__nnUNetPlans__3d_fullres/crossval_results_folds_0_1_2_3_4/PETCT_7a262070a9_11252005.nii.gz,/well/papiez/users/hri611/python/nnUnet_raw/Dataset219_PETCT/labelsTr/PETCT_7a262070a9_11252005.nii.gz,,0.0,0.0,0,0
415,415,,0,0,,46240000,0,0,0,/well/papiez/users/hri611/python/nnUNet_results/Dataset219_PETCT/nnUNetTrainer_1500epochs_NoMirroring__nnUNetPlans__3d_fullres/crossval_results_folds_0_1_2_3_4/PETCT_7a3a27371a_04132006.nii.gz,/well/papiez/users/hri611/python/nnUnet_raw/Dataset219_PETCT/labelsTr/PETCT_7a3a27371a_04132006.nii.gz,,0.0,0.0,0,0
416,416,0.7333791907168705,7589,1326,0.5790045334340763,45418824,12261,13587,19850,/well/papiez/users/hri611/python/nnUNet_results/Dataset219_PETCT/nnUNetTrainer_1500epochs_NoMirroring__nnUNetPlans__3d_fullres/crossval_results_folds_0_1_2_3_4/PETCT_7a77b26403_10202000.nii.gz,/well/papiez/users/hri611/python/nnUnet_raw/Dataset219_PETCT/labelsTr/PETCT_7a77b26403_10202000.nii.gz,0.7333791907168705,0.2861434822082519,12.764487510681152,36,38
417,417,0.605394499309759,7367,65,0.4340973121145207,52146867,5701,5766,13068,/well/papiez/users/hri611/python/nnUNet_results/Dataset219_PETCT/nnUNetTrainer_1500epochs_NoMirroring__nnUNetPlans__3d_fullres/crossval_results_folds_0_1_2_3_4/PETCT_7a8a062ed5_03122005.nii.gz,/well/papiez/users/hri611/python/nnUnet_raw/Dataset219_PETCT/labelsTr/PETCT_7a8a062ed5_03122005.nii.gz,0.605394499309759,0.3359075660705566,0.0124410209655761,6,3
418,418,0.0,0,145,0.0,43519855,0,145,0,/well/papiez/users/hri611/python/nnUNet_results/Dataset219_PETCT/nnUNetTrainer_1500epochs_NoMirroring__nnUNetPlans__3d_fullres/crossval_results_folds_0_1_2_3_4/PETCT_7abe274c10_09212006.nii.gz,/well/papiez/users/hri611/python/nnUnet_raw/Dataset219_PETCT/labelsTr/PETCT_7abe274c10_09212006.nii.gz,0.0,1.8039480400085448,0.0,1,0
419,419,0.8338992899816594,8133,1014,0.7151177276691167,45407892,22961,23975,31094,/well/papiez/users/hri611/python/nnUNet_results/Dataset219_PETCT/nnUNetTrainer_1500epochs_NoMirroring__nnUNetPlans__3d_fullres/crossval_results_folds_0_1_2_3_4/PETCT_7b42056ee3_10132002.nii.gz,/well/papiez/users/hri611/python/nnUnet_raw/Dataset219_PETCT/labelsTr/PETCT_7b42056ee3_10132002.nii.gz,0.8338992899816594,0.0,18.26341877746582,3,4
420,420,0.0,0,159,0.0,92319841,0,159,0,/well/papiez/users/hri611/python/nnUNet_results/Dataset219_PETCT/nnUNetTrainer_1500epochs_NoMirroring__nnUNetPlans__3d_fullres/crossval_results_folds_0_1_2_3_4/PETCT_7b477e7e0d_06192003.nii.gz,/well/papiez/users/hri611/python/nnUnet_raw/Dataset219_PETCT/labelsTr/PETCT_7b477e7e0d_06192003.nii.gz,0.0,1.9781223335266116,0.0,2,0
421,421,0.8956534254461715,3001,1349,0.8110256744428516,99016981,18669,20018,21670,/well/papiez/users/hri611/python/nnUNet_results/Dataset219_PETCT/nnUNetTrainer_1500epochs_NoMirroring__nnUNetPlans__3d_fullres/crossval_results_folds_0_1_2_3_4/PETCT_7b477e7e0d_07262002.nii.gz,/well/papiez/users/hri611/python/nnUnet_raw/Dataset219_PETCT/labelsTr/PETCT_7b477e7e0d_07262002.nii.gz,0.8956534254461715,1.3187482223510745,1.9159172286987305,37,40
422,422,0.0,0,1,0.0,52159999,0,1,0,/well/papiez/users/hri611/python/nnUNet_results/Dataset219_PETCT/nnUNetTrainer_1500epochs_NoMirroring__nnUNetPlans__3d_fullres/crossval_results_folds_0_1_2_3_4/PETCT_7b9d625330_11172002.nii.gz,/well/papiez/users/hri611/python/nnUnet_raw/Dataset219_PETCT/labelsTr/PETCT_7b9d625330_11172002.nii.gz,0.0,0.0124410209655761,0.0,1,0
423,423,0.0,0,29,0.0,99039971,0,29,0,/well/papiez/users/hri611/python/nnUNet_results/Dataset219_PETCT/nnUNetTrainer_1500epochs_NoMirroring__nnUNetPlans__3d_fullres/crossval_results_folds_0_1_2_3_4/PETCT_7c1e6175e0_01302005.nii.gz,/well/papiez/users/hri611/python/nnUnet_raw/Dataset219_PETCT/labelsTr/PETCT_7c1e6175e0_01302005.nii.gz,0.0,0.360789608001709,0.0,2,0
424,424,0.0,0,7715,0.0,52152285,0,7715,0,/well/papiez/users/hri611/python/nnUNet_results/Dataset219_PETCT/nnUNetTrainer_1500epochs_NoMirroring__nnUNetPlans__3d_fullres/crossval_results_folds_0_1_2_3_4/PETCT_7c96c4626d_06302003.nii.gz,/well/papiez/users/hri611/python/nnUnet_raw/Dataset219_PETCT/labelsTr/PETCT_7c96c4626d_06302003.nii.gz,0.0,95.98247674942016,0.0,9,0
425,425,0.872651356993737,64,58,0.774074074074074,89279460,418,476,482,/well/papiez/users/hri611/python/nnUNet_results/Dataset219_PETCT/nnUNetTrainer_1500epochs_NoMirroring__nnUNetPlans__3d_fullres/crossval_results_folds_0_1_2_3_4/PETCT_7ce196485f_01192006.nii.gz,/well/papiez/users/hri611/python/nnUnet_raw/Dataset219_PETCT/labelsTr/PETCT_7ce196485f_01192006.nii.gz,0.872651356993737,0.0248820419311523,0.0,4,3
426,426,0.5427342661578533,824,6725,0.3724332862249563,92147971,4480,11205,5304,/well/papiez/users/hri611/python/nnUNet_results/Dataset219_PETCT/nnUNetTrainer_1500epochs_NoMirroring__nnUNetPlans__3d_fullres/crossval_results_folds_0_1_2_3_4/PETCT_7cfd708a53_06172005.nii.gz,/well/papiez/users/hri611/python/nnUnet_raw/Dataset219_PETCT/labelsTr/PETCT_7cfd708a53_06172005.nii.gz,0.5427342661578533,75.2308537788391,0.0622051048278808,32,24
427,427,0.1197339246119734,1705,280,0.0636792452830188,52157880,135,415,1840,/well/papiez/users/hri611/python/nnUNet_results/Dataset219_PETCT/nnUNetTrainer_1500epochs_NoMirroring__nnUNetPlans__3d_fullres/crossval_results_folds_0_1_2_3_4/PETCT_7d01eb835d_03312002.nii.gz,/well/papiez/users/hri611/python/nnUnet_raw/Dataset219_PETCT/labelsTr/PETCT_7d01eb835d_03312002.nii.gz,0.1197339246119734,2.774347675323486,21.211940746307373,4,2
428,428,0.0,0,15,0.0,52159985,0,15,0,/well/papiez/users/hri611/python/nnUNet_results/Dataset219_PETCT/nnUNetTrainer_1500epochs_NoMirroring__nnUNetPlans__3d_fullres/crossval_results_folds_0_1_2_3_4/PETCT_7d8aa1e94d_10042002.nii.gz,/well/papiez/users/hri611/python/nnUnet_raw/Dataset219_PETCT/labelsTr/PETCT_7d8aa1e94d_10042002.nii.gz,0.0,0.1866153144836425,0.0,3,0
429,429,0.8553753552917572,2289,306,0.7472976920829681,52149731,7674,7980,9963,/well/papiez/users/hri611/python/nnUNet_results/Dataset219_PETCT/nnUNetTrainer_1500epochs_NoMirroring__nnUNetPlans__3d_fullres/crossval_results_folds_0_1_2_3_4/PETCT_7d97f7a102_04212002.nii.gz,/well/papiez/users/hri611/python/nnUnet_raw/Dataset219_PETCT/labelsTr/PETCT_7d97f7a102_04212002.nii.gz,0.8553753552917572,0.0248820419311523,0.0,3,2
430,430,,0,0,,46240000,0,0,0,/well/papiez/users/hri611/python/nnUNet_results/Dataset219_PETCT/nnUNetTrainer_1500epochs_NoMirroring__nnUNetPlans__3d_fullres/crossval_results_folds_0_1_2_3_4/PETCT_7e56b0b62c_05272006.nii.gz,/well/papiez/users/hri611/python/nnUnet_raw/Dataset219_PETCT/labelsTr/PETCT_7e56b0b62c_05272006.nii.gz,,0.0,0.0,0,0
431,431,0.844047619047619,590,458,0.7301750772399588,52156116,2836,3294,3426,/well/papiez/users/hri611/python/nnUNet_results/Dataset219_PETCT/nnUNetTrainer_1500epochs_NoMirroring__nnUNetPlans__3d_fullres/crossval_results_folds_0_1_2_3_4/PETCT_7e5729ea40_02212003.nii.gz,/well/papiez/users/hri611/python/nnUnet_raw/Dataset219_PETCT/labelsTr/PETCT_7e5729ea40_02212003.nii.gz,0.844047619047619,0.9206355514526368,2.4508811302185056,11,3
432,432,0.8170930865541643,21,651,0.6907501150483203,52157827,1501,2152,1522,/well/papiez/users/hri611/python/nnUNet_results/Dataset219_PETCT/nnUNetTrainer_1500epochs_NoMirroring__nnUNetPlans__3d_fullres/crossval_results_folds_0_1_2_3_4/PETCT_7ed037687a_01272003.nii.gz,/well/papiez/users/hri611/python/nnUnet_raw/Dataset219_PETCT/labelsTr/PETCT_7ed037687a_01272003.nii.gz,0.8170930865541643,0.2861434822082519,0.0,3,2
433,433,0.0,0,55,0.0,51039945,0,55,0,/well/papiez/users/hri611/python/nnUNet_results/Dataset219_PETCT/nnUNetTrainer_1500epochs_NoMirroring__nnUNetPlans__3d_fullres/crossval_results_folds_0_1_2_3_4/PETCT_7ee7610b9e_01212006.nii.gz,/well/papiez/users/hri611/python/nnUnet_raw/Dataset219_PETCT/labelsTr/PETCT_7ee7610b9e_01212006.nii.gz,0.0,0.6842561531066894,0.0,3,0
434,434,0.0,0,689,0.0,52159311,0,689,0,/well/papiez/users/hri611/python/nnUNet_results/Dataset219_PETCT/nnUNetTrainer_1500epochs_NoMirroring__nnUNetPlans__3d_fullres/crossval_results_folds_0_1_2_3_4/PETCT_7ef5343426_05122005.nii.gz,/well/papiez/users/hri611/python/nnUnet_raw/Dataset219_PETCT/labelsTr/PETCT_7ef5343426_05122005.nii.gz,0.0,8.571863445281982,0.0,4,0
435,435,0.449669360764144,468,1030,0.2900473933649289,99037890,612,1642,1080,/well/papiez/users/hri611/python/nnUNet_results/Dataset219_PETCT/nnUNetTrainer_1500epochs_NoMirroring__nnUNetPlans__3d_fullres/crossval_results_folds_0_1_2_3_4/PETCT_7f2a604e03_05052002.nii.gz,/well/papiez/users/hri611/python/nnUnet_raw/Dataset219_PETCT/labelsTr/PETCT_7f2a604e03_05052002.nii.gz,0.449669360764144,10.997862533569336,3.458603828430176,18,28
436,436,0.9218543046357616,178,117,0.855036855036855,45437965,1740,1857,1918,/well/papiez/users/hri611/python/nnUNet_results/Dataset219_PETCT/nnUNetTrainer_1500epochs_NoMirroring__nnUNetPlans__3d_fullres/crossval_results_folds_0_1_2_3_4/PETCT_7faf36a152_06142002.nii.gz,/well/papiez/users/hri611/python/nnUnet_raw/Dataset219_PETCT/labelsTr/PETCT_7faf36a152_06142002.nii.gz,0.9218543046357616,0.0,0.0,1,1
437,437,0.0,0,1,0.0,45439999,0,1,0,/well/papiez/users/hri611/python/nnUNet_results/Dataset219_PETCT/nnUNetTrainer_1500epochs_NoMirroring__nnUNetPlans__3d_fullres/crossval_results_folds_0_1_2_3_4/PETCT_7faf36a152_11272005.nii.gz,/well/papiez/users/hri611/python/nnUnet_raw/Dataset219_PETCT/labelsTr/PETCT_7faf36a152_11272005.nii.gz,0.0,0.0124410209655761,0.0,1,0
438,438,0.6228666364597493,954,1543,0.4522921693353806,85595441,2062,3605,3016,/well/papiez/users/hri611/python/nnUNet_results/Dataset219_PETCT/nnUNetTrainer_1500epochs_NoMirroring__nnUNetPlans__3d_fullres/crossval_results_folds_0_1_2_3_4/PETCT_7fbb39290e_08152002.nii.gz,/well/papiez/users/hri611/python/nnUnet_raw/Dataset219_PETCT/labelsTr/PETCT_7fbb39290e_08152002.nii.gz,0.6228666364597493,17.666249771118164,1.965681312561035,14,12
439,439,0.7994344576853161,1854,132,0.6658815612382234,45434056,3958,4090,5812,/well/papiez/users/hri611/python/nnUNet_results/Dataset219_PETCT/nnUNetTrainer_1500epochs_NoMirroring__nnUNetPlans__3d_fullres/crossval_results_folds_0_1_2_3_4/PETCT_802f19931c_06302002.nii.gz,/well/papiez/users/hri611/python/nnUnet_raw/Dataset219_PETCT/labelsTr/PETCT_802f19931c_06302002.nii.gz,0.7994344576853161,0.0,0.0,1,1
440,440,0.0,0,24,0.0,38719976,0,24,0,/well/papiez/users/hri611/python/nnUNet_results/Dataset219_PETCT/nnUNetTrainer_1500epochs_NoMirroring__nnUNetPlans__3d_fullres/crossval_results_folds_0_1_2_3_4/PETCT_80b8393c44_07222002.nii.gz,/well/papiez/users/hri611/python/nnUnet_raw/Dataset219_PETCT/labelsTr/PETCT_80b8393c44_07222002.nii.gz,0.0,0.2985845031738281,0.0,5,0
441,441,0.8336380255941499,304,151,0.7147335423197492,52158405,1140,1291,1444,/well/papiez/users/hri611/python/nnUNet_results/Dataset219_PETCT/nnUNetTrainer_1500epochs_NoMirroring__nnUNetPlans__3d_fullres/crossval_results_folds_0_1_2_3_4/PETCT_80ccbdadf9_05062002.nii.gz,/well/papiez/users/hri611/python/nnUnet_raw/Dataset219_PETCT/labelsTr/PETCT_80ccbdadf9_05062002.nii.gz,0.8336380255941499,0.1368512306213379,2.1522966270446777,5,3
442,442,0.7897646596779554,6064,895,0.6525711432850724,52139970,13071,13966,19135,/well/papiez/users/hri611/python/nnUNet_results/Dataset219_PETCT/nnUNetTrainer_1500epochs_NoMirroring__nnUNetPlans__3d_fullres/crossval_results_folds_0_1_2_3_4/PETCT_80d7e682f7_02112005.nii.gz,/well/papiez/users/hri611/python/nnUnet_raw/Dataset219_PETCT/labelsTr/PETCT_80d7e682f7_02112005.nii.gz,0.7897646596779554,0.5971690063476562,0.1990563354492187,14,14
443,443,,0,0,,50560000,0,0,0,/well/papiez/users/hri611/python/nnUNet_results/Dataset219_PETCT/nnUNetTrainer_1500epochs_NoMirroring__nnUNetPlans__3d_fullres/crossval_results_folds_0_1_2_3_4/PETCT_80f21e1ed0_11122006.nii.gz,/well/papiez/users/hri611/python/nnUnet_raw/Dataset219_PETCT/labelsTr/PETCT_80f21e1ed0_11122006.nii.gz,,0.0,0.0,0,0
444,444,0.0,0,4960,0.0,92315040,0,4960,0,/well/papiez/users/hri611/python/nnUNet_results/Dataset219_PETCT/nnUNetTrainer_1500epochs_NoMirroring__nnUNetPlans__3d_fullres/crossval_results_folds_0_1_2_3_4/PETCT_80f7760f65_05022005.nii.gz,/well/papiez/users/hri611/python/nnUnet_raw/Dataset219_PETCT/labelsTr/PETCT_80f7760f65_05022005.nii.gz,0.0,61.70746398925781,0.0,5,0
445,445,0.0,0,480,0.0,92319520,0,480,0,/well/papiez/users/hri611/python/nnUNet_results/Dataset219_PETCT/nnUNetTrainer_1500epochs_NoMirroring__nnUNetPlans__3d_fullres/crossval_results_folds_0_1_2_3_4/PETCT_80f7760f65_11142005.nii.gz,/well/papiez/users/hri611/python/nnUnet_raw/Dataset219_PETCT/labelsTr/PETCT_80f7760f65_11142005.nii.gz,0.0,5.971690063476562,0.0,2,0
446,446,0.0,0,20,0.0,49919980,0,20,0,/well/papiez/users/hri611/python/nnUNet_results/Dataset219_PETCT/nnUNetTrainer_1500epochs_NoMirroring__nnUNetPlans__3d_fullres/crossval_results_folds_0_1_2_3_4/PETCT_81debf13a1_03092006.nii.gz,/well/papiez/users/hri611/python/nnUnet_raw/Dataset219_PETCT/labelsTr/PETCT_81debf13a1_03092006.nii.gz,0.0,0.2488204193115234,0.0,1,0
447,447,0.7725102548584494,43,3340,0.629341514188671,52150873,5744,9084,5787,/well/papiez/users/hri611/python/nnUNet_results/Dataset219_PETCT/nnUNetTrainer_1500epochs_NoMirroring__nnUNetPlans__3d_fullres/crossval_results_folds_0_1_2_3_4/PETCT_82137245b0_01262002.nii.gz,/well/papiez/users/hri611/python/nnUnet_raw/Dataset219_PETCT/labelsTr/PETCT_82137245b0_01262002.nii.gz,0.7725102548584494,0.3732306289672851,0.0124410209655761,8,8
448,448,0.0,0,87,0.0,52159913,0,87,0,/well/papiez/users/hri611/python/nnUNet_results/Dataset219_PETCT/nnUNetTrainer_1500epochs_NoMirroring__nnUNetPlans__3d_fullres/crossval_results_folds_0_1_2_3_4/PETCT_8311aeddb9_11132003.nii.gz,/well/papiez/users/hri611/python/nnUnet_raw/Dataset219_PETCT/labelsTr/PETCT_8311aeddb9_11132003.nii.gz,0.0,1.082368824005127,0.0,9,0
449,449,0.0,0,97,0.0,47519903,0,97,0,/well/papiez/users/hri611/python/nnUNet_results/Dataset219_PETCT/nnUNetTrainer_1500epochs_NoMirroring__nnUNetPlans__3d_fullres/crossval_results_folds_0_1_2_3_4/PETCT_8311aeddb9_12162005.nii.gz,/well/papiez/users/hri611/python/nnUnet_raw/Dataset219_PETCT/labelsTr/PETCT_8311aeddb9_12162005.nii.gz,0.0,1.2067790336608886,0.0,1,0
450,450,,0,0,,47200000,0,0,0,/well/papiez/users/hri611/python/nnUNet_results/Dataset219_PETCT/nnUNetTrainer_1500epochs_NoMirroring__nnUNetPlans__3d_fullres/crossval_results_folds_0_1_2_3_4/PETCT_83e4c5b578_03112006.nii.gz,/well/papiez/users/hri611/python/nnUnet_raw/Dataset219_PETCT/labelsTr/PETCT_83e4c5b578_03112006.nii.gz,,0.0,0.0,0,0
451,451,0.0,0,27,0.0,52159973,0,27,0,/well/papiez/users/hri611/python/nnUNet_results/Dataset219_PETCT/nnUNetTrainer_1500epochs_NoMirroring__nnUNetPlans__3d_fullres/crossval_results_folds_0_1_2_3_4/PETCT_846c1af245_12062002.nii.gz,/well/papiez/users/hri611/python/nnUnet_raw/Dataset219_PETCT/labelsTr/PETCT_846c1af245_12062002.nii.gz,0.0,0.3359075660705566,0.0,5,0
452,452,0.7925849105522427,2045,1155,0.6564311788705175,51990686,6114,7269,8159,/well/papiez/users/hri611/python/nnUNet_results/Dataset219_PETCT/nnUNetTrainer_1500epochs_NoMirroring__nnUNetPlans__3d_fullres/crossval_results_folds_0_1_2_3_4/PETCT_84e7715ed9_01042002.nii.gz,/well/papiez/users/hri611/python/nnUnet_raw/Dataset219_PETCT/labelsTr/PETCT_84e7715ed9_01042002.nii.gz,0.7925849105522427,13.100395076751708,0.0,6,3
453,453,,0,0,,47360000,0,0,0,/well/papiez/users/hri611/python/nnUNet_results/Dataset219_PETCT/nnUNetTrainer_1500epochs_NoMirroring__nnUNetPlans__3d_fullres/crossval_results_folds_0_1_2_3_4/PETCT_855c7fca12_07272006.nii.gz,/well/papiez/users/hri611/python/nnUnet_raw/Dataset219_PETCT/labelsTr/PETCT_855c7fca12_07272006.nii.gz,,0.0,0.0,0,0
454,454,0.0,0,452,0.0,46879548,0,452,0,/well/papiez/users/hri611/python/nnUNet_results/Dataset219_PETCT/nnUNetTrainer_1500epochs_NoMirroring__nnUNetPlans__3d_fullres/crossval_results_folds_0_1_2_3_4/PETCT_85b69fed1c_01212006.nii.gz,/well/papiez/users/hri611/python/nnUnet_raw/Dataset219_PETCT/labelsTr/PETCT_85b69fed1c_01212006.nii.gz,0.0,5.623341476440429,0.0,7,0
455,455,,0,0,,53600000,0,0,0,/well/papiez/users/hri611/python/nnUNet_results/Dataset219_PETCT/nnUNetTrainer_1500epochs_NoMirroring__nnUNetPlans__3d_fullres/crossval_results_folds_0_1_2_3_4/PETCT_86153b2974_03192006.nii.gz,/well/papiez/users/hri611/python/nnUnet_raw/Dataset219_PETCT/labelsTr/PETCT_86153b2974_03192006.nii.gz,,0.0,0.0,0,0
456,456,0.0,0,134,0.0,65439866,0,134,0,/well/papiez/users/hri611/python/nnUNet_results/Dataset219_PETCT/nnUNetTrainer_1500epochs_NoMirroring__nnUNetPlans__3d_fullres/crossval_results_folds_0_1_2_3_4/PETCT_86153b2974_04032005.nii.gz,/well/papiez/users/hri611/python/nnUnet_raw/Dataset219_PETCT/labelsTr/PETCT_86153b2974_04032005.nii.gz,0.0,1.667096809387207,0.0,3,0
457,457,0.8584126102354003,868,1171,0.7519464720194647,58871780,6181,7352,7049,/well/papiez/users/hri611/python/nnUNet_results/Dataset219_PETCT/nnUNetTrainer_1500epochs_NoMirroring__nnUNetPlans__3d_fullres/crossval_results_folds_0_1_2_3_4/PETCT_86153b2974_06052003.nii.gz,/well/papiez/users/hri611/python/nnUnet_raw/Dataset219_PETCT/labelsTr/PETCT_86153b2974_06052003.nii.gz,0.8584126102354003,1.1321329078674316,0.0124410209655761,11,11
458,458,0.0,0,660,0.0,53119340,0,660,0,/well/papiez/users/hri611/python/nnUNet_results/Dataset219_PETCT/nnUNetTrainer_1500epochs_NoMirroring__nnUNetPlans__3d_fullres/crossval_results_folds_0_1_2_3_4/PETCT_86153b2974_10022005.nii.gz,/well/papiez/users/hri611/python/nnUnet_raw/Dataset219_PETCT/labelsTr/PETCT_86153b2974_10022005.nii.gz,0.0,8.211073837280273,0.0,2,0
459,459,,0,0,,52960000,0,0,0,/well/papiez/users/hri611/python/nnUNet_results/Dataset219_PETCT/nnUNetTrainer_1500epochs_NoMirroring__nnUNetPlans__3d_fullres/crossval_results_folds_0_1_2_3_4/PETCT_86153b2974_10062006.nii.gz,/well/papiez/users/hri611/python/nnUnet_raw/Dataset219_PETCT/labelsTr/PETCT_86153b2974_10062006.nii.gz,,0.0,0.0,0,0
460,460,0.8349779207327046,97,2930,0.7167056621431914,45429315,7658,10588,7755,/well/papiez/users/hri611/python/nnUNet_results/Dataset219_PETCT/nnUNetTrainer_1500epochs_NoMirroring__nnUNetPlans__3d_fullres/crossval_results_folds_0_1_2_3_4/PETCT_86e54ea60a_03182002.nii.gz,/well/papiez/users/hri611/python/nnUnet_raw/Dataset219_PETCT/labelsTr/PETCT_86e54ea60a_03182002.nii.gz,0.8349779207327046,13.933943481445311,0.721579216003418,6,6
461,461,0.2921928817451205,0,2466,0.1710924369747899,45437025,509,2975,509,/well/papiez/users/hri611/python/nnUNet_results/Dataset219_PETCT/nnUNetTrainer_1500epochs_NoMirroring__nnUNetPlans__3d_fullres/crossval_results_folds_0_1_2_3_4/PETCT_870181d7fd_10312004.nii.gz,/well/papiez/users/hri611/python/nnUnet_raw/Dataset219_PETCT/labelsTr/PETCT_870181d7fd_10312004.nii.gz,0.2921928817451205,26.08882096481323,0.0,15,2
462,462,,0,0,,87200000,0,0,0,/well/papiez/users/hri611/python/nnUNet_results/Dataset219_PETCT/nnUNetTrainer_1500epochs_NoMirroring__nnUNetPlans__3d_fullres/crossval_results_folds_0_1_2_3_4/PETCT_87afc291ec_01262006.nii.gz,/well/papiez/users/hri611/python/nnUnet_raw/Dataset219_PETCT/labelsTr/PETCT_87afc291ec_01262006.nii.gz,,0.0,0.0,0,0
463,463,0.0,0,464,0.0,85599536,0,464,0,/well/papiez/users/hri611/python/nnUNet_results/Dataset219_PETCT/nnUNetTrainer_1500epochs_NoMirroring__nnUNetPlans__3d_fullres/crossval_results_folds_0_1_2_3_4/PETCT_87afc291ec_07202003.nii.gz,/well/papiez/users/hri611/python/nnUnet_raw/Dataset219_PETCT/labelsTr/PETCT_87afc291ec_07202003.nii.gz,0.0,5.772633728027344,0.0,4,0
464,464,,0,0,,43680000,0,0,0,/well/papiez/users/hri611/python/nnUNet_results/Dataset219_PETCT/nnUNetTrainer_1500epochs_NoMirroring__nnUNetPlans__3d_fullres/crossval_results_folds_0_1_2_3_4/PETCT_8838c53a63_05222005.nii.gz,/well/papiez/users/hri611/python/nnUnet_raw/Dataset219_PETCT/labelsTr/PETCT_8838c53a63_05222005.nii.gz,,0.0,0.0,0,0
465,465,0.8602371932136386,6936,3246,0.7547510658284559,52118483,31335,34581,38271,/well/papiez/users/hri611/python/nnUNet_results/Dataset219_PETCT/nnUNetTrainer_1500epochs_NoMirroring__nnUNetPlans__3d_fullres/crossval_results_folds_0_1_2_3_4/PETCT_88bcc970b3_02282002.nii.gz,/well/papiez/users/hri611/python/nnUnet_raw/Dataset219_PETCT/labelsTr/PETCT_88bcc970b3_02282002.nii.gz,0.8602371932136386,2.425999088287353,18.773500637054443,13,7
466,466,0.5160202360876898,47,240,0.3477272727272727,92319560,153,393,200,/well/papiez/users/hri611/python/nnUNet_results/Dataset219_PETCT/nnUNetTrainer_1500epochs_NoMirroring__nnUNetPlans__3d_fullres/crossval_results_folds_0_1_2_3_4/PETCT_89065bc4ab_02202004.nii.gz,/well/papiez/users/hri611/python/nnUnet_raw/Dataset219_PETCT/labelsTr/PETCT_89065bc4ab_02202004.nii.gz,0.5160202360876898,1.1445739288330077,0.0,9,5
467,467,0.7897316930683849,11828,37842,0.6525261287479188,58737054,93276,131118,105104,/well/papiez/users/hri611/python/nnUNet_results/Dataset219_PETCT/nnUNetTrainer_1500epochs_NoMirroring__nnUNetPlans__3d_fullres/crossval_results_folds_0_1_2_3_4/PETCT_8a52353a72_02172003.nii.gz,/well/papiez/users/hri611/python/nnUnet_raw/Dataset219_PETCT/labelsTr/PETCT_8a52353a72_02172003.nii.gz,0.7897316930683849,20.65209480285645,39.66197483825683,110,251
468,468,0.8517404774922545,2917,337,0.7417665264661535,45427399,9347,9684,12264,/well/papiez/users/hri611/python/nnUNet_results/Dataset219_PETCT/nnUNetTrainer_1500epochs_NoMirroring__nnUNetPlans__3d_fullres/crossval_results_folds_0_1_2_3_4/PETCT_8aa48809ea_04162001.nii.gz,/well/papiez/users/hri611/python/nnUnet_raw/Dataset219_PETCT/labelsTr/PETCT_8aa48809ea_04162001.nii.gz,0.8517404774922545,2.687260528564453,0.0497640838623046,5,2
469,469,0.0,0,107,0.0,40639893,0,107,0,/well/papiez/users/hri611/python/nnUNet_results/Dataset219_PETCT/nnUNetTrainer_1500epochs_NoMirroring__nnUNetPlans__3d_fullres/crossval_results_folds_0_1_2_3_4/PETCT_8af3757198_12032006.nii.gz,/well/papiez/users/hri611/python/nnUnet_raw/Dataset219_PETCT/labelsTr/PETCT_8af3757198_12032006.nii.gz,0.0,1.3311892433166503,0.0,4,0
470,470,0.0,0,16,0.0,92799984,0,16,0,/well/papiez/users/hri611/python/nnUNet_results/Dataset219_PETCT/nnUNetTrainer_1500epochs_NoMirroring__nnUNetPlans__3d_fullres/crossval_results_folds_0_1_2_3_4/PETCT_8b14e6a819_01292006.nii.gz,/well/papiez/users/hri611/python/nnUnet_raw/Dataset219_PETCT/labelsTr/PETCT_8b14e6a819_01292006.nii.gz,0.0,0.1990563354492187,0.0,1,0
471,471,0.0,0,159,0.0,99039841,0,159,0,/well/papiez/users/hri611/python/nnUNet_results/Dataset219_PETCT/nnUNetTrainer_1500epochs_NoMirroring__nnUNetPlans__3d_fullres/crossval_results_folds_0_1_2_3_4/PETCT_8b40e356dc_06182007.nii.gz,/well/papiez/users/hri611/python/nnUnet_raw/Dataset219_PETCT/labelsTr/PETCT_8b40e356dc_06182007.nii.gz,0.0,1.9781223335266116,0.0,2,0
472,472,,0,0,,44800000,0,0,0,/well/papiez/users/hri611/python/nnUNet_results/Dataset219_PETCT/nnUNetTrainer_1500epochs_NoMirroring__nnUNetPlans__3d_fullres/crossval_results_folds_0_1_2_3_4/PETCT_8b714a64e7_05172007.nii.gz,/well/papiez/users/hri611/python/nnUnet_raw/Dataset219_PETCT/labelsTr/PETCT_8b714a64e7_05172007.nii.gz,,0.0,0.0,0,0
473,473,0.0,0,4,0.0,38719996,0,4,0,/well/papiez/users/hri611/python/nnUNet_results/Dataset219_PETCT/nnUNetTrainer_1500epochs_NoMirroring__nnUNetPlans__3d_fullres/crossval_results_folds_0_1_2_3_4/PETCT_8b73608326_04042003.nii.gz,/well/papiez/users/hri611/python/nnUnet_raw/Dataset219_PETCT/labelsTr/PETCT_8b73608326_04042003.nii.gz,0.0,0.0497640838623046,0.0,1,0
474,474,0.8883452619051555,436,6319,0.7991197549588128,52126373,26872,33191,27308,/well/papiez/users/hri611/python/nnUNet_results/Dataset219_PETCT/nnUNetTrainer_1500epochs_NoMirroring__nnUNetPlans__3d_fullres/crossval_results_folds_0_1_2_3_4/PETCT_8b74860ce6_03102005.nii.gz,/well/papiez/users/hri611/python/nnUnet_raw/Dataset219_PETCT/labelsTr/PETCT_8b74860ce6_03102005.nii.gz,0.8883452619051555,2.0652094802856444,0.0995281677246093,12,16
475,475,0.0,0,287,0.0,45439713,0,287,0,/well/papiez/users/hri611/python/nnUNet_results/Dataset219_PETCT/nnUNetTrainer_1500epochs_NoMirroring__nnUNetPlans__3d_fullres/crossval_results_folds_0_1_2_3_4/PETCT_8bebb676bf_12202002.nii.gz,/well/papiez/users/hri611/python/nnUnet_raw/Dataset219_PETCT/labelsTr/PETCT_8bebb676bf_12202002.nii.gz,0.0,3.570573017120361,0.0,3,0
476,476,0.0,0,12318,0.0,49267682,0,12318,0,/well/papiez/users/hri611/python/nnUNet_results/Dataset219_PETCT/nnUNetTrainer_1500epochs_NoMirroring__nnUNetPlans__3d_fullres/crossval_results_folds_0_1_2_3_4/PETCT_8bf08c9a42_06092006.nii.gz,/well/papiez/users/hri611/python/nnUnet_raw/Dataset219_PETCT/labelsTr/PETCT_8bf08c9a42_06092006.nii.gz,0.0,153.2484962539673,0.0,13,0
477,477,0.0,0,753,0.0,49919247,0,753,0,/well/papiez/users/hri611/python/nnUNet_results/Dataset219_PETCT/nnUNetTrainer_1500epochs_NoMirroring__nnUNetPlans__3d_fullres/crossval_results_folds_0_1_2_3_4/PETCT_8c5d99b459_05042007.nii.gz,/well/papiez/users/hri611/python/nnUnet_raw/Dataset219_PETCT/labelsTr/PETCT_8c5d99b459_05042007.nii.gz,0.0,9.368088787078856,0.0,9,0
478,478,0.4739756367663344,852,98,0.3105950653120464,52158622,428,526,1280,/well/papiez/users/hri611/python/nnUNet_results/Dataset219_PETCT/nnUNetTrainer_1500epochs_NoMirroring__nnUNetPlans__3d_fullres/crossval_results_folds_0_1_2_3_4/PETCT_8c8cd2699c_01182004.nii.gz,/well/papiez/users/hri611/python/nnUnet_raw/Dataset219_PETCT/labelsTr/PETCT_8c8cd2699c_01182004.nii.gz,0.4739756367663344,1.020163719177246,9.8159655418396,8,3
479,479,0.8341763259571479,1898,7544,0.7155252930011148,52126809,23749,31293,25647,/well/papiez/users/hri611/python/nnUNet_results/Dataset219_PETCT/nnUNetTrainer_1500epochs_NoMirroring__nnUNetPlans__3d_fullres/crossval_results_folds_0_1_2_3_4/PETCT_8de6953d23_01192001.nii.gz,/well/papiez/users/hri611/python/nnUnet_raw/Dataset219_PETCT/labelsTr/PETCT_8de6953d23_01192001.nii.gz,0.8341763259571479,2.01544539642334,0.0248820419311523,3,5
480,480,0.4932735426008968,396,169,0.3273809523809524,52159160,275,444,671,/well/papiez/users/hri611/python/nnUNet_results/Dataset219_PETCT/nnUNetTrainer_1500epochs_NoMirroring__nnUNetPlans__3d_fullres/crossval_results_folds_0_1_2_3_4/PETCT_8e02f36295_11082004.nii.gz,/well/papiez/users/hri611/python/nnUnet_raw/Dataset219_PETCT/labelsTr/PETCT_8e02f36295_11082004.nii.gz,0.4932735426008968,1.1072508659362792,1.0450457611083983,11,7
481,481,0.7939262472885033,0,95,0.658273381294964,52159722,183,278,183,/well/papiez/users/hri611/python/nnUNet_results/Dataset219_PETCT/nnUNetTrainer_1500epochs_NoMirroring__nnUNetPlans__3d_fullres/crossval_results_folds_0_1_2_3_4/PETCT_8e905366fe_04272001.nii.gz,/well/papiez/users/hri611/python/nnUnet_raw/Dataset219_PETCT/labelsTr/PETCT_8e905366fe_04272001.nii.gz,0.7939262472885033,0.0,0.0,1,1
482,482,0.0,0,5454,0.0,52154546,0,5454,0,/well/papiez/users/hri611/python/nnUNet_results/Dataset219_PETCT/nnUNetTrainer_1500epochs_NoMirroring__nnUNetPlans__3d_fullres/crossval_results_folds_0_1_2_3_4/PETCT_8eb3998417_07032004.nii.gz,/well/papiez/users/hri611/python/nnUnet_raw/Dataset219_PETCT/labelsTr/PETCT_8eb3998417_07032004.nii.gz,0.0,67.85332834625244,0.0,18,0
483,483,0.7653835405173217,44438,896,0.619936284372904,52040720,73946,74842,118384,/well/papiez/users/hri611/python/nnUNet_results/Dataset219_PETCT/nnUNetTrainer_1500epochs_NoMirroring__nnUNetPlans__3d_fullres/crossval_results_folds_0_1_2_3_4/PETCT_8ec13728df_10141999.nii.gz,/well/papiez/users/hri611/python/nnUnet_raw/Dataset219_PETCT/labelsTr/PETCT_8ec13728df_10141999.nii.gz,0.7653835405173217,0.0,129.18756170654297,96,198
484,484,0.0,0,9,0.0,52159991,0,9,0,/well/papiez/users/hri611/python/nnUNet_results/Dataset219_PETCT/nnUNetTrainer_1500epochs_NoMirroring__nnUNetPlans__3d_fullres/crossval_results_folds_0_1_2_3_4/PETCT_8f2878df50_02212003.nii.gz,/well/papiez/users/hri611/python/nnUnet_raw/Dataset219_PETCT/labelsTr/PETCT_8f2878df50_02212003.nii.gz,0.0,0.1119691886901855,0.0,2,0
485,485,0.6284271284271284,364,666,0.4581799053129932,52158099,871,1537,1235,/well/papiez/users/hri611/python/nnUNet_results/Dataset219_PETCT/nnUNetTrainer_1500epochs_NoMirroring__nnUNetPlans__3d_fullres/crossval_results_folds_0_1_2_3_4/PETCT_8f2878df50_08222002.nii.gz,/well/papiez/users/hri611/python/nnUnet_raw/Dataset219_PETCT/labelsTr/PETCT_8f2878df50_08222002.nii.gz,0.6284271284271284,6.3946847763061525,0.0373230628967285,8,6
486,486,0.0,0,1,0.0,37759999,0,1,0,/well/papiez/users/hri611/python/nnUNet_results/Dataset219_PETCT/nnUNetTrainer_1500epochs_NoMirroring__nnUNetPlans__3d_fullres/crossval_results_folds_0_1_2_3_4/PETCT_8fea5f0537_09262005.nii.gz,/well/papiez/users/hri611/python/nnUnet_raw/Dataset219_PETCT/labelsTr/PETCT_8fea5f0537_09262005.nii.gz,0.0,0.0124410209655761,0.0,1,0
487,487,0.6566918234848235,4727,5690,0.4888616290480863,52139620,9963,15653,14690,/well/papiez/users/hri611/python/nnUNet_results/Dataset219_PETCT/nnUNetTrainer_1500epochs_NoMirroring__nnUNetPlans__3d_fullres/crossval_results_folds_0_1_2_3_4/PETCT_901573a747_05132005.nii.gz,/well/papiez/users/hri611/python/nnUnet_raw/Dataset219_PETCT/labelsTr/PETCT_901573a747_05132005.nii.gz,0.6566918234848235,18.835705741882325,18.512239196777344,45,49
488,488,,0,0,,45440000,0,0,0,/well/papiez/users/hri611/python/nnUNet_results/Dataset219_PETCT/nnUNetTrainer_1500epochs_NoMirroring__nnUNetPlans__3d_fullres/crossval_results_folds_0_1_2_3_4/PETCT_90d668ed29_06072003.nii.gz,/well/papiez/users/hri611/python/nnUnet_raw/Dataset219_PETCT/labelsTr/PETCT_90d668ed29_06072003.nii.gz,,0.0,0.0,0,0
489,489,0.8251355900504956,3906,769,0.7023241006049029,52144295,11030,11799,14936,/well/papiez/users/hri611/python/nnUNet_results/Dataset219_PETCT/nnUNetTrainer_1500epochs_NoMirroring__nnUNetPlans__3d_fullres/crossval_results_folds_0_1_2_3_4/PETCT_90ea6a6aaf_07272001.nii.gz,/well/papiez/users/hri611/python/nnUnet_raw/Dataset219_PETCT/labelsTr/PETCT_90ea6a6aaf_07272001.nii.gz,0.8251355900504956,6.369802734375,0.1990563354492187,9,6
490,490,0.3152709359605911,49,1758,0.1871345029239766,90077777,416,2174,465,/well/papiez/users/hri611/python/nnUNet_results/Dataset219_PETCT/nnUNetTrainer_1500epochs_NoMirroring__nnUNetPlans__3d_fullres/crossval_results_folds_0_1_2_3_4/PETCT_912a25778f_05172007.nii.gz,/well/papiez/users/hri611/python/nnUnet_raw/Dataset219_PETCT/labelsTr/PETCT_912a25778f_05172007.nii.gz,0.3152709359605911,21.249263809204106,0.0,12,6
491,491,0.8514851485148515,38,7,0.7413793103448276,47999826,129,136,167,/well/papiez/users/hri611/python/nnUNet_results/Dataset219_PETCT/nnUNetTrainer_1500epochs_NoMirroring__nnUNetPlans__3d_fullres/crossval_results_folds_0_1_2_3_4/PETCT_91cfa804b0_09222006.nii.gz,/well/papiez/users/hri611/python/nnUnet_raw/Dataset219_PETCT/labelsTr/PETCT_91cfa804b0_09222006.nii.gz,0.8514851485148515,0.0622051048278808,0.2363793983459472,4,4
492,492,0.0,0,1402,0.0,49918598,0,1402,0,/well/papiez/users/hri611/python/nnUNet_results/Dataset219_PETCT/nnUNetTrainer_1500epochs_NoMirroring__nnUNetPlans__3d_fullres/crossval_results_folds_0_1_2_3_4/PETCT_92c3de23f5_10082005.nii.gz,/well/papiez/users/hri611/python/nnUnet_raw/Dataset219_PETCT/labelsTr/PETCT_92c3de23f5_10082005.nii.gz,0.0,17.442311393737793,0.0,2,0
493,493,0.7762139696919279,63696,2211,0.6342726183077333,45259792,114301,116512,177997,/well/papiez/users/hri611/python/nnUNet_results/Dataset219_PETCT/nnUNetTrainer_1500epochs_NoMirroring__nnUNetPlans__3d_fullres/crossval_results_folds_0_1_2_3_4/PETCT_92c5c944a5_07152002.nii.gz,/well/papiez/users/hri611/python/nnUnet_raw/Dataset219_PETCT/labelsTr/PETCT_92c5c944a5_07152002.nii.gz,0.7762139696919279,0.0124410209655761,11.955821147918702,28,31
494,494,0.0,0,12,0.0,52159988,0,12,0,/well/papiez/users/hri611/python/nnUNet_results/Dataset219_PETCT/nnUNetTrainer_1500epochs_NoMirroring__nnUNetPlans__3d_fullres/crossval_results_folds_0_1_2_3_4/PETCT_93132553f6_08122002.nii.gz,/well/papiez/users/hri611/python/nnUnet_raw/Dataset219_PETCT/labelsTr/PETCT_93132553f6_08122002.nii.gz,0.0,0.149292251586914,0.0,4,0
495,495,0.7931175747644408,173,837,0.6571622539035981,52157054,1936,2773,2109,/well/papiez/users/hri611/python/nnUNet_results/Dataset219_PETCT/nnUNetTrainer_1500epochs_NoMirroring__nnUNetPlans__3d_fullres/crossval_results_folds_0_1_2_3_4/PETCT_93bea242d1_07252002.nii.gz,/well/papiez/users/hri611/python/nnUnet_raw/Dataset219_PETCT/labelsTr/PETCT_93bea242d1_07252002.nii.gz,0.7931175747644408,0.0248820419311523,0.0,3,2
496,496,0.8626144879267277,2,163,0.7584187408491947,49759317,518,681,520,/well/papiez/users/hri611/python/nnUNet_results/Dataset219_PETCT/nnUNetTrainer_1500epochs_NoMirroring__nnUNetPlans__3d_fullres/crossval_results_folds_0_1_2_3_4/PETCT_94962fe878_06012007.nii.gz,/well/papiez/users/hri611/python/nnUnet_raw/Dataset219_PETCT/labelsTr/PETCT_94962fe878_06012007.nii.gz,0.8626144879267277,1.455599452972412,0.0,2,1
497,497,0.7120734732184756,4084,211,0.5528836144076619,52150394,5311,5522,9395,/well/papiez/users/hri611/python/nnUNet_results/Dataset219_PETCT/nnUNetTrainer_1500epochs_NoMirroring__nnUNetPlans__3d_fullres/crossval_results_folds_0_1_2_3_4/PETCT_94986389d4_11112002.nii.gz,/well/papiez/users/hri611/python/nnUnet_raw/Dataset219_PETCT/labelsTr/PETCT_94986389d4_11112002.nii.gz,0.7120734732184756,0.0248820419311523,10.276283317565918,5,5
498,498,0.0,84,358,0.0,102719558,0,358,84,/well/papiez/users/hri611/python/nnUNet_results/Dataset219_PETCT/nnUNetTrainer_1500epochs_NoMirroring__nnUNetPlans__3d_fullres/crossval_results_folds_0_1_2_3_4/PETCT_94cc0dac49_03092007.nii.gz,/well/papiez/users/hri611/python/nnUnet_raw/Dataset219_PETCT/labelsTr/PETCT_94cc0dac49_03092007.nii.gz,0.0,4.453885505676269,1.0450457611083983,8,1
499,499,0.0,0,1645,0.0,50878355,0,1645,0,/well/papiez/users/hri611/python/nnUNet_results/Dataset219_PETCT/nnUNetTrainer_1500epochs_NoMirroring__nnUNetPlans__3d_fullres/crossval_results_folds_0_1_2_3_4/PETCT_94cc0dac49_03102006.nii.gz,/well/papiez/users/hri611/python/nnUnet_raw/Dataset219_PETCT/labelsTr/PETCT_94cc0dac49_03102006.nii.gz,0.0,20.465479488372804,0.0,1,0
500,500,0.7363848980955563,1550,28,0.582760444209413,100956218,2204,2232,3754,/well/papiez/users/hri611/python/nnUNet_results/Dataset219_PETCT/nnUNetTrainer_1500epochs_NoMirroring__nnUNetPlans__3d_fullres/crossval_results_folds_0_1_2_3_4/PETCT_9521502dbb_05172007.nii.gz,/well/papiez/users/hri611/python/nnUnet_raw/Dataset219_PETCT/labelsTr/PETCT_9521502dbb_05172007.nii.gz,0.7363848980955563,0.0248820419311523,13.996148586273192,6,8
501,501,0.0,0,36,0.0,45439964,0,36,0,/well/papiez/users/hri611/python/nnUNet_results/Dataset219_PETCT/nnUNetTrainer_1500epochs_NoMirroring__nnUNetPlans__3d_fullres/crossval_results_folds_0_1_2_3_4/PETCT_956520090b_11012003.nii.gz,/well/papiez/users/hri611/python/nnUnet_raw/Dataset219_PETCT/labelsTr/PETCT_956520090b_11012003.nii.gz,0.0,0.4478767547607422,0.0,2,0
502,502,0.2036363636363636,102,117,0.1133603238866396,85599753,28,145,130,/well/papiez/users/hri611/python/nnUNet_results/Dataset219_PETCT/nnUNetTrainer_1500epochs_NoMirroring__nnUNetPlans__3d_fullres/crossval_results_folds_0_1_2_3_4/PETCT_95efdaba3c_10112003.nii.gz,/well/papiez/users/hri611/python/nnUnet_raw/Dataset219_PETCT/labelsTr/PETCT_95efdaba3c_10112003.nii.gz,0.2036363636363636,1.3560712852478027,1.2689841384887697,3,2
503,503,0.0,0,9,0.0,58879991,0,9,0,/well/papiez/users/hri611/python/nnUNet_results/Dataset219_PETCT/nnUNetTrainer_1500epochs_NoMirroring__nnUNetPlans__3d_fullres/crossval_results_folds_0_1_2_3_4/PETCT_960c5f4262_01162003.nii.gz,/well/papiez/users/hri611/python/nnUnet_raw/Dataset219_PETCT/labelsTr/PETCT_960c5f4262_01162003.nii.gz,0.0,0.1119691886901855,0.0,2,0
504,504,0.0,0,1,0.0,52159999,0,1,0,/well/papiez/users/hri611/python/nnUNet_results/Dataset219_PETCT/nnUNetTrainer_1500epochs_NoMirroring__nnUNetPlans__3d_fullres/crossval_results_folds_0_1_2_3_4/PETCT_960c5f4262_02252005.nii.gz,/well/papiez/users/hri611/python/nnUnet_raw/Dataset219_PETCT/labelsTr/PETCT_960c5f4262_02252005.nii.gz,0.0,0.0124410209655761,0.0,1,0
505,505,0.856167723061921,270,910,0.7485080988917306,45435308,3512,4422,3782,/well/papiez/users/hri611/python/nnUNet_results/Dataset219_PETCT/nnUNetTrainer_1500epochs_NoMirroring__nnUNetPlans__3d_fullres/crossval_results_folds_0_1_2_3_4/PETCT_963a71819a_10292001.nii.gz,/well/papiez/users/hri611/python/nnUnet_raw/Dataset219_PETCT/labelsTr/PETCT_963a71819a_10292001.nii.gz,0.856167723061921,6.133423336029052,0.0,5,2
506,506,0.0,0,850,0.0,46079150,0,850,0,/well/papiez/users/hri611/python/nnUNet_results/Dataset219_PETCT/nnUNetTrainer_1500epochs_NoMirroring__nnUNetPlans__3d_fullres/crossval_results_folds_0_1_2_3_4/PETCT_96e7a3ab28_06142007.nii.gz,/well/papiez/users/hri611/python/nnUnet_raw/Dataset219_PETCT/labelsTr/PETCT_96e7a3ab28_06142007.nii.gz,0.0,10.574867820739746,0.0,4,0
507,507,0.9136265812818224,5705,877,0.8409876066001498,45398607,34811,35688,40516,/well/papiez/users/hri611/python/nnUNet_results/Dataset219_PETCT/nnUNetTrainer_1500epochs_NoMirroring__nnUNetPlans__3d_fullres/crossval_results_folds_0_1_2_3_4/PETCT_97320b0b58_04172005.nii.gz,/well/papiez/users/hri611/python/nnUnet_raw/Dataset219_PETCT/labelsTr/PETCT_97320b0b58_04172005.nii.gz,0.9136265812818224,0.0373230628967285,0.870871467590332,21,18
508,508,0.0,0,1317,0.0,42878683,0,1317,0,/well/papiez/users/hri611/python/nnUNet_results/Dataset219_PETCT/nnUNetTrainer_1500epochs_NoMirroring__nnUNetPlans__3d_fullres/crossval_results_folds_0_1_2_3_4/PETCT_97320b0b58_07282005.nii.gz,/well/papiez/users/hri611/python/nnUnet_raw/Dataset219_PETCT/labelsTr/PETCT_97320b0b58_07282005.nii.gz,0.0,16.384824611663817,0.0,18,0
509,509,0.8986101211689237,3395,3433,0.8158873968613493,45402914,30258,33691,33653,/well/papiez/users/hri611/python/nnUNet_results/Dataset219_PETCT/nnUNetTrainer_1500epochs_NoMirroring__nnUNetPlans__3d_fullres/crossval_results_folds_0_1_2_3_4/PETCT_9775598501_05042001.nii.gz,/well/papiez/users/hri611/python/nnUnet_raw/Dataset219_PETCT/labelsTr/PETCT_9775598501_05042001.nii.gz,0.8986101211689237,1.6795378303527833,1.9159172286987305,15,8
510,510,0.8894117647058823,2,45,0.8008474576271186,45439764,189,234,191,/well/papiez/users/hri611/python/nnUNet_results/Dataset219_PETCT/nnUNetTrainer_1500epochs_NoMirroring__nnUNetPlans__3d_fullres/crossval_results_folds_0_1_2_3_4/PETCT_978c395243_01132005.nii.gz,/well/papiez/users/hri611/python/nnUnet_raw/Dataset219_PETCT/labelsTr/PETCT_978c395243_01132005.nii.gz,0.8894117647058823,0.2612614402770996,0.0,3,1
511,511,0.8910648714810282,227,40,0.8035320088300221,88158641,1092,1132,1319,/well/papiez/users/hri611/python/nnUNet_results/Dataset219_PETCT/nnUNetTrainer_1500epochs_NoMirroring__nnUNetPlans__3d_fullres/crossval_results_folds_0_1_2_3_4/PETCT_979f9c3dba_06222006.nii.gz,/well/papiez/users/hri611/python/nnUnet_raw/Dataset219_PETCT/labelsTr/PETCT_979f9c3dba_06222006.nii.gz,0.8910648714810282,0.0373230628967285,0.0,4,3
512,512,0.8893207416105717,9605,3779,0.8006998734271461,52092845,53771,57550,63376,/well/papiez/users/hri611/python/nnUNet_results/Dataset219_PETCT/nnUNetTrainer_1500epochs_NoMirroring__nnUNetPlans__3d_fullres/crossval_results_folds_0_1_2_3_4/PETCT_983a76fd43_11012001.nii.gz,/well/papiez/users/hri611/python/nnUnet_raw/Dataset219_PETCT/labelsTr/PETCT_983a76fd43_11012001.nii.gz,0.8893207416105717,2.537968276977539,6.344920692443847,91,103
513,513,0.0,0,170,0.0,52159830,0,170,0,/well/papiez/users/hri611/python/nnUNet_results/Dataset219_PETCT/nnUNetTrainer_1500epochs_NoMirroring__nnUNetPlans__3d_fullres/crossval_results_folds_0_1_2_3_4/PETCT_9860ffe82d_11192004.nii.gz,/well/papiez/users/hri611/python/nnUnet_raw/Dataset219_PETCT/labelsTr/PETCT_9860ffe82d_11192004.nii.gz,0.0,2.114973564147949,0.0,2,0
514,514,0.6788813886210222,14,319,0.5138686131386861,52159315,352,671,366,/well/papiez/users/hri611/python/nnUNet_results/Dataset219_PETCT/nnUNetTrainer_1500epochs_NoMirroring__nnUNetPlans__3d_fullres/crossval_results_folds_0_1_2_3_4/PETCT_987c8a1160_01222005.nii.gz,/well/papiez/users/hri611/python/nnUnet_raw/Dataset219_PETCT/labelsTr/PETCT_987c8a1160_01222005.nii.gz,0.6788813886210222,3.831834457397461,0.0,5,1
515,515,0.9376241241797876,5207,2645,0.8825728685300671,45373133,59015,61660,64222,/well/papiez/users/hri611/python/nnUNet_results/Dataset219_PETCT/nnUNetTrainer_1500epochs_NoMirroring__nnUNetPlans__3d_fullres/crossval_results_folds_0_1_2_3_4/PETCT_98c6af8b90_05262003.nii.gz,/well/papiez/users/hri611/python/nnUnet_raw/Dataset219_PETCT/labelsTr/PETCT_98c6af8b90_05262003.nii.gz,0.9376241241797876,2.824111759185791,0.0,15,2
516,516,0.0,0,709,0.0,52159291,0,709,0,/well/papiez/users/hri611/python/nnUNet_results/Dataset219_PETCT/nnUNetTrainer_1500epochs_NoMirroring__nnUNetPlans__3d_fullres/crossval_results_folds_0_1_2_3_4/PETCT_98cd91d44e_09062003.nii.gz,/well/papiez/users/hri611/python/nnUnet_raw/Dataset219_PETCT/labelsTr/PETCT_98cd91d44e_09062003.nii.gz,0.0,8.820683864593505,0.0,5,0
517,517,0.0,0,78,0.0,58879922,0,78,0,/well/papiez/users/hri611/python/nnUNet_results/Dataset219_PETCT/nnUNetTrainer_1500epochs_NoMirroring__nnUNetPlans__3d_fullres/crossval_results_folds_0_1_2_3_4/PETCT_9902caa7ec_08132006.nii.gz,/well/papiez/users/hri611/python/nnUnet_raw/Dataset219_PETCT/labelsTr/PETCT_9902caa7ec_08132006.nii.gz,0.0,0.9703996353149412,0.0,3,0
518,518,,0,0,,94240000,0,0,0,/well/papiez/users/hri611/python/nnUNet_results/Dataset219_PETCT/nnUNetTrainer_1500epochs_NoMirroring__nnUNetPlans__3d_fullres/crossval_results_folds_0_1_2_3_4/PETCT_993d40ea7e_12252005.nii.gz,/well/papiez/users/hri611/python/nnUnet_raw/Dataset219_PETCT/labelsTr/PETCT_993d40ea7e_12252005.nii.gz,,0.0,0.0,0,0
519,519,0.0,0,183,0.0,47359817,0,183,0,/well/papiez/users/hri611/python/nnUNet_results/Dataset219_PETCT/nnUNetTrainer_1500epochs_NoMirroring__nnUNetPlans__3d_fullres/crossval_results_folds_0_1_2_3_4/PETCT_997d4ef9a7_07222005.nii.gz,/well/papiez/users/hri611/python/nnUnet_raw/Dataset219_PETCT/labelsTr/PETCT_997d4ef9a7_07222005.nii.gz,0.0,2.2767068367004395,0.0,4,0
520,520,0.7024011523578169,12353,12026,0.5413083971476416,45386851,28770,40796,41123,/well/papiez/users/hri611/python/nnUNet_results/Dataset219_PETCT/nnUNetTrainer_1500epochs_NoMirroring__nnUNetPlans__3d_fullres/crossval_results_folds_0_1_2_3_4/PETCT_99a7bfad23_08262000.nii.gz,/well/papiez/users/hri611/python/nnUnet_raw/Dataset219_PETCT/labelsTr/PETCT_99a7bfad23_08262000.nii.gz,0.7024011523578169,2.2020607109069825,0.0,17,12
521,521,0.0,0,3,0.0,48159997,0,3,0,/well/papiez/users/hri611/python/nnUNet_results/Dataset219_PETCT/nnUNetTrainer_1500epochs_NoMirroring__nnUNetPlans__3d_fullres/crossval_results_folds_0_1_2_3_4/PETCT_9a2bfe901f_08062005.nii.gz,/well/papiez/users/hri611/python/nnUnet_raw/Dataset219_PETCT/labelsTr/PETCT_9a2bfe901f_08062005.nii.gz,0.0,0.0373230628967285,0.0,1,0
522,522,0.8619179551345071,505,2585,0.7573425475106016,45427266,9644,12229,10149,/well/papiez/users/hri611/python/nnUNet_results/Dataset219_PETCT/nnUNetTrainer_1500epochs_NoMirroring__nnUNetPlans__3d_fullres/crossval_results_folds_0_1_2_3_4/PETCT_9a2c6e618a_02142000.nii.gz,/well/papiez/users/hri611/python/nnUnet_raw/Dataset219_PETCT/labelsTr/PETCT_9a2c6e618a_02142000.nii.gz,0.8619179551345071,0.7837843208312988,0.2737024612426758,23,23
523,523,0.0,0,14,0.0,45439986,0,14,0,/well/papiez/users/hri611/python/nnUNet_results/Dataset219_PETCT/nnUNetTrainer_1500epochs_NoMirroring__nnUNetPlans__3d_fullres/crossval_results_folds_0_1_2_3_4/PETCT_9a418f3b3a_05112003.nii.gz,/well/papiez/users/hri611/python/nnUnet_raw/Dataset219_PETCT/labelsTr/PETCT_9a418f3b3a_05112003.nii.gz,0.0,0.1741742935180664,0.0,2,0
524,524,0.9386372329380908,357,766,0.8843698517298187,53590288,8589,9355,8946,/well/papiez/users/hri611/python/nnUNet_results/Dataset219_PETCT/nnUNetTrainer_1500epochs_NoMirroring__nnUNetPlans__3d_fullres/crossval_results_folds_0_1_2_3_4/PETCT_9a583160ea_06212007.nii.gz,/well/papiez/users/hri611/python/nnUnet_raw/Dataset219_PETCT/labelsTr/PETCT_9a583160ea_06212007.nii.gz,0.9386372329380908,3.5083679122924805,2.090091522216797,14,17
525,525,0.0,0,3002,0.0,52156998,0,3002,0,/well/papiez/users/hri611/python/nnUNet_results/Dataset219_PETCT/nnUNetTrainer_1500epochs_NoMirroring__nnUNetPlans__3d_fullres/crossval_results_folds_0_1_2_3_4/PETCT_9a66a81ad1_02262005.nii.gz,/well/papiez/users/hri611/python/nnUnet_raw/Dataset219_PETCT/labelsTr/PETCT_9a66a81ad1_02262005.nii.gz,0.0,37.34794493865967,0.0,4,0
526,526,0.0,0,418,0.0,51679582,0,418,0,/well/papiez/users/hri611/python/nnUNet_results/Dataset219_PETCT/nnUNetTrainer_1500epochs_NoMirroring__nnUNetPlans__3d_fullres/crossval_results_folds_0_1_2_3_4/PETCT_9a66a81ad1_05132006.nii.gz,/well/papiez/users/hri611/python/nnUnet_raw/Dataset219_PETCT/labelsTr/PETCT_9a66a81ad1_05132006.nii.gz,0.0,5.20034676361084,0.0,3,0
527,527,,0,0,,52960000,0,0,0,/well/papiez/users/hri611/python/nnUNet_results/Dataset219_PETCT/nnUNetTrainer_1500epochs_NoMirroring__nnUNetPlans__3d_fullres/crossval_results_folds_0_1_2_3_4/PETCT_9a66a81ad1_10212005.nii.gz,/well/papiez/users/hri611/python/nnUnet_raw/Dataset219_PETCT/labelsTr/PETCT_9a66a81ad1_10212005.nii.gz,,0.0,0.0,0,0
528,528,0.0,0,2852,0.0,105757148,0,2852,0,/well/papiez/users/hri611/python/nnUNet_results/Dataset219_PETCT/nnUNetTrainer_1500epochs_NoMirroring__nnUNetPlans__3d_fullres/crossval_results_folds_0_1_2_3_4/PETCT_9a66a81ad1_10312004.nii.gz,/well/papiez/users/hri611/python/nnUnet_raw/Dataset219_PETCT/labelsTr/PETCT_9a66a81ad1_10312004.nii.gz,0.0,35.48179179382324,0.0,5,0
529,529,0.0,0,320,0.0,52159680,0,320,0,/well/papiez/users/hri611/python/nnUNet_results/Dataset219_PETCT/nnUNetTrainer_1500epochs_NoMirroring__nnUNetPlans__3d_fullres/crossval_results_folds_0_1_2_3_4/PETCT_9a83943958_08032003.nii.gz,/well/papiez/users/hri611/python/nnUnet_raw/Dataset219_PETCT/labelsTr/PETCT_9a83943958_08032003.nii.gz,0.0,3.981126708984375,0.0,5,0
530,530,0.7709212295423988,7482,2400,0.6272350056582422,52133490,16628,19028,24110,/well/papiez/users/hri611/python/nnUNet_results/Dataset219_PETCT/nnUNetTrainer_1500epochs_NoMirroring__nnUNetPlans__3d_fullres/crossval_results_folds_0_1_2_3_4/PETCT_9aa97cf103_07182004.nii.gz,/well/papiez/users/hri611/python/nnUnet_raw/Dataset219_PETCT/labelsTr/PETCT_9aa97cf103_07182004.nii.gz,0.7709212295423988,5.411844120025635,9.77864247894287,34,22
531,531,0.761699064074874,88,243,0.6151162790697674,52159140,529,772,617,/well/papiez/users/hri611/python/nnUNet_results/Dataset219_PETCT/nnUNetTrainer_1500epochs_NoMirroring__nnUNetPlans__3d_fullres/crossval_results_folds_0_1_2_3_4/PETCT_9abb9583ec_05302002.nii.gz,/well/papiez/users/hri611/python/nnUnet_raw/Dataset219_PETCT/labelsTr/PETCT_9abb9583ec_05302002.nii.gz,0.761699064074874,0.1244102096557617,0.3483485870361328,14,10
532,532,0.0,0,137,0.0,52159863,0,137,0,/well/papiez/users/hri611/python/nnUNet_results/Dataset219_PETCT/nnUNetTrainer_1500epochs_NoMirroring__nnUNetPlans__3d_fullres/crossval_results_folds_0_1_2_3_4/PETCT_9ad7dffae6_05222003.nii.gz,/well/papiez/users/hri611/python/nnUnet_raw/Dataset219_PETCT/labelsTr/PETCT_9ad7dffae6_05222003.nii.gz,0.0,1.7044198722839354,0.0,3,0
533,533,0.8040518299069336,10871,2225,0.6723132741148505,52120035,26869,29094,37740,/well/papiez/users/hri611/python/nnUNet_results/Dataset219_PETCT/nnUNetTrainer_1500epochs_NoMirroring__nnUNetPlans__3d_fullres/crossval_results_folds_0_1_2_3_4/PETCT_9afd440677_03172003.nii.gz,/well/papiez/users/hri611/python/nnUnet_raw/Dataset219_PETCT/labelsTr/PETCT_9afd440677_03172003.nii.gz,0.8040518299069336,0.0,41.08025122833252,10,12
534,534,0.0,0,455,0.0,52159545,0,455,0,/well/papiez/users/hri611/python/nnUNet_results/Dataset219_PETCT/nnUNetTrainer_1500epochs_NoMirroring__nnUNetPlans__3d_fullres/crossval_results_folds_0_1_2_3_4/PETCT_9b1bb2165a_10132002.nii.gz,/well/papiez/users/hri611/python/nnUnet_raw/Dataset219_PETCT/labelsTr/PETCT_9b1bb2165a_10132002.nii.gz,0.0,5.660664539337158,0.0,3,0
535,535,0.833219483391416,13724,681,0.7141184408986266,45389612,35983,36664,49707,/well/papiez/users/hri611/python/nnUNet_results/Dataset219_PETCT/nnUNetTrainer_1500epochs_NoMirroring__nnUNetPlans__3d_fullres/crossval_results_folds_0_1_2_3_4/PETCT_9b982e72cb_09152001.nii.gz,/well/papiez/users/hri611/python/nnUnet_raw/Dataset219_PETCT/labelsTr/PETCT_9b982e72cb_09152001.nii.gz,0.833219483391416,1.8661531448364257,6.892325614929199,18,18
536,536,0.0,0,496,0.0,45439504,0,496,0,/well/papiez/users/hri611/python/nnUNet_results/Dataset219_PETCT/nnUNetTrainer_1500epochs_NoMirroring__nnUNetPlans__3d_fullres/crossval_results_folds_0_1_2_3_4/PETCT_9b9d67b3ff_07122003.nii.gz,/well/papiez/users/hri611/python/nnUnet_raw/Dataset219_PETCT/labelsTr/PETCT_9b9d67b3ff_07122003.nii.gz,0.0,6.170746398925781,0.0,5,0
537,537,,0,0,,54720000,0,0,0,/well/papiez/users/hri611/python/nnUNet_results/Dataset219_PETCT/nnUNetTrainer_1500epochs_NoMirroring__nnUNetPlans__3d_fullres/crossval_results_folds_0_1_2_3_4/PETCT_9c36b318e8_11042006.nii.gz,/well/papiez/users/hri611/python/nnUnet_raw/Dataset219_PETCT/labelsTr/PETCT_9c36b318e8_11042006.nii.gz,,0.0,0.0,0,0
538,538,0.0,0,6,0.0,99039994,0,6,0,/well/papiez/users/hri611/python/nnUNet_results/Dataset219_PETCT/nnUNetTrainer_1500epochs_NoMirroring__nnUNetPlans__3d_fullres/crossval_results_folds_0_1_2_3_4/PETCT_9c68e484a7_08142003.nii.gz,/well/papiez/users/hri611/python/nnUnet_raw/Dataset219_PETCT/labelsTr/PETCT_9c68e484a7_08142003.nii.gz,0.0,0.074646125793457,0.0,2,0
539,539,0.9090686274509804,141,2085,0.8332958885643675,45426647,11127,13212,11268,/well/papiez/users/hri611/python/nnUNet_results/Dataset219_PETCT/nnUNetTrainer_1500epochs_NoMirroring__nnUNetPlans__3d_fullres/crossval_results_folds_0_1_2_3_4/PETCT_9c8842d12e_01252004.nii.gz,/well/papiez/users/hri611/python/nnUnet_raw/Dataset219_PETCT/labelsTr/PETCT_9c8842d12e_01252004.nii.gz,0.9090686274509804,2.6499374656677244,0.0497640838623046,13,10
540,540,0.7297612732095491,3318,1776,0.5745071834279987,52148028,6878,8654,10196,/well/papiez/users/hri611/python/nnUNet_results/Dataset219_PETCT/nnUNetTrainer_1500epochs_NoMirroring__nnUNetPlans__3d_fullres/crossval_results_folds_0_1_2_3_4/PETCT_9c9a347388_09092000.nii.gz,/well/papiez/users/hri611/python/nnUnet_raw/Dataset219_PETCT/labelsTr/PETCT_9c9a347388_09092000.nii.gz,0.7297612732095491,11.08494968032837,5.187905742645263,7,6
541,541,0.0,0,8,0.0,52159992,0,8,0,/well/papiez/users/hri611/python/nnUNet_results/Dataset219_PETCT/nnUNetTrainer_1500epochs_NoMirroring__nnUNetPlans__3d_fullres/crossval_results_folds_0_1_2_3_4/PETCT_9d6e9223cc_11162002.nii.gz,/well/papiez/users/hri611/python/nnUnet_raw/Dataset219_PETCT/labelsTr/PETCT_9d6e9223cc_11162002.nii.gz,0.0,0.0995281677246093,0.0,3,0
542,542,0.0,0,1190,0.0,52158810,0,1190,0,/well/papiez/users/hri611/python/nnUNet_results/Dataset219_PETCT/nnUNetTrainer_1500epochs_NoMirroring__nnUNetPlans__3d_fullres/crossval_results_folds_0_1_2_3_4/PETCT_9d97ac5d4d_12122004.nii.gz,/well/papiez/users/hri611/python/nnUnet_raw/Dataset219_PETCT/labelsTr/PETCT_9d97ac5d4d_12122004.nii.gz,0.0,14.804814949035643,0.0,5,0
543,543,0.4742906148625974,13863,236,0.3108656337064372,52139541,6360,6596,20223,/well/papiez/users/hri611/python/nnUNet_results/Dataset219_PETCT/nnUNetTrainer_1500epochs_NoMirroring__nnUNetPlans__3d_fullres/crossval_results_folds_0_1_2_3_4/PETCT_9da159b835_03232002.nii.gz,/well/papiez/users/hri611/python/nnUnet_raw/Dataset219_PETCT/labelsTr/PETCT_9da159b835_03232002.nii.gz,0.4742906148625974,0.0870871467590332,79.39859580230713,12,21
544,544,0.0,0,3975,0.0,52156025,0,3975,0,/well/papiez/users/hri611/python/nnUNet_results/Dataset219_PETCT/nnUNetTrainer_1500epochs_NoMirroring__nnUNetPlans__3d_fullres/crossval_results_folds_0_1_2_3_4/PETCT_9e864bb710_09142003.nii.gz,/well/papiez/users/hri611/python/nnUnet_raw/Dataset219_PETCT/labelsTr/PETCT_9e864bb710_09142003.nii.gz,0.0,49.453058338165285,0.0,13,0
545,545,0.9522539232644897,1483,3099,0.9088594502128337,52109726,45692,48791,47175,/well/papiez/users/hri611/python/nnUNet_results/Dataset219_PETCT/nnUNetTrainer_1500epochs_NoMirroring__nnUNetPlans__3d_fullres/crossval_results_folds_0_1_2_3_4/PETCT_9f206193d3_04072003.nii.gz,/well/papiez/users/hri611/python/nnUnet_raw/Dataset219_PETCT/labelsTr/PETCT_9f206193d3_04072003.nii.gz,0.9522539232644897,0.4851998176574706,0.4229947128295898,25,26
546,546,0.0,0,1,0.0,52159999,0,1,0,/well/papiez/users/hri611/python/nnUNet_results/Dataset219_PETCT/nnUNetTrainer_1500epochs_NoMirroring__nnUNetPlans__3d_fullres/crossval_results_folds_0_1_2_3_4/PETCT_9f206193d3_08042003.nii.gz,/well/papiez/users/hri611/python/nnUnet_raw/Dataset219_PETCT/labelsTr/PETCT_9f206193d3_08042003.nii.gz,0.0,0.0124410209655761,0.0,1,0
547,547,,0,0,,48160000,0,0,0,/well/papiez/users/hri611/python/nnUNet_results/Dataset219_PETCT/nnUNetTrainer_1500epochs_NoMirroring__nnUNetPlans__3d_fullres/crossval_results_folds_0_1_2_3_4/PETCT_9f491f1481_02122006.nii.gz,/well/papiez/users/hri611/python/nnUnet_raw/Dataset219_PETCT/labelsTr/PETCT_9f491f1481_02122006.nii.gz,,0.0,0.0,0,0
548,548,0.0,0,5,0.0,52159995,0,5,0,/well/papiez/users/hri611/python/nnUNet_results/Dataset219_PETCT/nnUNetTrainer_1500epochs_NoMirroring__nnUNetPlans__3d_fullres/crossval_results_folds_0_1_2_3_4/PETCT_9f6e8b1b43_11162002.nii.gz,/well/papiez/users/hri611/python/nnUnet_raw/Dataset219_PETCT/labelsTr/PETCT_9f6e8b1b43_11162002.nii.gz,0.0,0.0622051048278808,0.0,2,0
549,549,0.670846394984326,103,2,0.5047169811320755,52159788,107,109,210,/well/papiez/users/hri611/python/nnUNet_results/Dataset219_PETCT/nnUNetTrainer_1500epochs_NoMirroring__nnUNetPlans__3d_fullres/crossval_results_folds_0_1_2_3_4/PETCT_9f7c68f5ca_12212001.nii.gz,/well/papiez/users/hri611/python/nnUnet_raw/Dataset219_PETCT/labelsTr/PETCT_9f7c68f5ca_12212001.nii.gz,0.670846394984326,0.0,0.0,1,1
550,550,0.7937864077669903,347,184,0.6580811332904056,49758447,1022,1206,1369,/well/papiez/users/hri611/python/nnUNet_results/Dataset219_PETCT/nnUNetTrainer_1500epochs_NoMirroring__nnUNetPlans__3d_fullres/crossval_results_folds_0_1_2_3_4/PETCT_9ffd8409b3_07152005.nii.gz,/well/papiez/users/hri611/python/nnUnet_raw/Dataset219_PETCT/labelsTr/PETCT_9ffd8409b3_07152005.nii.gz,0.7937864077669903,2.251824794769287,1.3933943481445312,11,13
551,551,,0,0,,51040000,0,0,0,/well/papiez/users/hri611/python/nnUNet_results/Dataset219_PETCT/nnUNetTrainer_1500epochs_NoMirroring__nnUNetPlans__3d_fullres/crossval_results_folds_0_1_2_3_4/PETCT_a09210d96b_12112005.nii.gz,/well/papiez/users/hri611/python/nnUnet_raw/Dataset219_PETCT/labelsTr/PETCT_a09210d96b_12112005.nii.gz,,0.0,0.0,0,0
552,552,0.7817268048993349,4980,2273,0.6416679017835087,52139759,12988,15261,17968,/well/papiez/users/hri611/python/nnUNet_results/Dataset219_PETCT/nnUNetTrainer_1500epochs_NoMirroring__nnUNetPlans__3d_fullres/crossval_results_folds_0_1_2_3_4/PETCT_a0c4dc1ef1_01192003.nii.gz,/well/papiez/users/hri611/python/nnUnet_raw/Dataset219_PETCT/labelsTr/PETCT_a0c4dc1ef1_01192003.nii.gz,0.7817268048993349,27.407569187164302,9.218796535491943,14,12
553,553,,0,0,,47200000,0,0,0,/well/papiez/users/hri611/python/nnUNet_results/Dataset219_PETCT/nnUNetTrainer_1500epochs_NoMirroring__nnUNetPlans__3d_fullres/crossval_results_folds_0_1_2_3_4/PETCT_a19c2a0c65_03052006.nii.gz,/well/papiez/users/hri611/python/nnUnet_raw/Dataset219_PETCT/labelsTr/PETCT_a19c2a0c65_03052006.nii.gz,,0.0,0.0,0,0
554,554,0.5506172011270629,77589,2793,0.3798977064963317,52030373,49245,52038,126834,/well/papiez/users/hri611/python/nnUNet_results/Dataset219_PETCT/nnUNetTrainer_1500epochs_NoMirroring__nnUNetPlans__3d_fullres/crossval_results_folds_0_1_2_3_4/PETCT_a19ef8e0d2_12261999.nii.gz,/well/papiez/users/hri611/python/nnUnet_raw/Dataset219_PETCT/labelsTr/PETCT_a19ef8e0d2_12261999.nii.gz,0.5506172011270629,1.5675686416625976,2.251824794769287,10,9
555,555,0.918032786885246,5,60,0.8484848484848485,105759571,364,424,369,/well/papiez/users/hri611/python/nnUNet_results/Dataset219_PETCT/nnUNetTrainer_1500epochs_NoMirroring__nnUNetPlans__3d_fullres/crossval_results_folds_0_1_2_3_4/PETCT_a1bc00ad60_03062003.nii.gz,/well/papiez/users/hri611/python/nnUnet_raw/Dataset219_PETCT/labelsTr/PETCT_a1bc00ad60_03062003.nii.gz,0.918032786885246,0.1244102096557617,0.0248820419311523,4,5
556,556,0.0,0,282,0.0,104479718,0,282,0,/well/papiez/users/hri611/python/nnUNet_results/Dataset219_PETCT/nnUNetTrainer_1500epochs_NoMirroring__nnUNetPlans__3d_fullres/crossval_results_folds_0_1_2_3_4/PETCT_a1bc00ad60_08102006.nii.gz,/well/papiez/users/hri611/python/nnUnet_raw/Dataset219_PETCT/labelsTr/PETCT_a1bc00ad60_08102006.nii.gz,0.0,3.5083679122924805,0.0,4,0
557,557,0.0,0,1833,0.0,85598167,0,1833,0,/well/papiez/users/hri611/python/nnUNet_results/Dataset219_PETCT/nnUNetTrainer_1500epochs_NoMirroring__nnUNetPlans__3d_fullres/crossval_results_folds_0_1_2_3_4/PETCT_a1d93ebc74_09012003.nii.gz,/well/papiez/users/hri611/python/nnUnet_raw/Dataset219_PETCT/labelsTr/PETCT_a1d93ebc74_09012003.nii.gz,0.0,22.804391429901123,0.0,7,0
558,558,0.9298043728423476,61,61,0.8688172043010752,52159070,808,869,869,/well/papiez/users/hri611/python/nnUNet_results/Dataset219_PETCT/nnUNetTrainer_1500epochs_NoMirroring__nnUNetPlans__3d_fullres/crossval_results_folds_0_1_2_3_4/PETCT_a1db71e797_03252005.nii.gz,/well/papiez/users/hri611/python/nnUnet_raw/Dataset219_PETCT/labelsTr/PETCT_a1db71e797_03252005.nii.gz,0.9298043728423476,0.0870871467590332,0.0,4,2
559,559,0.0,0,10,0.0,72159990,0,10,0,/well/papiez/users/hri611/python/nnUNet_results/Dataset219_PETCT/nnUNetTrainer_1500epochs_NoMirroring__nnUNetPlans__3d_fullres/crossval_results_folds_0_1_2_3_4/PETCT_a21200dcba_03102005.nii.gz,/well/papiez/users/hri611/python/nnUnet_raw/Dataset219_PETCT/labelsTr/PETCT_a21200dcba_03102005.nii.gz,0.0,0.1244102096557617,0.0,1,0
560,560,,0,0,,91680000,0,0,0,/well/papiez/users/hri611/python/nnUNet_results/Dataset219_PETCT/nnUNetTrainer_1500epochs_NoMirroring__nnUNetPlans__3d_fullres/crossval_results_folds_0_1_2_3_4/PETCT_a22ec7f62b_06302007.nii.gz,/well/papiez/users/hri611/python/nnUnet_raw/Dataset219_PETCT/labelsTr/PETCT_a22ec7f62b_06302007.nii.gz,,0.0,0.0,0,0
561,561,0.0,0,2685,0.0,52157315,0,2685,0,/well/papiez/users/hri611/python/nnUNet_results/Dataset219_PETCT/nnUNetTrainer_1500epochs_NoMirroring__nnUNetPlans__3d_fullres/crossval_results_folds_0_1_2_3_4/PETCT_a25083ff81_08282003.nii.gz,/well/papiez/users/hri611/python/nnUnet_raw/Dataset219_PETCT/labelsTr/PETCT_a25083ff81_08282003.nii.gz,0.0,33.40414129257202,0.0,9,0
562,562,,0,0,,72160000,0,0,0,/well/papiez/users/hri611/python/nnUNet_results/Dataset219_PETCT/nnUNetTrainer_1500epochs_NoMirroring__nnUNetPlans__3d_fullres/crossval_results_folds_0_1_2_3_4/PETCT_a2676f03c0_05092003.nii.gz,/well/papiez/users/hri611/python/nnUnet_raw/Dataset219_PETCT/labelsTr/PETCT_a2676f03c0_05092003.nii.gz,,0.0,0.0,0,0
563,563,,0,0,,48480000,0,0,0,/well/papiez/users/hri611/python/nnUNet_results/Dataset219_PETCT/nnUNetTrainer_1500epochs_NoMirroring__nnUNetPlans__3d_fullres/crossval_results_folds_0_1_2_3_4/PETCT_a29cae0316_06292006.nii.gz,/well/papiez/users/hri611/python/nnUnet_raw/Dataset219_PETCT/labelsTr/PETCT_a29cae0316_06292006.nii.gz,,0.0,0.0,0,0
564,564,0.945693911135491,52,47,0.8969823100936525,52159039,862,909,914,/well/papiez/users/hri611/python/nnUNet_results/Dataset219_PETCT/nnUNetTrainer_1500epochs_NoMirroring__nnUNetPlans__3d_fullres/crossval_results_folds_0_1_2_3_4/PETCT_a2a68bbe97_08212003.nii.gz,/well/papiez/users/hri611/python/nnUnet_raw/Dataset219_PETCT/labelsTr/PETCT_a2a68bbe97_08212003.nii.gz,0.945693911135491,0.0995281677246093,0.0,5,4
565,565,0.0,0,6,0.0,52159994,0,6,0,/well/papiez/users/hri611/python/nnUNet_results/Dataset219_PETCT/nnUNetTrainer_1500epochs_NoMirroring__nnUNetPlans__3d_fullres/crossval_results_folds_0_1_2_3_4/PETCT_a37b4bca43_06232002.nii.gz,/well/papiez/users/hri611/python/nnUnet_raw/Dataset219_PETCT/labelsTr/PETCT_a37b4bca43_06232002.nii.gz,0.0,0.074646125793457,0.0,3,0
566,566,0.0,0,3780,0.0,45436220,0,3780,0,/well/papiez/users/hri611/python/nnUNet_results/Dataset219_PETCT/nnUNetTrainer_1500epochs_NoMirroring__nnUNetPlans__3d_fullres/crossval_results_folds_0_1_2_3_4/PETCT_a37c4e231f_12132002.nii.gz,/well/papiez/users/hri611/python/nnUnet_raw/Dataset219_PETCT/labelsTr/PETCT_a37c4e231f_12132002.nii.gz,0.0,47.02705924987793,0.0,4,0
567,567,0.9153685833724866,5687,1338,0.8439443753332149,45394984,37991,39329,43678,/well/papiez/users/hri611/python/nnUNet_results/Dataset219_PETCT/nnUNetTrainer_1500epochs_NoMirroring__nnUNetPlans__3d_fullres/crossval_results_folds_0_1_2_3_4/PETCT_a37da9e85d_03022002.nii.gz,/well/papiez/users/hri611/python/nnUnet_raw/Dataset219_PETCT/labelsTr/PETCT_a37da9e85d_03022002.nii.gz,0.9153685833724866,0.3110255241394043,6.95453071975708,5,3
568,568,0.8441904434513579,7025,227,0.7303888764963938,52133102,19646,19873,26671,/well/papiez/users/hri611/python/nnUNet_results/Dataset219_PETCT/nnUNetTrainer_1500epochs_NoMirroring__nnUNetPlans__3d_fullres/crossval_results_folds_0_1_2_3_4/PETCT_a3df01d3a3_10052002.nii.gz,/well/papiez/users/hri611/python/nnUnet_raw/Dataset219_PETCT/labelsTr/PETCT_a3df01d3a3_10052002.nii.gz,0.8441904434513579,0.58472798538208,6.170746398925781,12,6
569,569,0.5657698056801196,652,1672,0.3944762897342366,52156162,1514,3186,2166,/well/papiez/users/hri611/python/nnUNet_results/Dataset219_PETCT/nnUNetTrainer_1500epochs_NoMirroring__nnUNetPlans__3d_fullres/crossval_results_folds_0_1_2_3_4/PETCT_a471649d35_05062002.nii.gz,/well/papiez/users/hri611/python/nnUnet_raw/Dataset219_PETCT/labelsTr/PETCT_a471649d35_05062002.nii.gz,0.5657698056801196,19.806105377197262,0.9081945304870606,19,14
570,570,0.0,0,4,0.0,49119996,0,4,0,/well/papiez/users/hri611/python/nnUNet_results/Dataset219_PETCT/nnUNetTrainer_1500epochs_NoMirroring__nnUNetPlans__3d_fullres/crossval_results_folds_0_1_2_3_4/PETCT_a4a66c4fa7_07072006.nii.gz,/well/papiez/users/hri611/python/nnUnet_raw/Dataset219_PETCT/labelsTr/PETCT_a4a66c4fa7_07072006.nii.gz,0.0,0.0497640838623046,0.0,1,0
571,571,0.0,0,315,0.0,49119685,0,315,0,/well/papiez/users/hri611/python/nnUNet_results/Dataset219_PETCT/nnUNetTrainer_1500epochs_NoMirroring__nnUNetPlans__3d_fullres/crossval_results_folds_0_1_2_3_4/PETCT_a4cb97ffc7_07112005.nii.gz,/well/papiez/users/hri611/python/nnUnet_raw/Dataset219_PETCT/labelsTr/PETCT_a4cb97ffc7_07112005.nii.gz,0.0,3.9189216041564943,0.0,2,0
572,572,0.0,0,23099,0.0,45416901,0,23099,0,/well/papiez/users/hri611/python/nnUNet_results/Dataset219_PETCT/nnUNetTrainer_1500epochs_NoMirroring__nnUNetPlans__3d_fullres/crossval_results_folds_0_1_2_3_4/PETCT_a4ccc397a9_11302002.nii.gz,/well/papiez/users/hri611/python/nnUnet_raw/Dataset219_PETCT/labelsTr/PETCT_a4ccc397a9_11302002.nii.gz,0.0,287.375143283844,0.0,14,0
573,573,0.0,0,1,0.0,50879999,0,1,0,/well/papiez/users/hri611/python/nnUNet_results/Dataset219_PETCT/nnUNetTrainer_1500epochs_NoMirroring__nnUNetPlans__3d_fullres/crossval_results_folds_0_1_2_3_4/PETCT_a4cd2b10de_10152005.nii.gz,/well/papiez/users/hri611/python/nnUnet_raw/Dataset219_PETCT/labelsTr/PETCT_a4cd2b10de_10152005.nii.gz,0.0,0.0124410209655761,0.0,1,0
574,574,,0,0,,53120000,0,0,0,/well/papiez/users/hri611/python/nnUNet_results/Dataset219_PETCT/nnUNetTrainer_1500epochs_NoMirroring__nnUNetPlans__3d_fullres/crossval_results_folds_0_1_2_3_4/PETCT_a4cd2b10de_10152006.nii.gz,/well/papiez/users/hri611/python/nnUnet_raw/Dataset219_PETCT/labelsTr/PETCT_a4cd2b10de_10152006.nii.gz,,0.0,0.0,0,0
575,575,0.6481481481481481,279,139,0.4794520547945205,58879197,385,524,664,/well/papiez/users/hri611/python/nnUNet_results/Dataset219_PETCT/nnUNetTrainer_1500epochs_NoMirroring__nnUNetPlans__3d_fullres/crossval_results_folds_0_1_2_3_4/PETCT_a4cd2b10de_12292001.nii.gz,/well/papiez/users/hri611/python/nnUnet_raw/Dataset219_PETCT/labelsTr/PETCT_a4cd2b10de_12292001.nii.gz,0.6481481481481481,1.3187482223510745,0.9081945304870606,6,4
576,576,0.5723432004110185,6505,15137,0.400896910641125,85723876,14482,29619,20987,/well/papiez/users/hri611/python/nnUNet_results/Dataset219_PETCT/nnUNetTrainer_1500epochs_NoMirroring__nnUNetPlans__3d_fullres/crossval_results_folds_0_1_2_3_4/PETCT_a4ff5d0d9d_05302005.nii.gz,/well/papiez/users/hri611/python/nnUnet_raw/Dataset219_PETCT/labelsTr/PETCT_a4ff5d0d9d_05302005.nii.gz,0.5723432004110185,113.38746508026122,51.82929334259033,83,69
577,577,0.0,0,43,0.0,52159957,0,43,0,/well/papiez/users/hri611/python/nnUNet_results/Dataset219_PETCT/nnUNetTrainer_1500epochs_NoMirroring__nnUNetPlans__3d_fullres/crossval_results_folds_0_1_2_3_4/PETCT_a57bd6b006_11092002.nii.gz,/well/papiez/users/hri611/python/nnUnet_raw/Dataset219_PETCT/labelsTr/PETCT_a57bd6b006_11092002.nii.gz,0.0,0.5349639015197754,0.0,1,0
578,578,0.934127659574468,406,1142,0.8763973171510699,92307476,10976,12118,11382,/well/papiez/users/hri611/python/nnUNet_results/Dataset219_PETCT/nnUNetTrainer_1500epochs_NoMirroring__nnUNetPlans__3d_fullres/crossval_results_folds_0_1_2_3_4/PETCT_a61d8768d0_03262004.nii.gz,/well/papiez/users/hri611/python/nnUnet_raw/Dataset219_PETCT/labelsTr/PETCT_a61d8768d0_03262004.nii.gz,0.934127659574468,3.2968705558776854,0.3981126708984375,20,13
579,579,0.0,0,4209,0.0,52155791,0,4209,0,/well/papiez/users/hri611/python/nnUNet_results/Dataset219_PETCT/nnUNetTrainer_1500epochs_NoMirroring__nnUNetPlans__3d_fullres/crossval_results_folds_0_1_2_3_4/PETCT_a627fc68a1_02142003.nii.gz,/well/papiez/users/hri611/python/nnUnet_raw/Dataset219_PETCT/labelsTr/PETCT_a627fc68a1_02142003.nii.gz,0.0,52.36425724411011,0.0,7,0
580,580,0.3443708609271523,0,693,0.208,99039125,182,875,182,/well/papiez/users/hri611/python/nnUNet_results/Dataset219_PETCT/nnUNetTrainer_1500epochs_NoMirroring__nnUNetPlans__3d_fullres/crossval_results_folds_0_1_2_3_4/PETCT_a86b2dc6ce_10142002.nii.gz,/well/papiez/users/hri611/python/nnUnet_raw/Dataset219_PETCT/labelsTr/PETCT_a86b2dc6ce_10142002.nii.gz,0.3443708609271523,6.195628440856933,0.0,5,2
581,581,0.8774736842105263,29,1135,0.781695423855964,99034668,4168,5303,4197,/well/papiez/users/hri611/python/nnUNet_results/Dataset219_PETCT/nnUNetTrainer_1500epochs_NoMirroring__nnUNetPlans__3d_fullres/crossval_results_folds_0_1_2_3_4/PETCT_a86b3fad40_07182003.nii.gz,/well/papiez/users/hri611/python/nnUnet_raw/Dataset219_PETCT/labelsTr/PETCT_a86b3fad40_07182003.nii.gz,0.8774736842105263,0.5474049224853516,0.0,3,1
582,582,,0,0,,45440000,0,0,0,/well/papiez/users/hri611/python/nnUNet_results/Dataset219_PETCT/nnUNetTrainer_1500epochs_NoMirroring__nnUNetPlans__3d_fullres/crossval_results_folds_0_1_2_3_4/PETCT_a87dda9193_01262003.nii.gz,/well/papiez/users/hri611/python/nnUnet_raw/Dataset219_PETCT/labelsTr/PETCT_a87dda9193_01262003.nii.gz,,0.0,0.0,0,0
583,583,0.0,0,5,0.0,52159995,0,5,0,/well/papiez/users/hri611/python/nnUNet_results/Dataset219_PETCT/nnUNetTrainer_1500epochs_NoMirroring__nnUNetPlans__3d_fullres/crossval_results_folds_0_1_2_3_4/PETCT_a8a5e96821_03112005.nii.gz,/well/papiez/users/hri611/python/nnUnet_raw/Dataset219_PETCT/labelsTr/PETCT_a8a5e96821_03112005.nii.gz,0.0,0.0622051048278808,0.0,2,0
584,584,0.0,0,2502,0.0,46717498,0,2502,0,/well/papiez/users/hri611/python/nnUNet_results/Dataset219_PETCT/nnUNetTrainer_1500epochs_NoMirroring__nnUNetPlans__3d_fullres/crossval_results_folds_0_1_2_3_4/PETCT_a8a5e96821_09302005.nii.gz,/well/papiez/users/hri611/python/nnUnet_raw/Dataset219_PETCT/labelsTr/PETCT_a8a5e96821_09302005.nii.gz,0.0,31.127434455871583,0.0,2,0
585,585,0.0,0,368,0.0,52159632,0,368,0,/well/papiez/users/hri611/python/nnUNet_results/Dataset219_PETCT/nnUNetTrainer_1500epochs_NoMirroring__nnUNetPlans__3d_fullres/crossval_results_folds_0_1_2_3_4/PETCT_a90955352e_05162003.nii.gz,/well/papiez/users/hri611/python/nnUnet_raw/Dataset219_PETCT/labelsTr/PETCT_a90955352e_05162003.nii.gz,0.0,4.578295715332031,0.0,6,0
586,586,0.0,0,239,0.0,92319761,0,239,0,/well/papiez/users/hri611/python/nnUNet_results/Dataset219_PETCT/nnUNetTrainer_1500epochs_NoMirroring__nnUNetPlans__3d_fullres/crossval_results_folds_0_1_2_3_4/PETCT_a933c9af60_09192002.nii.gz,/well/papiez/users/hri611/python/nnUnet_raw/Dataset219_PETCT/labelsTr/PETCT_a933c9af60_09192002.nii.gz,0.0,2.973404010772705,0.0,2,0
587,587,0.832826191999791,246,12555,0.7135408508067224,45395313,31886,44441,32132,/well/papiez/users/hri611/python/nnUNet_results/Dataset219_PETCT/nnUNetTrainer_1500epochs_NoMirroring__nnUNetPlans__3d_fullres/crossval_results_folds_0_1_2_3_4/PETCT_aa27cb9156_12142003.nii.gz,/well/papiez/users/hri611/python/nnUnet_raw/Dataset219_PETCT/labelsTr/PETCT_aa27cb9156_12142003.nii.gz,0.832826191999791,29.423014583587644,0.0,27,10
588,588,0.6533586818757922,3790,586,0.4851764705882353,45431500,4124,4710,7914,/well/papiez/users/hri611/python/nnUNet_results/Dataset219_PETCT/nnUNetTrainer_1500epochs_NoMirroring__nnUNetPlans__3d_fullres/crossval_results_folds_0_1_2_3_4/PETCT_ab1fa26e5e_06232001.nii.gz,/well/papiez/users/hri611/python/nnUnet_raw/Dataset219_PETCT/labelsTr/PETCT_ab1fa26e5e_06232001.nii.gz,0.6533586818757922,1.0574867820739746,2.052768459320068,9,8
589,589,0.8537968524546156,1054,3303,0.7448913870835528,105742921,12722,16025,13776,/well/papiez/users/hri611/python/nnUNet_results/Dataset219_PETCT/nnUNetTrainer_1500epochs_NoMirroring__nnUNetPlans__3d_fullres/crossval_results_folds_0_1_2_3_4/PETCT_ab953a5230_11032003.nii.gz,/well/papiez/users/hri611/python/nnUnet_raw/Dataset219_PETCT/labelsTr/PETCT_ab953a5230_11032003.nii.gz,0.8537968524546156,15.1407225151062,2.6374964447021485,42,36
590,590,0.8598325736586528,2572,2133,0.7541283444816054,45420864,14431,16564,17003,/well/papiez/users/hri611/python/nnUNet_results/Dataset219_PETCT/nnUNetTrainer_1500epochs_NoMirroring__nnUNetPlans__3d_fullres/crossval_results_folds_0_1_2_3_4/PETCT_ac11b344b6_11032002.nii.gz,/well/papiez/users/hri611/python/nnUnet_raw/Dataset219_PETCT/labelsTr/PETCT_ac11b344b6_11032002.nii.gz,0.8598325736586528,0.0,0.0,1,2
591,591,0.0,0,1343,0.0,45438657,0,1343,0,/well/papiez/users/hri611/python/nnUNet_results/Dataset219_PETCT/nnUNetTrainer_1500epochs_NoMirroring__nnUNetPlans__3d_fullres/crossval_results_folds_0_1_2_3_4/PETCT_ac700ab4db_12042004.nii.gz,/well/papiez/users/hri611/python/nnUnet_raw/Dataset219_PETCT/labelsTr/PETCT_ac700ab4db_12042004.nii.gz,0.0,16.708291156768798,0.0,1,0
592,592,0.1700832799487508,1883,3299,0.0929459128303868,45434287,531,3830,2414,/well/papiez/users/hri611/python/nnUNet_results/Dataset219_PETCT/nnUNetTrainer_1500epochs_NoMirroring__nnUNetPlans__3d_fullres/crossval_results_folds_0_1_2_3_4/PETCT_ac75e49284_11132004.nii.gz,/well/papiez/users/hri611/python/nnUnet_raw/Dataset219_PETCT/labelsTr/PETCT_ac75e49284_11132004.nii.gz,0.1700832799487508,41.04292816543579,11.08494968032837,33,4
593,593,0.7235718975705844,9986,2644,0.5668724279835391,52130840,16530,19174,26516,/well/papiez/users/hri611/python/nnUNet_results/Dataset219_PETCT/nnUNetTrainer_1500epochs_NoMirroring__nnUNetPlans__3d_fullres/crossval_results_folds_0_1_2_3_4/PETCT_ad7c6a4a58_03282003.nii.gz,/well/papiez/users/hri611/python/nnUnet_raw/Dataset219_PETCT/labelsTr/PETCT_ad7c6a4a58_03282003.nii.gz,0.7235718975705844,3.0729321784973145,9.35564776611328,23,18
594,594,0.758942236387447,24736,5820,0.6115285352861156,52081343,48101,53921,72837,/well/papiez/users/hri611/python/nnUNet_results/Dataset219_PETCT/nnUNetTrainer_1500epochs_NoMirroring__nnUNetPlans__3d_fullres/crossval_results_folds_0_1_2_3_4/PETCT_ad7cd4a9d2_10022003.nii.gz,/well/papiez/users/hri611/python/nnUnet_raw/Dataset219_PETCT/labelsTr/PETCT_ad7cd4a9d2_10022003.nii.gz,0.758942236387447,5.722869644165039,26.92236936950684,53,62
595,595,0.0,0,33,0.0,52799967,0,33,0,/well/papiez/users/hri611/python/nnUNet_results/Dataset219_PETCT/nnUNetTrainer_1500epochs_NoMirroring__nnUNetPlans__3d_fullres/crossval_results_folds_0_1_2_3_4/PETCT_ad99263bec_01292006.nii.gz,/well/papiez/users/hri611/python/nnUnet_raw/Dataset219_PETCT/labelsTr/PETCT_ad99263bec_01292006.nii.gz,0.0,0.4105536918640137,0.0,1,0
596,596,0.0,0,221154,0.0,51938846,0,221154,0,/well/papiez/users/hri611/python/nnUNet_results/Dataset219_PETCT/nnUNetTrainer_1500epochs_NoMirroring__nnUNetPlans__3d_fullres/crossval_results_folds_0_1_2_3_4/PETCT_adc49adb3d_09222002.nii.gz,/well/papiez/users/hri611/python/nnUnet_raw/Dataset219_PETCT/labelsTr/PETCT_adc49adb3d_09222002.nii.gz,0.0,2751.3815506210326,0.0,88,0
597,597,0.9639643712980964,75,722,0.9304355415902942,45428543,10660,11382,10735,/well/papiez/users/hri611/python/nnUNet_results/Dataset219_PETCT/nnUNetTrainer_1500epochs_NoMirroring__nnUNetPlans__3d_fullres/crossval_results_folds_0_1_2_3_4/PETCT_ae3074834a_07262003.nii.gz,/well/papiez/users/hri611/python/nnUnet_raw/Dataset219_PETCT/labelsTr/PETCT_ae3074834a_07262003.nii.gz,0.9639643712980964,0.0,0.0,2,2
598,598,0.0,0,181,0.0,52159819,0,181,0,/well/papiez/users/hri611/python/nnUNet_results/Dataset219_PETCT/nnUNetTrainer_1500epochs_NoMirroring__nnUNetPlans__3d_fullres/crossval_results_folds_0_1_2_3_4/PETCT_ae46202abb_02282003.nii.gz,/well/papiez/users/hri611/python/nnUnet_raw/Dataset219_PETCT/labelsTr/PETCT_ae46202abb_02282003.nii.gz,0.0,2.251824794769287,0.0,4,0
599,599,0.0,0,15,0.0,38719985,0,15,0,/well/papiez/users/hri611/python/nnUNet_results/Dataset219_PETCT/nnUNetTrainer_1500epochs_NoMirroring__nnUNetPlans__3d_fullres/crossval_results_folds_0_1_2_3_4/PETCT_ae4dcc5dd3_10082004.nii.gz,/well/papiez/users/hri611/python/nnUnet_raw/Dataset219_PETCT/labelsTr/PETCT_ae4dcc5dd3_10082004.nii.gz,0.0,0.1866153144836425,0.0,3,0
600,600,0.0,0,3,0.0,52159997,0,3,0,/well/papiez/users/hri611/python/nnUNet_results/Dataset219_PETCT/nnUNetTrainer_1500epochs_NoMirroring__nnUNetPlans__3d_fullres/crossval_results_folds_0_1_2_3_4/PETCT_ae6a37a9d6_02102005.nii.gz,/well/papiez/users/hri611/python/nnUnet_raw/Dataset219_PETCT/labelsTr/PETCT_ae6a37a9d6_02102005.nii.gz,0.0,0.0373230628967285,0.0,2,0
601,601,0.0,0,79,0.0,49439921,0,79,0,/well/papiez/users/hri611/python/nnUNet_results/Dataset219_PETCT/nnUNetTrainer_1500epochs_NoMirroring__nnUNetPlans__3d_fullres/crossval_results_folds_0_1_2_3_4/PETCT_ae6a37a9d6_02182006.nii.gz,/well/papiez/users/hri611/python/nnUnet_raw/Dataset219_PETCT/labelsTr/PETCT_ae6a37a9d6_02182006.nii.gz,0.0,0.9828406562805176,0.0,1,0
602,602,0.0,0,9,0.0,48159991,0,9,0,/well/papiez/users/hri611/python/nnUNet_results/Dataset219_PETCT/nnUNetTrainer_1500epochs_NoMirroring__nnUNetPlans__3d_fullres/crossval_results_folds_0_1_2_3_4/PETCT_ae6a37a9d6_08182005.nii.gz,/well/papiez/users/hri611/python/nnUnet_raw/Dataset219_PETCT/labelsTr/PETCT_ae6a37a9d6_08182005.nii.gz,0.0,0.1119691886901855,0.0,2,0
603,603,0.0,0,3,0.0,52159997,0,3,0,/well/papiez/users/hri611/python/nnUNet_results/Dataset219_PETCT/nnUNetTrainer_1500epochs_NoMirroring__nnUNetPlans__3d_fullres/crossval_results_folds_0_1_2_3_4/PETCT_ae6a37a9d6_09132003.nii.gz,/well/papiez/users/hri611/python/nnUnet_raw/Dataset219_PETCT/labelsTr/PETCT_ae6a37a9d6_09132003.nii.gz,0.0,0.0373230628967285,0.0,1,0
604,604,0.0,0,63,0.0,52159937,0,63,0,/well/papiez/users/hri611/python/nnUNet_results/Dataset219_PETCT/nnUNetTrainer_1500epochs_NoMirroring__nnUNetPlans__3d_fullres/crossval_results_folds_0_1_2_3_4/PETCT_ae6a37a9d6_09152002.nii.gz,/well/papiez/users/hri611/python/nnUnet_raw/Dataset219_PETCT/labelsTr/PETCT_ae6a37a9d6_09152002.nii.gz,0.0,0.7837843208312988,0.0,3,0
605,605,0.6094898641122745,1501,252,0.4383210509452098,52156879,1368,1620,2869,/well/papiez/users/hri611/python/nnUNet_results/Dataset219_PETCT/nnUNetTrainer_1500epochs_NoMirroring__nnUNetPlans__3d_fullres/crossval_results_folds_0_1_2_3_4/PETCT_ae96f738c0_05012003.nii.gz,/well/papiez/users/hri611/python/nnUnet_raw/Dataset219_PETCT/labelsTr/PETCT_ae96f738c0_05012003.nii.gz,0.6094898641122745,3.0978142204284667,0.0,7,1
606,606,0.0,0,70,0.0,52159930,0,70,0,/well/papiez/users/hri611/python/nnUNet_results/Dataset219_PETCT/nnUNetTrainer_1500epochs_NoMirroring__nnUNetPlans__3d_fullres/crossval_results_folds_0_1_2_3_4/PETCT_ae96f738c0_09112003.nii.gz,/well/papiez/users/hri611/python/nnUnet_raw/Dataset219_PETCT/labelsTr/PETCT_ae96f738c0_09112003.nii.gz,0.0,0.870871467590332,0.0,3,0
607,607,0.7939624039262895,249,1976,0.6583230958230958,45433488,4287,6263,4536,/well/papiez/users/hri611/python/nnUNet_results/Dataset219_PETCT/nnUNetTrainer_1500epochs_NoMirroring__nnUNetPlans__3d_fullres/crossval_results_folds_0_1_2_3_4/PETCT_aea7906fd2_12162001.nii.gz,/well/papiez/users/hri611/python/nnUnet_raw/Dataset219_PETCT/labelsTr/PETCT_aea7906fd2_12162001.nii.gz,0.7939624039262895,0.8335484046936035,0.4603177757263184,16,15
608,608,0.94408272692455,1215,1121,0.8940877765687342,52137944,19720,20841,20935,/well/papiez/users/hri611/python/nnUNet_results/Dataset219_PETCT/nnUNetTrainer_1500epochs_NoMirroring__nnUNetPlans__3d_fullres/crossval_results_folds_0_1_2_3_4/PETCT_aee7d68f86_04152002.nii.gz,/well/papiez/users/hri611/python/nnUnet_raw/Dataset219_PETCT/labelsTr/PETCT_aee7d68f86_04152002.nii.gz,0.94408272692455,0.0870871467590332,0.0,4,2
609,609,,0,0,,99040000,0,0,0,/well/papiez/users/hri611/python/nnUNet_results/Dataset219_PETCT/nnUNetTrainer_1500epochs_NoMirroring__nnUNetPlans__3d_fullres/crossval_results_folds_0_1_2_3_4/PETCT_af119148fe_02112005.nii.gz,/well/papiez/users/hri611/python/nnUnet_raw/Dataset219_PETCT/labelsTr/PETCT_af119148fe_02112005.nii.gz,,0.0,0.0,0,0
610,610,,0,0,,99040000,0,0,0,/well/papiez/users/hri611/python/nnUNet_results/Dataset219_PETCT/nnUNetTrainer_1500epochs_NoMirroring__nnUNetPlans__3d_fullres/crossval_results_folds_0_1_2_3_4/PETCT_af119148fe_10052003.nii.gz,/well/papiez/users/hri611/python/nnUnet_raw/Dataset219_PETCT/labelsTr/PETCT_af119148fe_10052003.nii.gz,,0.0,0.0,0,0
611,611,,0,0,,99040000,0,0,0,/well/papiez/users/hri611/python/nnUNet_results/Dataset219_PETCT/nnUNetTrainer_1500epochs_NoMirroring__nnUNetPlans__3d_fullres/crossval_results_folds_0_1_2_3_4/PETCT_af119148fe_12052002.nii.gz,/well/papiez/users/hri611/python/nnUnet_raw/Dataset219_PETCT/labelsTr/PETCT_af119148fe_12052002.nii.gz,,0.0,0.0,0,0
612,612,0.0,0,1313,0.0,45438687,0,1313,0,/well/papiez/users/hri611/python/nnUNet_results/Dataset219_PETCT/nnUNetTrainer_1500epochs_NoMirroring__nnUNetPlans__3d_fullres/crossval_results_folds_0_1_2_3_4/PETCT_af547fa618_03112006.nii.gz,/well/papiez/users/hri611/python/nnUnet_raw/Dataset219_PETCT/labelsTr/PETCT_af547fa618_03112006.nii.gz,0.0,16.335060527801513,0.0,4,0
613,613,0.9125778331257784,661,41,0.8392120934493816,99035634,3664,3705,4325,/well/papiez/users/hri611/python/nnUNet_results/Dataset219_PETCT/nnUNetTrainer_1500epochs_NoMirroring__nnUNetPlans__3d_fullres/crossval_results_folds_0_1_2_3_4/PETCT_af73b85f2c_06192003.nii.gz,/well/papiez/users/hri611/python/nnUnet_raw/Dataset219_PETCT/labelsTr/PETCT_af73b85f2c_06192003.nii.gz,0.9125778331257784,0.0870871467590332,0.0,3,1
614,614,0.767279482416245,1302,2331,0.6224277696944502,52150378,5989,8320,7291,/well/papiez/users/hri611/python/nnUNet_results/Dataset219_PETCT/nnUNetTrainer_1500epochs_NoMirroring__nnUNetPlans__3d_fullres/crossval_results_folds_0_1_2_3_4/PETCT_b04be2846e_11152004.nii.gz,/well/papiez/users/hri611/python/nnUnet_raw/Dataset219_PETCT/labelsTr/PETCT_b04be2846e_11152004.nii.gz,0.767279482416245,6.320038650512696,0.0,9,5
615,615,0.0,0,383,0.0,49439617,0,383,0,/well/papiez/users/hri611/python/nnUNet_results/Dataset219_PETCT/nnUNetTrainer_1500epochs_NoMirroring__nnUNetPlans__3d_fullres/crossval_results_folds_0_1_2_3_4/PETCT_b0e002e974_03112007.nii.gz,/well/papiez/users/hri611/python/nnUnet_raw/Dataset219_PETCT/labelsTr/PETCT_b0e002e974_03112007.nii.gz,0.0,4.764911029815674,0.0,5,0
616,616,0.0,0,4,0.0,58879996,0,4,0,/well/papiez/users/hri611/python/nnUNet_results/Dataset219_PETCT/nnUNetTrainer_1500epochs_NoMirroring__nnUNetPlans__3d_fullres/crossval_results_folds_0_1_2_3_4/PETCT_b0e002e974_04022005.nii.gz,/well/papiez/users/hri611/python/nnUnet_raw/Dataset219_PETCT/labelsTr/PETCT_b0e002e974_04022005.nii.gz,0.0,0.0497640838623046,0.0,1,0
617,617,0.0,0,1,0.0,52799999,0,1,0,/well/papiez/users/hri611/python/nnUNet_results/Dataset219_PETCT/nnUNetTrainer_1500epochs_NoMirroring__nnUNetPlans__3d_fullres/crossval_results_folds_0_1_2_3_4/PETCT_b0e002e974_09232005.nii.gz,/well/papiez/users/hri611/python/nnUnet_raw/Dataset219_PETCT/labelsTr/PETCT_b0e002e974_09232005.nii.gz,0.0,0.0124410209655761,0.0,1,0
618,618,0.8861722984661515,639,348,0.7956098571132739,52155171,3842,4190,4481,/well/papiez/users/hri611/python/nnUNet_results/Dataset219_PETCT/nnUNetTrainer_1500epochs_NoMirroring__nnUNetPlans__3d_fullres/crossval_results_folds_0_1_2_3_4/PETCT_b1aa7ce13e_03092003.nii.gz,/well/papiez/users/hri611/python/nnUnet_raw/Dataset219_PETCT/labelsTr/PETCT_b1aa7ce13e_03092003.nii.gz,0.8861722984661515,0.2239383773803711,0.0,6,2
619,619,,0,0,,50080000,0,0,0,/well/papiez/users/hri611/python/nnUNet_results/Dataset219_PETCT/nnUNetTrainer_1500epochs_NoMirroring__nnUNetPlans__3d_fullres/crossval_results_folds_0_1_2_3_4/PETCT_b1d6679284_05282007.nii.gz,/well/papiez/users/hri611/python/nnUnet_raw/Dataset219_PETCT/labelsTr/PETCT_b1d6679284_05282007.nii.gz,,0.0,0.0,0,0
620,620,0.0,0,1634,0.0,45438366,0,1634,0,/well/papiez/users/hri611/python/nnUNet_results/Dataset219_PETCT/nnUNetTrainer_1500epochs_NoMirroring__nnUNetPlans__3d_fullres/crossval_results_folds_0_1_2_3_4/PETCT_b1de3d4248_11202003.nii.gz,/well/papiez/users/hri611/python/nnUnet_raw/Dataset219_PETCT/labelsTr/PETCT_b1de3d4248_11202003.nii.gz,0.0,20.328628257751465,0.0,6,0
621,621,0.6947159390610941,7464,2375,0.5322335266711039,52138966,11195,13570,18659,/well/papiez/users/hri611/python/nnUNet_results/Dataset219_PETCT/nnUNetTrainer_1500epochs_NoMirroring__nnUNetPlans__3d_fullres/crossval_results_folds_0_1_2_3_4/PETCT_b258dfa7c2_12152002.nii.gz,/well/papiez/users/hri611/python/nnUnet_raw/Dataset219_PETCT/labelsTr/PETCT_b258dfa7c2_12152002.nii.gz,0.6947159390610941,0.1866153144836425,17.205931995391847,17,23
622,622,0.0,0,12,0.0,45439988,0,12,0,/well/papiez/users/hri611/python/nnUNet_results/Dataset219_PETCT/nnUNetTrainer_1500epochs_NoMirroring__nnUNetPlans__3d_fullres/crossval_results_folds_0_1_2_3_4/PETCT_b2f82ed4b9_04172003.nii.gz,/well/papiez/users/hri611/python/nnUnet_raw/Dataset219_PETCT/labelsTr/PETCT_b2f82ed4b9_04172003.nii.gz,0.0,0.149292251586914,0.0,2,0
623,623,0.8734693877551021,4902,1174,0.7753623188405797,45412952,20972,22146,25874,/well/papiez/users/hri611/python/nnUNet_results/Dataset219_PETCT/nnUNetTrainer_1500epochs_NoMirroring__nnUNetPlans__3d_fullres/crossval_results_folds_0_1_2_3_4/PETCT_b2f82ed4b9_11112002.nii.gz,/well/papiez/users/hri611/python/nnUnet_raw/Dataset219_PETCT/labelsTr/PETCT_b2f82ed4b9_11112002.nii.gz,0.8734693877551021,4.628059799194336,5.038613491058349,27,38
624,624,0.7787807296474852,9289,3651,0.6377075342273987,45404283,22777,26428,32066,/well/papiez/users/hri611/python/nnUNet_results/Dataset219_PETCT/nnUNetTrainer_1500epochs_NoMirroring__nnUNetPlans__3d_fullres/crossval_results_folds_0_1_2_3_4/PETCT_b327726c24_08272000.nii.gz,/well/papiez/users/hri611/python/nnUnet_raw/Dataset219_PETCT/labelsTr/PETCT_b327726c24_08272000.nii.gz,0.7787807296474852,15.028753326416016,0.0124410209655761,16,14
625,625,0.575101166388955,9850,860,0.4036084196458403,52142042,7248,8108,17098,/well/papiez/users/hri611/python/nnUNet_results/Dataset219_PETCT/nnUNetTrainer_1500epochs_NoMirroring__nnUNetPlans__3d_fullres/crossval_results_folds_0_1_2_3_4/PETCT_b3d4773f85_11042000.nii.gz,/well/papiez/users/hri611/python/nnUnet_raw/Dataset219_PETCT/labelsTr/PETCT_b3d4773f85_11042000.nii.gz,0.575101166388955,2.525527256011963,15.476630081176758,41,46
626,626,0.0,0,366,0.0,52159634,0,366,0,/well/papiez/users/hri611/python/nnUNet_results/Dataset219_PETCT/nnUNetTrainer_1500epochs_NoMirroring__nnUNetPlans__3d_fullres/crossval_results_folds_0_1_2_3_4/PETCT_b3e923029c_07192003.nii.gz,/well/papiez/users/hri611/python/nnUnet_raw/Dataset219_PETCT/labelsTr/PETCT_b3e923029c_07192003.nii.gz,0.0,4.553413673400879,0.0,5,0
627,627,0.0,0,168,0.0,52159832,0,168,0,/well/papiez/users/hri611/python/nnUNet_results/Dataset219_PETCT/nnUNetTrainer_1500epochs_NoMirroring__nnUNetPlans__3d_fullres/crossval_results_folds_0_1_2_3_4/PETCT_b3e923029c_11212003.nii.gz,/well/papiez/users/hri611/python/nnUnet_raw/Dataset219_PETCT/labelsTr/PETCT_b3e923029c_11212003.nii.gz,0.0,2.090091522216797,0.0,6,0
628,628,0.7463414634146341,0,104,0.5953307392996109,58879743,153,257,153,/well/papiez/users/hri611/python/nnUNet_results/Dataset219_PETCT/nnUNetTrainer_1500epochs_NoMirroring__nnUNetPlans__3d_fullres/crossval_results_folds_0_1_2_3_4/PETCT_b41bc7c1e5_03122005.nii.gz,/well/papiez/users/hri611/python/nnUnet_raw/Dataset219_PETCT/labelsTr/PETCT_b41bc7c1e5_03122005.nii.gz,0.7463414634146341,0.0248820419311523,0.0,3,2
629,629,,0,0,,59200000,0,0,0,/well/papiez/users/hri611/python/nnUNet_results/Dataset219_PETCT/nnUNetTrainer_1500epochs_NoMirroring__nnUNetPlans__3d_fullres/crossval_results_folds_0_1_2_3_4/PETCT_b41bc7c1e5_08062006.nii.gz,/well/papiez/users/hri611/python/nnUnet_raw/Dataset219_PETCT/labelsTr/PETCT_b41bc7c1e5_08062006.nii.gz,,0.0,0.0,0,0
630,630,,0,0,,58880000,0,0,0,/well/papiez/users/hri611/python/nnUNet_results/Dataset219_PETCT/nnUNetTrainer_1500epochs_NoMirroring__nnUNetPlans__3d_fullres/crossval_results_folds_0_1_2_3_4/PETCT_b41bc7c1e5_11052006.nii.gz,/well/papiez/users/hri611/python/nnUnet_raw/Dataset219_PETCT/labelsTr/PETCT_b41bc7c1e5_11052006.nii.gz,,0.0,0.0,0,0
631,631,,0,0,,45120000,0,0,0,/well/papiez/users/hri611/python/nnUNet_results/Dataset219_PETCT/nnUNetTrainer_1500epochs_NoMirroring__nnUNetPlans__3d_fullres/crossval_results_folds_0_1_2_3_4/PETCT_b4247b8ecd_05272007.nii.gz,/well/papiez/users/hri611/python/nnUnet_raw/Dataset219_PETCT/labelsTr/PETCT_b4247b8ecd_05272007.nii.gz,,0.0,0.0,0,0
632,632,0.0,0,59,0.0,45119941,0,59,0,/well/papiez/users/hri611/python/nnUNet_results/Dataset219_PETCT/nnUNetTrainer_1500epochs_NoMirroring__nnUNetPlans__3d_fullres/crossval_results_folds_0_1_2_3_4/PETCT_b4247b8ecd_10202006.nii.gz,/well/papiez/users/hri611/python/nnUnet_raw/Dataset219_PETCT/labelsTr/PETCT_b4247b8ecd_10202006.nii.gz,0.0,0.7340202369689941,0.0,3,0
633,633,0.0,0,131,0.0,52159869,0,131,0,/well/papiez/users/hri611/python/nnUNet_results/Dataset219_PETCT/nnUNetTrainer_1500epochs_NoMirroring__nnUNetPlans__3d_fullres/crossval_results_folds_0_1_2_3_4/PETCT_b42adab18e_09052003.nii.gz,/well/papiez/users/hri611/python/nnUnet_raw/Dataset219_PETCT/labelsTr/PETCT_b42adab18e_09052003.nii.gz,0.0,1.6297737464904785,0.0,4,0
634,634,0.0,0,194,0.0,52159806,0,194,0,/well/papiez/users/hri611/python/nnUNet_results/Dataset219_PETCT/nnUNetTrainer_1500epochs_NoMirroring__nnUNetPlans__3d_fullres/crossval_results_folds_0_1_2_3_4/PETCT_b4e5c1047c_10102004.nii.gz,/well/papiez/users/hri611/python/nnUnet_raw/Dataset219_PETCT/labelsTr/PETCT_b4e5c1047c_10102004.nii.gz,0.0,2.413558067321777,0.0,3,0
635,635,0.8377984453081622,103,4571,0.7208719020603165,52143255,12071,16642,12174,/well/papiez/users/hri611/python/nnUNet_results/Dataset219_PETCT/nnUNetTrainer_1500epochs_NoMirroring__nnUNetPlans__3d_fullres/crossval_results_folds_0_1_2_3_4/PETCT_b509ace2a2_05272002.nii.gz,/well/papiez/users/hri611/python/nnUnet_raw/Dataset219_PETCT/labelsTr/PETCT_b509ace2a2_05272002.nii.gz,0.8377984453081622,4.317034275054931,0.4851998176574706,21,31
636,636,0.4298724954462659,0,626,0.2737819025522042,52159138,236,862,236,/well/papiez/users/hri611/python/nnUNet_results/Dataset219_PETCT/nnUNetTrainer_1500epochs_NoMirroring__nnUNetPlans__3d_fullres/crossval_results_folds_0_1_2_3_4/PETCT_b510436d83_11102002.nii.gz,/well/papiez/users/hri611/python/nnUnet_raw/Dataset219_PETCT/labelsTr/PETCT_b510436d83_11102002.nii.gz,0.4298724954462659,6.85500255203247,0.0,11,2
637,637,0.0,137,0,0.0,45439863,0,0,137,/well/papiez/users/hri611/python/nnUNet_results/Dataset219_PETCT/nnUNetTrainer_1500epochs_NoMirroring__nnUNetPlans__3d_fullres/crossval_results_folds_0_1_2_3_4/PETCT_b510436d83_11142003.nii.gz,/well/papiez/users/hri611/python/nnUnet_raw/Dataset219_PETCT/labelsTr/PETCT_b510436d83_11142003.nii.gz,0.0,0.0,1.7044198722839354,0,1
638,638,0.8305584512285927,4742,947,0.7102180114099429,52140368,13943,14890,18685,/well/papiez/users/hri611/python/nnUNet_results/Dataset219_PETCT/nnUNetTrainer_1500epochs_NoMirroring__nnUNetPlans__3d_fullres/crossval_results_folds_0_1_2_3_4/PETCT_b52920038c_06072003.nii.gz,/well/papiez/users/hri611/python/nnUnet_raw/Dataset219_PETCT/labelsTr/PETCT_b52920038c_06072003.nii.gz,0.8305584512285927,0.0497640838623046,2.625055423736572,5,2
639,639,0.6991562347240229,2290,11865,0.5374636473548345,52129397,16448,28313,18738,/well/papiez/users/hri611/python/nnUNet_results/Dataset219_PETCT/nnUNetTrainer_1500epochs_NoMirroring__nnUNetPlans__3d_fullres/crossval_results_folds_0_1_2_3_4/PETCT_b53ba7c6bf_11212003.nii.gz,/well/papiez/users/hri611/python/nnUnet_raw/Dataset219_PETCT/labelsTr/PETCT_b53ba7c6bf_11212003.nii.gz,0.6991562347240229,41.44104083633423,10.736601093292236,52,45
640,640,,0,0,,55520000,0,0,0,/well/papiez/users/hri611/python/nnUNet_results/Dataset219_PETCT/nnUNetTrainer_1500epochs_NoMirroring__nnUNetPlans__3d_fullres/crossval_results_folds_0_1_2_3_4/PETCT_b57e1c1f5f_06252006.nii.gz,/well/papiez/users/hri611/python/nnUnet_raw/Dataset219_PETCT/labelsTr/PETCT_b57e1c1f5f_06252006.nii.gz,,0.0,0.0,0,0
641,641,0.924433249370277,101,19,0.8594847775175644,52799146,734,753,835,/well/papiez/users/hri611/python/nnUNet_results/Dataset219_PETCT/nnUNetTrainer_1500epochs_NoMirroring__nnUNetPlans__3d_fullres/crossval_results_folds_0_1_2_3_4/PETCT_b5923963ac_02172007.nii.gz,/well/papiez/users/hri611/python/nnUnet_raw/Dataset219_PETCT/labelsTr/PETCT_b5923963ac_02172007.nii.gz,0.924433249370277,0.0497640838623046,0.0,3,1
642,642,0.0,0,204,0.0,52959796,0,204,0,/well/papiez/users/hri611/python/nnUNet_results/Dataset219_PETCT/nnUNetTrainer_1500epochs_NoMirroring__nnUNetPlans__3d_fullres/crossval_results_folds_0_1_2_3_4/PETCT_b5923963ac_06022007.nii.gz,/well/papiez/users/hri611/python/nnUnet_raw/Dataset219_PETCT/labelsTr/PETCT_b5923963ac_06022007.nii.gz,0.0,2.537968276977539,0.0,1,0
643,643,,0,0,,38720000,0,0,0,/well/papiez/users/hri611/python/nnUNet_results/Dataset219_PETCT/nnUNetTrainer_1500epochs_NoMirroring__nnUNetPlans__3d_fullres/crossval_results_folds_0_1_2_3_4/PETCT_b621742469_11042004.nii.gz,/well/papiez/users/hri611/python/nnUnet_raw/Dataset219_PETCT/labelsTr/PETCT_b621742469_11042004.nii.gz,,0.0,0.0,0,0
644,644,0.0,0,1159,0.0,52158841,0,1159,0,/well/papiez/users/hri611/python/nnUNet_results/Dataset219_PETCT/nnUNetTrainer_1500epochs_NoMirroring__nnUNetPlans__3d_fullres/crossval_results_folds_0_1_2_3_4/PETCT_b62864161e_07282002.nii.gz,/well/papiez/users/hri611/python/nnUnet_raw/Dataset219_PETCT/labelsTr/PETCT_b62864161e_07282002.nii.gz,0.0,14.419143299102783,0.0,3,0
645,645,0.0,0,252,0.0,94239748,0,252,0,/well/papiez/users/hri611/python/nnUNet_results/Dataset219_PETCT/nnUNetTrainer_1500epochs_NoMirroring__nnUNetPlans__3d_fullres/crossval_results_folds_0_1_2_3_4/PETCT_b663adb148_06212007.nii.gz,/well/papiez/users/hri611/python/nnUnet_raw/Dataset219_PETCT/labelsTr/PETCT_b663adb148_06212007.nii.gz,0.0,3.135137283325195,0.0,3,0
646,646,0.0,0,33,0.0,52159967,0,33,0,/well/papiez/users/hri611/python/nnUNet_results/Dataset219_PETCT/nnUNetTrainer_1500epochs_NoMirroring__nnUNetPlans__3d_fullres/crossval_results_folds_0_1_2_3_4/PETCT_b66ba83594_03132003.nii.gz,/well/papiez/users/hri611/python/nnUnet_raw/Dataset219_PETCT/labelsTr/PETCT_b66ba83594_03132003.nii.gz,0.0,0.4105536918640137,0.0,1,0
647,647,0.7377084687026207,43,1168,0.5844200411805079,49437086,1703,2871,1746,/well/papiez/users/hri611/python/nnUNet_results/Dataset219_PETCT/nnUNetTrainer_1500epochs_NoMirroring__nnUNetPlans__3d_fullres/crossval_results_folds_0_1_2_3_4/PETCT_b6a1ee33ef_10242005.nii.gz,/well/papiez/users/hri611/python/nnUnet_raw/Dataset219_PETCT/labelsTr/PETCT_b6a1ee33ef_10242005.nii.gz,0.7377084687026207,2.911198905944824,0.0,17,13
648,648,0.4464285714285714,709,35,0.2873563218390804,52158956,300,335,1009,/well/papiez/users/hri611/python/nnUNet_results/Dataset219_PETCT/nnUNetTrainer_1500epochs_NoMirroring__nnUNetPlans__3d_fullres/crossval_results_folds_0_1_2_3_4/PETCT_b6a3c72db6_07132002.nii.gz,/well/papiez/users/hri611/python/nnUnet_raw/Dataset219_PETCT/labelsTr/PETCT_b6a3c72db6_07132002.nii.gz,0.4464285714285714,0.2737024612426758,7.825402187347412,4,2
649,649,0.8902445152407465,8866,2055,0.8021987973628921,45384788,44291,46346,53157,/well/papiez/users/hri611/python/nnUNet_results/Dataset219_PETCT/nnUNetTrainer_1500epochs_NoMirroring__nnUNetPlans__3d_fullres/crossval_results_folds_0_1_2_3_4/PETCT_b6fc20942c_12282001.nii.gz,/well/papiez/users/hri611/python/nnUnet_raw/Dataset219_PETCT/labelsTr/PETCT_b6fc20942c_12282001.nii.gz,0.8902445152407465,0.1119691886901855,0.58472798538208,9,6
650,650,,0,0,,46880000,0,0,0,/well/papiez/users/hri611/python/nnUNet_results/Dataset219_PETCT/nnUNetTrainer_1500epochs_NoMirroring__nnUNetPlans__3d_fullres/crossval_results_folds_0_1_2_3_4/PETCT_b79961f3f6_07072007.nii.gz,/well/papiez/users/hri611/python/nnUnet_raw/Dataset219_PETCT/labelsTr/PETCT_b79961f3f6_07072007.nii.gz,,0.0,0.0,0,0
651,651,0.7209951489200249,7057,3238,0.5637157265754121,52136403,13302,16540,20359,/well/papiez/users/hri611/python/nnUNet_results/Dataset219_PETCT/nnUNetTrainer_1500epochs_NoMirroring__nnUNetPlans__3d_fullres/crossval_results_folds_0_1_2_3_4/PETCT_b7c1533a39_02122005.nii.gz,/well/papiez/users/hri611/python/nnUnet_raw/Dataset219_PETCT/labelsTr/PETCT_b7c1533a39_02122005.nii.gz,0.7209951489200249,17.716013854980467,3.956244667053223,22,27
652,652,0.7725730546131115,3705,451,0.6294248773963442,38708785,7059,7510,10764,/well/papiez/users/hri611/python/nnUNet_results/Dataset219_PETCT/nnUNetTrainer_1500epochs_NoMirroring__nnUNetPlans__3d_fullres/crossval_results_folds_0_1_2_3_4/PETCT_b899150306_08112002.nii.gz,/well/papiez/users/hri611/python/nnUnet_raw/Dataset219_PETCT/labelsTr/PETCT_b899150306_08112002.nii.gz,0.7725730546131115,0.0,10.251401275634766,7,11
653,653,0.0,0,9,0.0,52159991,0,9,0,/well/papiez/users/hri611/python/nnUNet_results/Dataset219_PETCT/nnUNetTrainer_1500epochs_NoMirroring__nnUNetPlans__3d_fullres/crossval_results_folds_0_1_2_3_4/PETCT_b926177c87_10102004.nii.gz,/well/papiez/users/hri611/python/nnUnet_raw/Dataset219_PETCT/labelsTr/PETCT_b926177c87_10102004.nii.gz,0.0,0.1119691886901855,0.0,5,0
654,654,,0,0,,44320000,0,0,0,/well/papiez/users/hri611/python/nnUNet_results/Dataset219_PETCT/nnUNetTrainer_1500epochs_NoMirroring__nnUNetPlans__3d_fullres/crossval_results_folds_0_1_2_3_4/PETCT_b92d7f441e_03222007.nii.gz,/well/papiez/users/hri611/python/nnUnet_raw/Dataset219_PETCT/labelsTr/PETCT_b92d7f441e_03222007.nii.gz,,0.0,0.0,0,0
655,655,0.8754429970062303,4351,3346,0.7784780981983538,52125254,27049,30395,31400,/well/papiez/users/hri611/python/nnUNet_results/Dataset219_PETCT/nnUNetTrainer_1500epochs_NoMirroring__nnUNetPlans__3d_fullres/crossval_results_folds_0_1_2_3_4/PETCT_ba717a1f22_03282003.nii.gz,/well/papiez/users/hri611/python/nnUnet_raw/Dataset219_PETCT/labelsTr/PETCT_ba717a1f22_03282003.nii.gz,0.8754429970062303,0.8211073837280274,9.5547041015625,8,10
656,656,,0,0,,51520000,0,0,0,/well/papiez/users/hri611/python/nnUNet_results/Dataset219_PETCT/nnUNetTrainer_1500epochs_NoMirroring__nnUNetPlans__3d_fullres/crossval_results_folds_0_1_2_3_4/PETCT_ba81e4b04b_12022005.nii.gz,/well/papiez/users/hri611/python/nnUnet_raw/Dataset219_PETCT/labelsTr/PETCT_ba81e4b04b_12022005.nii.gz,,0.0,0.0,0,0
657,657,0.8238336386165284,567,1068,0.7004397215097106,52154542,3823,4891,4390,/well/papiez/users/hri611/python/nnUNet_results/Dataset219_PETCT/nnUNetTrainer_1500epochs_NoMirroring__nnUNetPlans__3d_fullres/crossval_results_folds_0_1_2_3_4/PETCT_bacc741e2c_01282002.nii.gz,/well/papiez/users/hri611/python/nnUnet_raw/Dataset219_PETCT/labelsTr/PETCT_bacc741e2c_01282002.nii.gz,0.8238336386165284,1.604891704559326,0.0,6,4
658,658,0.349478390461997,1989,1503,0.2117381489841986,52155570,938,2441,2927,/well/papiez/users/hri611/python/nnUNet_results/Dataset219_PETCT/nnUNetTrainer_1500epochs_NoMirroring__nnUNetPlans__3d_fullres/crossval_results_folds_0_1_2_3_4/PETCT_bb45bfcffd_01032003.nii.gz,/well/papiez/users/hri611/python/nnUnet_raw/Dataset219_PETCT/labelsTr/PETCT_bb45bfcffd_01032003.nii.gz,0.349478390461997,9.169032451629638,0.2612614402770996,6,7
659,659,,0,0,,48000000,0,0,0,/well/papiez/users/hri611/python/nnUNet_results/Dataset219_PETCT/nnUNetTrainer_1500epochs_NoMirroring__nnUNetPlans__3d_fullres/crossval_results_folds_0_1_2_3_4/PETCT_bb564e29d2_05052006.nii.gz,/well/papiez/users/hri611/python/nnUnet_raw/Dataset219_PETCT/labelsTr/PETCT_bb564e29d2_05052006.nii.gz,,0.0,0.0,0,0
660,660,,0,0,,52160000,0,0,0,/well/papiez/users/hri611/python/nnUNet_results/Dataset219_PETCT/nnUNetTrainer_1500epochs_NoMirroring__nnUNetPlans__3d_fullres/crossval_results_folds_0_1_2_3_4/PETCT_bbb2df1e31_01292005.nii.gz,/well/papiez/users/hri611/python/nnUnet_raw/Dataset219_PETCT/labelsTr/PETCT_bbb2df1e31_01292005.nii.gz,,0.0,0.0,0,0
661,661,0.5792941992543137,3303,6401,0.4077509917607568,52143615,6681,13082,9984,/well/papiez/users/hri611/python/nnUNet_results/Dataset219_PETCT/nnUNetTrainer_1500epochs_NoMirroring__nnUNetPlans__3d_fullres/crossval_results_folds_0_1_2_3_4/PETCT_bbb83facb4_08232001.nii.gz,/well/papiez/users/hri611/python/nnUnet_raw/Dataset219_PETCT/labelsTr/PETCT_bbb83facb4_08232001.nii.gz,0.5792941992543137,76.13904830932617,0.5722869644165038,10,9
662,662,0.8715551974214343,0,797,0.7723507569265924,92316499,2704,3501,2704,/well/papiez/users/hri611/python/nnUNet_results/Dataset219_PETCT/nnUNetTrainer_1500epochs_NoMirroring__nnUNetPlans__3d_fullres/crossval_results_folds_0_1_2_3_4/PETCT_bc80d06f97_02182002.nii.gz,/well/papiez/users/hri611/python/nnUnet_raw/Dataset219_PETCT/labelsTr/PETCT_bc80d06f97_02182002.nii.gz,0.8715551974214343,1.604891704559326,0.0,9,6
663,663,0.9279807413681652,1733,1498,0.86563812533788,45415953,20816,22314,22549,/well/papiez/users/hri611/python/nnUNet_results/Dataset219_PETCT/nnUNetTrainer_1500epochs_NoMirroring__nnUNetPlans__3d_fullres/crossval_results_folds_0_1_2_3_4/PETCT_bca97006e4_05062001.nii.gz,/well/papiez/users/hri611/python/nnUnet_raw/Dataset219_PETCT/labelsTr/PETCT_bca97006e4_05062001.nii.gz,0.9279807413681652,2.251824794769287,0.0,5,2
664,664,0.6311659192825112,619,39,0.4610974610974611,45438779,563,602,1182,/well/papiez/users/hri611/python/nnUNet_results/Dataset219_PETCT/nnUNetTrainer_1500epochs_NoMirroring__nnUNetPlans__3d_fullres/crossval_results_folds_0_1_2_3_4/PETCT_bd52fdf529_12032000.nii.gz,/well/papiez/users/hri611/python/nnUnet_raw/Dataset219_PETCT/labelsTr/PETCT_bd52fdf529_12032000.nii.gz,0.6311659192825112,0.0,6.979412761688232,1,3
665,665,0.8777819690682761,215,433,0.7821848739495798,52157025,2327,2760,2542,/well/papiez/users/hri611/python/nnUNet_results/Dataset219_PETCT/nnUNetTrainer_1500epochs_NoMirroring__nnUNetPlans__3d_fullres/crossval_results_folds_0_1_2_3_4/PETCT_bd7603e9df_05062005.nii.gz,/well/papiez/users/hri611/python/nnUnet_raw/Dataset219_PETCT/labelsTr/PETCT_bd7603e9df_05062005.nii.gz,0.8777819690682761,0.0497640838623046,2.425999088287353,3,2
666,666,0.0,0,2178,0.0,45437822,0,2178,0,/well/papiez/users/hri611/python/nnUNet_results/Dataset219_PETCT/nnUNetTrainer_1500epochs_NoMirroring__nnUNetPlans__3d_fullres/crossval_results_folds_0_1_2_3_4/PETCT_bd76c8d299_10252002.nii.gz,/well/papiez/users/hri611/python/nnUnet_raw/Dataset219_PETCT/labelsTr/PETCT_bd76c8d299_10252002.nii.gz,0.0,27.096543663024903,0.0,5,0
667,667,0.8139926354550236,3200,336,0.6863301694313847,45428727,7737,8073,10937,/well/papiez/users/hri611/python/nnUNet_results/Dataset219_PETCT/nnUNetTrainer_1500epochs_NoMirroring__nnUNetPlans__3d_fullres/crossval_results_folds_0_1_2_3_4/PETCT_bd7c02faa9_05042002.nii.gz,/well/papiez/users/hri611/python/nnUnet_raw/Dataset219_PETCT/labelsTr/PETCT_bd7c02faa9_05042002.nii.gz,0.8139926354550236,0.1368512306213379,5.063495532989502,7,10
668,668,0.0,0,2204,0.0,50397796,0,2204,0,/well/papiez/users/hri611/python/nnUNet_results/Dataset219_PETCT/nnUNetTrainer_1500epochs_NoMirroring__nnUNetPlans__3d_fullres/crossval_results_folds_0_1_2_3_4/PETCT_be0d3c767e_05292006.nii.gz,/well/papiez/users/hri611/python/nnUnet_raw/Dataset219_PETCT/labelsTr/PETCT_be0d3c767e_05292006.nii.gz,0.0,27.42001020812988,0.0,2,0
669,669,0.840532241555783,568,990,0.7249293785310734,45434336,4106,5096,4674,/well/papiez/users/hri611/python/nnUNet_results/Dataset219_PETCT/nnUNetTrainer_1500epochs_NoMirroring__nnUNetPlans__3d_fullres/crossval_results_folds_0_1_2_3_4/PETCT_be3e55a32f_04052001.nii.gz,/well/papiez/users/hri611/python/nnUnet_raw/Dataset219_PETCT/labelsTr/PETCT_be3e55a32f_04052001.nii.gz,0.840532241555783,0.5722869644165038,0.0124410209655761,13,14
670,670,0.0,0,1449,0.0,51678551,0,1449,0,/well/papiez/users/hri611/python/nnUNet_results/Dataset219_PETCT/nnUNetTrainer_1500epochs_NoMirroring__nnUNetPlans__3d_fullres/crossval_results_folds_0_1_2_3_4/PETCT_bef465b4ad_05042007.nii.gz,/well/papiez/users/hri611/python/nnUnet_raw/Dataset219_PETCT/labelsTr/PETCT_bef465b4ad_05042007.nii.gz,0.0,18.027039379119877,0.0,7,0
671,671,0.454892989374191,17227,882,0.2944087278394701,45414335,7556,8438,24783,/well/papiez/users/hri611/python/nnUNet_results/Dataset219_PETCT/nnUNetTrainer_1500epochs_NoMirroring__nnUNetPlans__3d_fullres/crossval_results_folds_0_1_2_3_4/PETCT_bf178a41b2_06082002.nii.gz,/well/papiez/users/hri611/python/nnUnet_raw/Dataset219_PETCT/labelsTr/PETCT_bf178a41b2_06082002.nii.gz,0.454892989374191,0.7589022789001465,63.523853050231935,24,45
672,672,0.8263687531980215,1875,161,0.7041127743060601,45433119,4845,5006,6720,/well/papiez/users/hri611/python/nnUNet_results/Dataset219_PETCT/nnUNetTrainer_1500epochs_NoMirroring__nnUNetPlans__3d_fullres/crossval_results_folds_0_1_2_3_4/PETCT_bf7652bccc_11252002.nii.gz,/well/papiez/users/hri611/python/nnUnet_raw/Dataset219_PETCT/labelsTr/PETCT_bf7652bccc_11252002.nii.gz,0.8263687531980215,1.16945597076416,7.315320327758789,5,5
673,673,0.891626854412874,76,355,0.8044464609800362,46237796,1773,2128,1849,/well/papiez/users/hri611/python/nnUNet_results/Dataset219_PETCT/nnUNetTrainer_1500epochs_NoMirroring__nnUNetPlans__3d_fullres/crossval_results_folds_0_1_2_3_4/PETCT_bfd89440db_02052006.nii.gz,/well/papiez/users/hri611/python/nnUnet_raw/Dataset219_PETCT/labelsTr/PETCT_bfd89440db_02052006.nii.gz,0.891626854412874,0.2114973564147949,0.0,10,6
674,674,,0,0,,47360000,0,0,0,/well/papiez/users/hri611/python/nnUNet_results/Dataset219_PETCT/nnUNetTrainer_1500epochs_NoMirroring__nnUNetPlans__3d_fullres/crossval_results_folds_0_1_2_3_4/PETCT_bfd89440db_03112007.nii.gz,/well/papiez/users/hri611/python/nnUnet_raw/Dataset219_PETCT/labelsTr/PETCT_bfd89440db_03112007.nii.gz,,0.0,0.0,0,0
675,675,,0,0,,48160000,0,0,0,/well/papiez/users/hri611/python/nnUNet_results/Dataset219_PETCT/nnUNetTrainer_1500epochs_NoMirroring__nnUNetPlans__3d_fullres/crossval_results_folds_0_1_2_3_4/PETCT_c018b45a49_11262006.nii.gz,/well/papiez/users/hri611/python/nnUnet_raw/Dataset219_PETCT/labelsTr/PETCT_c018b45a49_11262006.nii.gz,,0.0,0.0,0,0
676,676,0.0,0,1606,0.0,52798394,0,1606,0,/well/papiez/users/hri611/python/nnUNet_results/Dataset219_PETCT/nnUNetTrainer_1500epochs_NoMirroring__nnUNetPlans__3d_fullres/crossval_results_folds_0_1_2_3_4/PETCT_c08293f2b2_07132006.nii.gz,/well/papiez/users/hri611/python/nnUnet_raw/Dataset219_PETCT/labelsTr/PETCT_c08293f2b2_07132006.nii.gz,0.0,19.980279670715333,0.0,1,0
677,677,0.0,0,27,0.0,50399973,0,27,0,/well/papiez/users/hri611/python/nnUNet_results/Dataset219_PETCT/nnUNetTrainer_1500epochs_NoMirroring__nnUNetPlans__3d_fullres/crossval_results_folds_0_1_2_3_4/PETCT_c094a24c03_01292006.nii.gz,/well/papiez/users/hri611/python/nnUnet_raw/Dataset219_PETCT/labelsTr/PETCT_c094a24c03_01292006.nii.gz,0.0,0.3359075660705566,0.0,2,0
678,678,0.0,0,9,0.0,52159991,0,9,0,/well/papiez/users/hri611/python/nnUNet_results/Dataset219_PETCT/nnUNetTrainer_1500epochs_NoMirroring__nnUNetPlans__3d_fullres/crossval_results_folds_0_1_2_3_4/PETCT_c094a24c03_03042007.nii.gz,/well/papiez/users/hri611/python/nnUnet_raw/Dataset219_PETCT/labelsTr/PETCT_c094a24c03_03042007.nii.gz,0.0,0.1119691886901855,0.0,2,0
679,679,0.0,0,553,0.0,52159447,0,553,0,/well/papiez/users/hri611/python/nnUNet_results/Dataset219_PETCT/nnUNetTrainer_1500epochs_NoMirroring__nnUNetPlans__3d_fullres/crossval_results_folds_0_1_2_3_4/PETCT_c10f48b173_11272004.nii.gz,/well/papiez/users/hri611/python/nnUnet_raw/Dataset219_PETCT/labelsTr/PETCT_c10f48b173_11272004.nii.gz,0.0,6.879884593963623,0.0,13,0
680,680,0.7961515333734215,150,189,0.6613386613386614,45438999,662,851,812,/well/papiez/users/hri611/python/nnUNet_results/Dataset219_PETCT/nnUNetTrainer_1500epochs_NoMirroring__nnUNetPlans__3d_fullres/crossval_results_folds_0_1_2_3_4/PETCT_c16c13211c_10262003.nii.gz,/well/papiez/users/hri611/python/nnUnet_raw/Dataset219_PETCT/labelsTr/PETCT_c16c13211c_10262003.nii.gz,0.7961515333734215,0.2488204193115234,0.6096100273132324,8,8
681,681,0.8879824035192961,746,2055,0.7985326907861613,72146097,11102,13157,11848,/well/papiez/users/hri611/python/nnUNet_results/Dataset219_PETCT/nnUNetTrainer_1500epochs_NoMirroring__nnUNetPlans__3d_fullres/crossval_results_folds_0_1_2_3_4/PETCT_c16d325d12_02152003.nii.gz,/well/papiez/users/hri611/python/nnUnet_raw/Dataset219_PETCT/labelsTr/PETCT_c16d325d12_02152003.nii.gz,0.8879824035192961,0.5722869644165038,0.1119691886901855,9,14
682,682,,0,0,,51040000,0,0,0,/well/papiez/users/hri611/python/nnUNet_results/Dataset219_PETCT/nnUNetTrainer_1500epochs_NoMirroring__nnUNetPlans__3d_fullres/crossval_results_folds_0_1_2_3_4/PETCT_c1c9e78e0e_05142007.nii.gz,/well/papiez/users/hri611/python/nnUnet_raw/Dataset219_PETCT/labelsTr/PETCT_c1c9e78e0e_05142007.nii.gz,,0.0,0.0,0,0
683,683,,0,0,,45440000,0,0,0,/well/papiez/users/hri611/python/nnUNet_results/Dataset219_PETCT/nnUNetTrainer_1500epochs_NoMirroring__nnUNetPlans__3d_fullres/crossval_results_folds_0_1_2_3_4/PETCT_c227131152_10262003.nii.gz,/well/papiez/users/hri611/python/nnUnet_raw/Dataset219_PETCT/labelsTr/PETCT_c227131152_10262003.nii.gz,,0.0,0.0,0,0
684,684,0.9207642596234896,58,506,0.8531632387399115,92316159,3277,3783,3335,/well/papiez/users/hri611/python/nnUNet_results/Dataset219_PETCT/nnUNetTrainer_1500epochs_NoMirroring__nnUNetPlans__3d_fullres/crossval_results_folds_0_1_2_3_4/PETCT_c252d734a0_08092003.nii.gz,/well/papiez/users/hri611/python/nnUnet_raw/Dataset219_PETCT/labelsTr/PETCT_c252d734a0_08092003.nii.gz,0.9207642596234896,2.525527256011963,0.0,6,3
685,685,0.6623106011884856,12573,554,0.4951153846153846,52134000,12873,13427,25446,/well/papiez/users/hri611/python/nnUNet_results/Dataset219_PETCT/nnUNetTrainer_1500epochs_NoMirroring__nnUNetPlans__3d_fullres/crossval_results_folds_0_1_2_3_4/PETCT_c29aba73da_08232002.nii.gz,/well/papiez/users/hri611/python/nnUnet_raw/Dataset219_PETCT/labelsTr/PETCT_c29aba73da_08232002.nii.gz,0.6623106011884856,0.1741742935180664,14.431584320068358,41,39
686,686,0.8657906698070328,5239,1257,0.7633429268825822,52132551,20953,22210,26192,/well/papiez/users/hri611/python/nnUNet_results/Dataset219_PETCT/nnUNetTrainer_1500epochs_NoMirroring__nnUNetPlans__3d_fullres/crossval_results_folds_0_1_2_3_4/PETCT_c2a51a65c6_09152002.nii.gz,/well/papiez/users/hri611/python/nnUnet_raw/Dataset219_PETCT/labelsTr/PETCT_c2a51a65c6_09152002.nii.gz,0.8657906698070328,0.2239383773803711,0.0248820419311523,7,6
687,687,0.0,0,1336,0.0,72158664,0,1336,0,/well/papiez/users/hri611/python/nnUNet_results/Dataset219_PETCT/nnUNetTrainer_1500epochs_NoMirroring__nnUNetPlans__3d_fullres/crossval_results_folds_0_1_2_3_4/PETCT_c2b776974a_05092005.nii.gz,/well/papiez/users/hri611/python/nnUnet_raw/Dataset219_PETCT/labelsTr/PETCT_c2b776974a_05092005.nii.gz,0.0,16.621204010009766,0.0,13,0
688,688,0.0,0,273,0.0,38719727,0,273,0,/well/papiez/users/hri611/python/nnUNet_results/Dataset219_PETCT/nnUNetTrainer_1500epochs_NoMirroring__nnUNetPlans__3d_fullres/crossval_results_folds_0_1_2_3_4/PETCT_c2ffda4725_04112003.nii.gz,/well/papiez/users/hri611/python/nnUnet_raw/Dataset219_PETCT/labelsTr/PETCT_c2ffda4725_04112003.nii.gz,0.0,3.396398723602295,0.0,2,0
689,689,0.0,0,2536,0.0,38717464,0,2536,0,/well/papiez/users/hri611/python/nnUNet_results/Dataset219_PETCT/nnUNetTrainer_1500epochs_NoMirroring__nnUNetPlans__3d_fullres/crossval_results_folds_0_1_2_3_4/PETCT_c2ffda4725_09192003.nii.gz,/well/papiez/users/hri611/python/nnUnet_raw/Dataset219_PETCT/labelsTr/PETCT_c2ffda4725_09192003.nii.gz,0.0,31.55042916870117,0.0,18,0
690,690,0.0,0,3397,0.0,65436603,0,3397,0,/well/papiez/users/hri611/python/nnUNet_results/Dataset219_PETCT/nnUNetTrainer_1500epochs_NoMirroring__nnUNetPlans__3d_fullres/crossval_results_folds_0_1_2_3_4/PETCT_c32e1daf9b_02022003.nii.gz,/well/papiez/users/hri611/python/nnUnet_raw/Dataset219_PETCT/labelsTr/PETCT_c32e1daf9b_02022003.nii.gz,0.0,42.26214822006226,0.0,2,0
691,691,0.0,0,217,0.0,41759783,0,217,0,/well/papiez/users/hri611/python/nnUNet_results/Dataset219_PETCT/nnUNetTrainer_1500epochs_NoMirroring__nnUNetPlans__3d_fullres/crossval_results_folds_0_1_2_3_4/PETCT_c38b168f1a_04152006.nii.gz,/well/papiez/users/hri611/python/nnUnet_raw/Dataset219_PETCT/labelsTr/PETCT_c38b168f1a_04152006.nii.gz,0.0,2.699701549530029,0.0,1,0
692,692,,0,0,,58880000,0,0,0,/well/papiez/users/hri611/python/nnUNet_results/Dataset219_PETCT/nnUNetTrainer_1500epochs_NoMirroring__nnUNetPlans__3d_fullres/crossval_results_folds_0_1_2_3_4/PETCT_c395306306_08242002.nii.gz,/well/papiez/users/hri611/python/nnUnet_raw/Dataset219_PETCT/labelsTr/PETCT_c395306306_08242002.nii.gz,,0.0,0.0,0,0
693,693,0.7839220462850183,840,934,0.6446314102564102,51195008,3218,4152,4058,/well/papiez/users/hri611/python/nnUNet_results/Dataset219_PETCT/nnUNetTrainer_1500epochs_NoMirroring__nnUNetPlans__3d_fullres/crossval_results_folds_0_1_2_3_4/PETCT_c3cc732d95_07212005.nii.gz,/well/papiez/users/hri611/python/nnUnet_raw/Dataset219_PETCT/labelsTr/PETCT_c3cc732d95_07212005.nii.gz,0.7839220462850183,0.2612614402770996,8.372807109832763,7,12
694,694,0.8326051429143181,3003,2016,0.7132163876349923,52142499,12482,14498,15485,/well/papiez/users/hri611/python/nnUNet_results/Dataset219_PETCT/nnUNetTrainer_1500epochs_NoMirroring__nnUNetPlans__3d_fullres/crossval_results_folds_0_1_2_3_4/PETCT_c4a686881e_04231999.nii.gz,/well/papiez/users/hri611/python/nnUnet_raw/Dataset219_PETCT/labelsTr/PETCT_c4a686881e_04231999.nii.gz,0.8326051429143181,0.1368512306213379,0.0,6,4
695,695,0.9124884895056043,2895,2617,0.8390609944815907,52125751,28737,31354,31632,/well/papiez/users/hri611/python/nnUNet_results/Dataset219_PETCT/nnUNetTrainer_1500epochs_NoMirroring__nnUNetPlans__3d_fullres/crossval_results_folds_0_1_2_3_4/PETCT_c517c47bed_02062003.nii.gz,/well/papiez/users/hri611/python/nnUnet_raw/Dataset219_PETCT/labelsTr/PETCT_c517c47bed_02062003.nii.gz,0.9124884895056043,2.1522966270446777,0.9703996353149412,14,5
696,696,0.2041904761904762,2063,26,0.1137038608400509,45437643,268,294,2331,/well/papiez/users/hri611/python/nnUNet_results/Dataset219_PETCT/nnUNetTrainer_1500epochs_NoMirroring__nnUNetPlans__3d_fullres/crossval_results_folds_0_1_2_3_4/PETCT_c58477f3b4_12072002.nii.gz,/well/papiez/users/hri611/python/nnUnet_raw/Dataset219_PETCT/labelsTr/PETCT_c58477f3b4_12072002.nii.gz,0.2041904761904762,0.1244102096557617,22.406278759002685,4,10
697,697,0.0,0,43,0.0,65439957,0,43,0,/well/papiez/users/hri611/python/nnUNet_results/Dataset219_PETCT/nnUNetTrainer_1500epochs_NoMirroring__nnUNetPlans__3d_fullres/crossval_results_folds_0_1_2_3_4/PETCT_c596a50286_05162003.nii.gz,/well/papiez/users/hri611/python/nnUnet_raw/Dataset219_PETCT/labelsTr/PETCT_c596a50286_05162003.nii.gz,0.0,0.5349639015197754,0.0,2,0
698,698,,0,0,,43680000,0,0,0,/well/papiez/users/hri611/python/nnUNet_results/Dataset219_PETCT/nnUNetTrainer_1500epochs_NoMirroring__nnUNetPlans__3d_fullres/crossval_results_folds_0_1_2_3_4/PETCT_c5a143a604_08122006.nii.gz,/well/papiez/users/hri611/python/nnUnet_raw/Dataset219_PETCT/labelsTr/PETCT_c5a143a604_08122006.nii.gz,,0.0,0.0,0,0
699,699,,0,0,,42880000,0,0,0,/well/papiez/users/hri611/python/nnUNet_results/Dataset219_PETCT/nnUNetTrainer_1500epochs_NoMirroring__nnUNetPlans__3d_fullres/crossval_results_folds_0_1_2_3_4/PETCT_c6730783de_01052006.nii.gz,/well/papiez/users/hri611/python/nnUnet_raw/Dataset219_PETCT/labelsTr/PETCT_c6730783de_01052006.nii.gz,,0.0,0.0,0,0
700,700,0.6465248423532672,4271,830,0.4776776571779643,52150234,4665,5495,8936,/well/papiez/users/hri611/python/nnUNet_results/Dataset219_PETCT/nnUNetTrainer_1500epochs_NoMirroring__nnUNetPlans__3d_fullres/crossval_results_folds_0_1_2_3_4/PETCT_c73c2685c0_02012001.nii.gz,/well/papiez/users/hri611/python/nnUnet_raw/Dataset219_PETCT/labelsTr/PETCT_c73c2685c0_02012001.nii.gz,0.6465248423532672,0.4105536918640137,3.0729321784973145,4,3
701,701,0.0,0,71,0.0,45439929,0,71,0,/well/papiez/users/hri611/python/nnUNet_results/Dataset219_PETCT/nnUNetTrainer_1500epochs_NoMirroring__nnUNetPlans__3d_fullres/crossval_results_folds_0_1_2_3_4/PETCT_c787334539_01052003.nii.gz,/well/papiez/users/hri611/python/nnUnet_raw/Dataset219_PETCT/labelsTr/PETCT_c787334539_01052003.nii.gz,0.0,0.8833124885559082,0.0,2,0
702,702,0.8934921167393493,1163,107,0.8074882522358647,45433403,5327,5434,6490,/well/papiez/users/hri611/python/nnUNet_results/Dataset219_PETCT/nnUNetTrainer_1500epochs_NoMirroring__nnUNetPlans__3d_fullres/crossval_results_folds_0_1_2_3_4/PETCT_c799ccc2f6_08262002.nii.gz,/well/papiez/users/hri611/python/nnUnet_raw/Dataset219_PETCT/labelsTr/PETCT_c799ccc2f6_08262002.nii.gz,0.8934921167393493,0.0,0.0,2,2
703,703,0.0,0,319,0.0,45439681,0,319,0,/well/papiez/users/hri611/python/nnUNet_results/Dataset219_PETCT/nnUNetTrainer_1500epochs_NoMirroring__nnUNetPlans__3d_fullres/crossval_results_folds_0_1_2_3_4/PETCT_c7fd7e3e30_11132003.nii.gz,/well/papiez/users/hri611/python/nnUnet_raw/Dataset219_PETCT/labelsTr/PETCT_c7fd7e3e30_11132003.nii.gz,0.0,3.968685688018799,0.0,2,0
704,704,0.0,0,1,0.0,52159999,0,1,0,/well/papiez/users/hri611/python/nnUNet_results/Dataset219_PETCT/nnUNetTrainer_1500epochs_NoMirroring__nnUNetPlans__3d_fullres/crossval_results_folds_0_1_2_3_4/PETCT_c852dfc0a5_07262002.nii.gz,/well/papiez/users/hri611/python/nnUnet_raw/Dataset219_PETCT/labelsTr/PETCT_c852dfc0a5_07262002.nii.gz,0.0,0.0124410209655761,0.0,1,0
705,705,0.8815075055892686,315,56,0.7881210736721873,52158249,1380,1436,1695,/well/papiez/users/hri611/python/nnUNet_results/Dataset219_PETCT/nnUNetTrainer_1500epochs_NoMirroring__nnUNetPlans__3d_fullres/crossval_results_folds_0_1_2_3_4/PETCT_c898e2abcb_12102004.nii.gz,/well/papiez/users/hri611/python/nnUnet_raw/Dataset219_PETCT/labelsTr/PETCT_c898e2abcb_12102004.nii.gz,0.8815075055892686,0.0,0.149292251586914,4,5
706,706,0.0,0,9,0.0,52159991,0,9,0,/well/papiez/users/hri611/python/nnUNet_results/Dataset219_PETCT/nnUNetTrainer_1500epochs_NoMirroring__nnUNetPlans__3d_fullres/crossval_results_folds_0_1_2_3_4/PETCT_c9f1b9980f_09152003.nii.gz,/well/papiez/users/hri611/python/nnUnet_raw/Dataset219_PETCT/labelsTr/PETCT_c9f1b9980f_09152003.nii.gz,0.0,0.1119691886901855,0.0,3,0
707,707,0.0,0,47,0.0,45439953,0,47,0,/well/papiez/users/hri611/python/nnUNet_results/Dataset219_PETCT/nnUNetTrainer_1500epochs_NoMirroring__nnUNetPlans__3d_fullres/crossval_results_folds_0_1_2_3_4/PETCT_ca16242e89_09132002.nii.gz,/well/papiez/users/hri611/python/nnUnet_raw/Dataset219_PETCT/labelsTr/PETCT_ca16242e89_09132002.nii.gz,0.0,0.58472798538208,0.0,3,0
708,708,,0,0,,45440000,0,0,0,/well/papiez/users/hri611/python/nnUNet_results/Dataset219_PETCT/nnUNetTrainer_1500epochs_NoMirroring__nnUNetPlans__3d_fullres/crossval_results_folds_0_1_2_3_4/PETCT_ca16242e89_09182003.nii.gz,/well/papiez/users/hri611/python/nnUnet_raw/Dataset219_PETCT/labelsTr/PETCT_ca16242e89_09182003.nii.gz,,0.0,0.0,0,0
709,709,0.0,0,9573,0.0,45430427,0,9573,0,/well/papiez/users/hri611/python/nnUNet_results/Dataset219_PETCT/nnUNetTrainer_1500epochs_NoMirroring__nnUNetPlans__3d_fullres/crossval_results_folds_0_1_2_3_4/PETCT_ca29501275_11042004.nii.gz,/well/papiez/users/hri611/python/nnUnet_raw/Dataset219_PETCT/labelsTr/PETCT_ca29501275_11042004.nii.gz,0.0,119.09789370346068,0.0,12,0
710,710,0.8501299288216021,4570,736,0.7393269466961434,52139645,15049,15785,19619,/well/papiez/users/hri611/python/nnUNet_results/Dataset219_PETCT/nnUNetTrainer_1500epochs_NoMirroring__nnUNetPlans__3d_fullres/crossval_results_folds_0_1_2_3_4/PETCT_ca47fe5e7d_09012003.nii.gz,/well/papiez/users/hri611/python/nnUnet_raw/Dataset219_PETCT/labelsTr/PETCT_ca47fe5e7d_09012003.nii.gz,0.8501299288216021,7.589022789001465,0.9081945304870606,5,4
711,711,0.0,0,150,0.0,38719850,0,150,0,/well/papiez/users/hri611/python/nnUNet_results/Dataset219_PETCT/nnUNetTrainer_1500epochs_NoMirroring__nnUNetPlans__3d_fullres/crossval_results_folds_0_1_2_3_4/PETCT_ca5406d339_12092004.nii.gz,/well/papiez/users/hri611/python/nnUnet_raw/Dataset219_PETCT/labelsTr/PETCT_ca5406d339_12092004.nii.gz,0.0,1.8661531448364257,0.0,1,0
712,712,0.7281129916485919,72361,7238,0.5724667261067128,51973818,106583,113821,178944,/well/papiez/users/hri611/python/nnUNet_results/Dataset219_PETCT/nnUNetTrainer_1500epochs_NoMirroring__nnUNetPlans__3d_fullres/crossval_results_folds_0_1_2_3_4/PETCT_ca58410fad_05232003.nii.gz,/well/papiez/users/hri611/python/nnUnet_raw/Dataset219_PETCT/labelsTr/PETCT_ca58410fad_05232003.nii.gz,0.7281129916485919,0.6220510482788086,33.78981294250488,79,74
713,713,0.0,0,7110,0.0,52152890,0,7110,0,/well/papiez/users/hri611/python/nnUNet_results/Dataset219_PETCT/nnUNetTrainer_1500epochs_NoMirroring__nnUNetPlans__3d_fullres/crossval_results_folds_0_1_2_3_4/PETCT_ca62984a81_08072003.nii.gz,/well/papiez/users/hri611/python/nnUnet_raw/Dataset219_PETCT/labelsTr/PETCT_ca62984a81_08072003.nii.gz,0.0,88.45565906524658,0.0,13,0
714,714,0.0,0,26,0.0,52159974,0,26,0,/well/papiez/users/hri611/python/nnUNet_results/Dataset219_PETCT/nnUNetTrainer_1500epochs_NoMirroring__nnUNetPlans__3d_fullres/crossval_results_folds_0_1_2_3_4/PETCT_ca9570a0eb_09282002.nii.gz,/well/papiez/users/hri611/python/nnUnet_raw/Dataset219_PETCT/labelsTr/PETCT_ca9570a0eb_09282002.nii.gz,0.0,0.3234665451049804,0.0,6,0
715,715,0.8855444785276073,1882,506,0.7945983141235162,85588374,9238,9744,11120,/well/papiez/users/hri611/python/nnUNet_results/Dataset219_PETCT/nnUNetTrainer_1500epochs_NoMirroring__nnUNetPlans__3d_fullres/crossval_results_folds_0_1_2_3_4/PETCT_caae8d63f0_01262004.nii.gz,/well/papiez/users/hri611/python/nnUnet_raw/Dataset219_PETCT/labelsTr/PETCT_caae8d63f0_01262004.nii.gz,0.8855444785276073,1.455599452972412,0.0,20,12
716,716,0.845360824742268,1,59,0.7321428571428571,101439776,164,223,165,/well/papiez/users/hri611/python/nnUNet_results/Dataset219_PETCT/nnUNetTrainer_1500epochs_NoMirroring__nnUNetPlans__3d_fullres/crossval_results_folds_0_1_2_3_4/PETCT_cab58c1fee_03192007.nii.gz,/well/papiez/users/hri611/python/nnUnet_raw/Dataset219_PETCT/labelsTr/PETCT_cab58c1fee_03192007.nii.gz,0.845360824742268,0.3483485870361328,0.0,2,1
717,717,0.3284625158831004,4227,1,0.1965032307107563,45434738,1034,1035,5261,/well/papiez/users/hri611/python/nnUNet_results/Dataset219_PETCT/nnUNetTrainer_1500epochs_NoMirroring__nnUNetPlans__3d_fullres/crossval_results_folds_0_1_2_3_4/PETCT_cb1f5e74ab_06142001.nii.gz,/well/papiez/users/hri611/python/nnUnet_raw/Dataset219_PETCT/labelsTr/PETCT_cb1f5e74ab_06142001.nii.gz,0.3284625158831004,0.0,3.806952415466309,5,8
718,718,0.0,0,15,0.0,91039985,0,15,0,/well/papiez/users/hri611/python/nnUNet_results/Dataset219_PETCT/nnUNetTrainer_1500epochs_NoMirroring__nnUNetPlans__3d_fullres/crossval_results_folds_0_1_2_3_4/PETCT_cb240e6f0f_04192007.nii.gz,/well/papiez/users/hri611/python/nnUnet_raw/Dataset219_PETCT/labelsTr/PETCT_cb240e6f0f_04192007.nii.gz,0.0,0.1866153144836425,0.0,2,0
719,719,0.8069506985336566,7723,2309,0.6763766573115262,48129001,20967,23276,28690,/well/papiez/users/hri611/python/nnUNet_results/Dataset219_PETCT/nnUNetTrainer_1500epochs_NoMirroring__nnUNetPlans__3d_fullres/crossval_results_folds_0_1_2_3_4/PETCT_cbbc9e2879_01162006.nii.gz,/well/papiez/users/hri611/python/nnUnet_raw/Dataset219_PETCT/labelsTr/PETCT_cbbc9e2879_01162006.nii.gz,0.8069506985336566,1.9159172286987305,1.3560712852478027,12,10
720,720,,0,0,,47200000,0,0,0,/well/papiez/users/hri611/python/nnUNet_results/Dataset219_PETCT/nnUNetTrainer_1500epochs_NoMirroring__nnUNetPlans__3d_fullres/crossval_results_folds_0_1_2_3_4/PETCT_cbbc9e2879_03312006.nii.gz,/well/papiez/users/hri611/python/nnUnet_raw/Dataset219_PETCT/labelsTr/PETCT_cbbc9e2879_03312006.nii.gz,,0.0,0.0,0,0
721,721,,0,0,,46880000,0,0,0,/well/papiez/users/hri611/python/nnUNet_results/Dataset219_PETCT/nnUNetTrainer_1500epochs_NoMirroring__nnUNetPlans__3d_fullres/crossval_results_folds_0_1_2_3_4/PETCT_cbbc9e2879_06282007.nii.gz,/well/papiez/users/hri611/python/nnUnet_raw/Dataset219_PETCT/labelsTr/PETCT_cbbc9e2879_06282007.nii.gz,,0.0,0.0,0,0
722,722,0.0,0,3,0.0,46239997,0,3,0,/well/papiez/users/hri611/python/nnUNet_results/Dataset219_PETCT/nnUNetTrainer_1500epochs_NoMirroring__nnUNetPlans__3d_fullres/crossval_results_folds_0_1_2_3_4/PETCT_cbbc9e2879_08062006.nii.gz,/well/papiez/users/hri611/python/nnUnet_raw/Dataset219_PETCT/labelsTr/PETCT_cbbc9e2879_08062006.nii.gz,0.0,0.0373230628967285,0.0,1,0
723,723,0.0,0,4357,0.0,45435643,0,4357,0,/well/papiez/users/hri611/python/nnUNet_results/Dataset219_PETCT/nnUNetTrainer_1500epochs_NoMirroring__nnUNetPlans__3d_fullres/crossval_results_folds_0_1_2_3_4/PETCT_cc1698663a_10152004.nii.gz,/well/papiez/users/hri611/python/nnUnet_raw/Dataset219_PETCT/labelsTr/PETCT_cc1698663a_10152004.nii.gz,0.0,54.20552834701538,0.0,24,0
724,724,0.0,0,2861,0.0,45437139,0,2861,0,/well/papiez/users/hri611/python/nnUNet_results/Dataset219_PETCT/nnUNetTrainer_1500epochs_NoMirroring__nnUNetPlans__3d_fullres/crossval_results_folds_0_1_2_3_4/PETCT_cc7cb73213_12182004.nii.gz,/well/papiez/users/hri611/python/nnUnet_raw/Dataset219_PETCT/labelsTr/PETCT_cc7cb73213_12182004.nii.gz,0.0,35.59376098251343,0.0,11,0
725,725,0.0,0,251,0.0,44159749,0,251,0,/well/papiez/users/hri611/python/nnUNet_results/Dataset219_PETCT/nnUNetTrainer_1500epochs_NoMirroring__nnUNetPlans__3d_fullres/crossval_results_folds_0_1_2_3_4/PETCT_ccb9c375b2_10012005.nii.gz,/well/papiez/users/hri611/python/nnUnet_raw/Dataset219_PETCT/labelsTr/PETCT_ccb9c375b2_10012005.nii.gz,0.0,3.1226962623596197,0.0,2,0
726,726,0.0,0,7491,0.0,50872509,0,7491,0,/well/papiez/users/hri611/python/nnUNet_results/Dataset219_PETCT/nnUNetTrainer_1500epochs_NoMirroring__nnUNetPlans__3d_fullres/crossval_results_folds_0_1_2_3_4/PETCT_ccd8f5ff71_10292006.nii.gz,/well/papiez/users/hri611/python/nnUnet_raw/Dataset219_PETCT/labelsTr/PETCT_ccd8f5ff71_10292006.nii.gz,0.0,93.19568805313112,0.0,8,0
727,727,0.8365758754863813,1,3779,0.7190635451505016,52146545,9675,13454,9676,/well/papiez/users/hri611/python/nnUNet_results/Dataset219_PETCT/nnUNetTrainer_1500epochs_NoMirroring__nnUNetPlans__3d_fullres/crossval_results_folds_0_1_2_3_4/PETCT_cd2ef932b5_04272003.nii.gz,/well/papiez/users/hri611/python/nnUnet_raw/Dataset219_PETCT/labelsTr/PETCT_cd2ef932b5_04272003.nii.gz,0.8365758754863813,3.0107270736694334,0.0124410209655761,11,3
728,728,0.0,0,14,0.0,52159986,0,14,0,/well/papiez/users/hri611/python/nnUNet_results/Dataset219_PETCT/nnUNetTrainer_1500epochs_NoMirroring__nnUNetPlans__3d_fullres/crossval_results_folds_0_1_2_3_4/PETCT_cd50f3fec4_12012002.nii.gz,/well/papiez/users/hri611/python/nnUnet_raw/Dataset219_PETCT/labelsTr/PETCT_cd50f3fec4_12012002.nii.gz,0.0,0.1741742935180664,0.0,4,0
729,729,0.0,0,207,0.0,54399793,0,207,0,/well/papiez/users/hri611/python/nnUNet_results/Dataset219_PETCT/nnUNetTrainer_1500epochs_NoMirroring__nnUNetPlans__3d_fullres/crossval_results_folds_0_1_2_3_4/PETCT_cd9bdca46b_10052006.nii.gz,/well/papiez/users/hri611/python/nnUnet_raw/Dataset219_PETCT/labelsTr/PETCT_cd9bdca46b_10052006.nii.gz,0.0,2.5752913398742674,0.0,5,0
730,730,0.7325196760579445,1722,623,0.577933765298776,92314444,3211,3834,4933,/well/papiez/users/hri611/python/nnUNet_results/Dataset219_PETCT/nnUNetTrainer_1500epochs_NoMirroring__nnUNetPlans__3d_fullres/crossval_results_folds_0_1_2_3_4/PETCT_cdd237e9b3_04162005.nii.gz,/well/papiez/users/hri611/python/nnUnet_raw/Dataset219_PETCT/labelsTr/PETCT_cdd237e9b3_04162005.nii.gz,0.7325196760579445,6.220510482788086,0.074646125793457,5,5
731,731,0.0,0,2694,0.0,52157306,0,2694,0,/well/papiez/users/hri611/python/nnUNet_results/Dataset219_PETCT/nnUNetTrainer_1500epochs_NoMirroring__nnUNetPlans__3d_fullres/crossval_results_folds_0_1_2_3_4/PETCT_ce0ffef966_05112003.nii.gz,/well/papiez/users/hri611/python/nnUnet_raw/Dataset219_PETCT/labelsTr/PETCT_ce0ffef966_05112003.nii.gz,0.0,33.51611048126221,0.0,10,0
732,732,0.7342629482071713,3376,1960,0.5801070192005037,72147292,7372,9332,10748,/well/papiez/users/hri611/python/nnUNet_results/Dataset219_PETCT/nnUNetTrainer_1500epochs_NoMirroring__nnUNetPlans__3d_fullres/crossval_results_folds_0_1_2_3_4/PETCT_cf20ad1656_02182005.nii.gz,/well/papiez/users/hri611/python/nnUnet_raw/Dataset219_PETCT/labelsTr/PETCT_cf20ad1656_02182005.nii.gz,0.7342629482071713,0.721579216003418,0.0248820419311523,21,18
733,733,0.0,0,104,0.0,89759896,0,104,0,/well/papiez/users/hri611/python/nnUNet_results/Dataset219_PETCT/nnUNetTrainer_1500epochs_NoMirroring__nnUNetPlans__3d_fullres/crossval_results_folds_0_1_2_3_4/PETCT_cf3725edf0_10072005.nii.gz,/well/papiez/users/hri611/python/nnUnet_raw/Dataset219_PETCT/labelsTr/PETCT_cf3725edf0_10072005.nii.gz,0.0,1.293866180419922,0.0,2,0
734,734,0.0,0,3,0.0,38719997,0,3,0,/well/papiez/users/hri611/python/nnUNet_results/Dataset219_PETCT/nnUNetTrainer_1500epochs_NoMirroring__nnUNetPlans__3d_fullres/crossval_results_folds_0_1_2_3_4/PETCT_d0086487f4_04102003.nii.gz,/well/papiez/users/hri611/python/nnUnet_raw/Dataset219_PETCT/labelsTr/PETCT_d0086487f4_04102003.nii.gz,0.0,0.0373230628967285,0.0,2,0
735,735,0.0,0,75,0.0,45439925,0,75,0,/well/papiez/users/hri611/python/nnUNet_results/Dataset219_PETCT/nnUNetTrainer_1500epochs_NoMirroring__nnUNetPlans__3d_fullres/crossval_results_folds_0_1_2_3_4/PETCT_d098458d29_08012003.nii.gz,/well/papiez/users/hri611/python/nnUnet_raw/Dataset219_PETCT/labelsTr/PETCT_d098458d29_08012003.nii.gz,0.0,0.9330765724182128,0.0,3,0
736,736,0.0,0,42,0.0,58879958,0,42,0,/well/papiez/users/hri611/python/nnUNet_results/Dataset219_PETCT/nnUNetTrainer_1500epochs_NoMirroring__nnUNetPlans__3d_fullres/crossval_results_folds_0_1_2_3_4/PETCT_d0ea6c975f_10112002.nii.gz,/well/papiez/users/hri611/python/nnUnet_raw/Dataset219_PETCT/labelsTr/PETCT_d0ea6c975f_10112002.nii.gz,0.0,0.5225228805541993,0.0,1,0
737,737,0.0,0,343,0.0,52159657,0,343,0,/well/papiez/users/hri611/python/nnUNet_results/Dataset219_PETCT/nnUNetTrainer_1500epochs_NoMirroring__nnUNetPlans__3d_fullres/crossval_results_folds_0_1_2_3_4/PETCT_d103e57f0e_12122002.nii.gz,/well/papiez/users/hri611/python/nnUnet_raw/Dataset219_PETCT/labelsTr/PETCT_d103e57f0e_12122002.nii.gz,0.0,4.267270191192627,0.0,3,0
738,738,0.2307692307692307,3640,0,0.1304347826086956,52155814,546,546,4186,/well/papiez/users/hri611/python/nnUNet_results/Dataset219_PETCT/nnUNetTrainer_1500epochs_NoMirroring__nnUNetPlans__3d_fullres/crossval_results_folds_0_1_2_3_4/PETCT_d1c8141930_06142002.nii.gz,/well/papiez/users/hri611/python/nnUnet_raw/Dataset219_PETCT/labelsTr/PETCT_d1c8141930_06142002.nii.gz,0.2307692307692307,0.0,21.000443389892578,2,6
739,739,,0,0,,49920000,0,0,0,/well/papiez/users/hri611/python/nnUNet_results/Dataset219_PETCT/nnUNetTrainer_1500epochs_NoMirroring__nnUNetPlans__3d_fullres/crossval_results_folds_0_1_2_3_4/PETCT_d1f456d229_09012006.nii.gz,/well/papiez/users/hri611/python/nnUnet_raw/Dataset219_PETCT/labelsTr/PETCT_d1f456d229_09012006.nii.gz,,0.0,0.0,0,0
740,740,0.7018951634989319,6821,14949,0.5407076098651871,46672601,25629,40578,32450,/well/papiez/users/hri611/python/nnUNet_results/Dataset219_PETCT/nnUNetTrainer_1500epochs_NoMirroring__nnUNetPlans__3d_fullres/crossval_results_folds_0_1_2_3_4/PETCT_d206b891ee_10272005.nii.gz,/well/papiez/users/hri611/python/nnUnet_raw/Dataset219_PETCT/labelsTr/PETCT_d206b891ee_10272005.nii.gz,0.7018951634989319,96.30594329452516,6.85500255203247,56,61
741,741,0.0,0,305,0.0,92319695,0,305,0,/well/papiez/users/hri611/python/nnUNet_results/Dataset219_PETCT/nnUNetTrainer_1500epochs_NoMirroring__nnUNetPlans__3d_fullres/crossval_results_folds_0_1_2_3_4/PETCT_d27451634d_03122005.nii.gz,/well/papiez/users/hri611/python/nnUnet_raw/Dataset219_PETCT/labelsTr/PETCT_d27451634d_03122005.nii.gz,0.0,3.794511394500733,0.0,3,0
742,742,0.0,0,9,0.0,52159991,0,9,0,/well/papiez/users/hri611/python/nnUNet_results/Dataset219_PETCT/nnUNetTrainer_1500epochs_NoMirroring__nnUNetPlans__3d_fullres/crossval_results_folds_0_1_2_3_4/PETCT_d31a5688a2_09212003.nii.gz,/well/papiez/users/hri611/python/nnUnet_raw/Dataset219_PETCT/labelsTr/PETCT_d31a5688a2_09212003.nii.gz,0.0,0.1119691886901855,0.0,5,0
743,743,0.835243735763098,659,17423,0.7170974403905126,52096084,45834,63257,46493,/well/papiez/users/hri611/python/nnUNet_results/Dataset219_PETCT/nnUNetTrainer_1500epochs_NoMirroring__nnUNetPlans__3d_fullres/crossval_results_folds_0_1_2_3_4/PETCT_d31c9ebd93_07212003.nii.gz,/well/papiez/users/hri611/python/nnUnet_raw/Dataset219_PETCT/labelsTr/PETCT_d31c9ebd93_07212003.nii.gz,0.835243735763098,1.3685123062133788,0.721579216003418,8,21
744,744,0.0,0,3,0.0,45439997,0,3,0,/well/papiez/users/hri611/python/nnUNet_results/Dataset219_PETCT/nnUNetTrainer_1500epochs_NoMirroring__nnUNetPlans__3d_fullres/crossval_results_folds_0_1_2_3_4/PETCT_d3208ff062_03142003.nii.gz,/well/papiez/users/hri611/python/nnUnet_raw/Dataset219_PETCT/labelsTr/PETCT_d3208ff062_03142003.nii.gz,0.0,0.0373230628967285,0.0,1,0
745,745,0.0,0,287,0.0,51679713,0,287,0,/well/papiez/users/hri611/python/nnUNet_results/Dataset219_PETCT/nnUNetTrainer_1500epochs_NoMirroring__nnUNetPlans__3d_fullres/crossval_results_folds_0_1_2_3_4/PETCT_d325897ff4_05102007.nii.gz,/well/papiez/users/hri611/python/nnUnet_raw/Dataset219_PETCT/labelsTr/PETCT_d325897ff4_05102007.nii.gz,0.0,3.570573017120361,0.0,1,0
746,746,,0,0,,52480000,0,0,0,/well/papiez/users/hri611/python/nnUNet_results/Dataset219_PETCT/nnUNetTrainer_1500epochs_NoMirroring__nnUNetPlans__3d_fullres/crossval_results_folds_0_1_2_3_4/PETCT_d325897ff4_07152005.nii.gz,/well/papiez/users/hri611/python/nnUnet_raw/Dataset219_PETCT/labelsTr/PETCT_d325897ff4_07152005.nii.gz,,0.0,0.0,0,0
747,747,0.0,0,36,0.0,50879964,0,36,0,/well/papiez/users/hri611/python/nnUNet_results/Dataset219_PETCT/nnUNetTrainer_1500epochs_NoMirroring__nnUNetPlans__3d_fullres/crossval_results_folds_0_1_2_3_4/PETCT_d325897ff4_11122005.nii.gz,/well/papiez/users/hri611/python/nnUnet_raw/Dataset219_PETCT/labelsTr/PETCT_d325897ff4_11122005.nii.gz,0.0,0.4478767547607422,0.0,1,0
748,748,0.0,0,18,0.0,52159982,0,18,0,/well/papiez/users/hri611/python/nnUNet_results/Dataset219_PETCT/nnUNetTrainer_1500epochs_NoMirroring__nnUNetPlans__3d_fullres/crossval_results_folds_0_1_2_3_4/PETCT_d32cf972af_03132003.nii.gz,/well/papiez/users/hri611/python/nnUnet_raw/Dataset219_PETCT/labelsTr/PETCT_d32cf972af_03132003.nii.gz,0.0,0.2239383773803711,0.0,2,0
749,749,0.4651257096512571,2626,12,0.3030383091149273,45436215,1147,1159,3773,/well/papiez/users/hri611/python/nnUNet_results/Dataset219_PETCT/nnUNetTrainer_1500epochs_NoMirroring__nnUNetPlans__3d_fullres/crossval_results_folds_0_1_2_3_4/PETCT_d393ab6c7b_09222002.nii.gz,/well/papiez/users/hri611/python/nnUnet_raw/Dataset219_PETCT/labelsTr/PETCT_d393ab6c7b_09222002.nii.gz,0.4651257096512571,0.0,27.905210025787355,1,2
750,750,0.0,0,1,0.0,48479999,0,1,0,/well/papiez/users/hri611/python/nnUNet_results/Dataset219_PETCT/nnUNetTrainer_1500epochs_NoMirroring__nnUNetPlans__3d_fullres/crossval_results_folds_0_1_2_3_4/PETCT_d3d3b7d4ff_08312006.nii.gz,/well/papiez/users/hri611/python/nnUnet_raw/Dataset219_PETCT/labelsTr/PETCT_d3d3b7d4ff_08312006.nii.gz,0.0,0.0124410209655761,0.0,1,0
751,751,0.8680139656973929,3015,2164,0.7668062497185826,52137791,17030,19194,20045,/well/papiez/users/hri611/python/nnUNet_results/Dataset219_PETCT/nnUNetTrainer_1500epochs_NoMirroring__nnUNetPlans__3d_fullres/crossval_results_folds_0_1_2_3_4/PETCT_d3d61785e6_10192001.nii.gz,/well/papiez/users/hri611/python/nnUnet_raw/Dataset219_PETCT/labelsTr/PETCT_d3d61785e6_10192001.nii.gz,0.8680139656973929,0.2861434822082519,19.880751502990723,10,7
752,752,0.9342040587037428,1772,2913,0.8765318223744893,72122055,33260,36173,35032,/well/papiez/users/hri611/python/nnUNet_results/Dataset219_PETCT/nnUNetTrainer_1500epochs_NoMirroring__nnUNetPlans__3d_fullres/crossval_results_folds_0_1_2_3_4/PETCT_d3dac0d1cd_08092003.nii.gz,/well/papiez/users/hri611/python/nnUnet_raw/Dataset219_PETCT/labelsTr/PETCT_d3dac0d1cd_08092003.nii.gz,0.9342040587037428,0.149292251586914,0.0124410209655761,6,5
753,753,,0,0,,45440000,0,0,0,/well/papiez/users/hri611/python/nnUNet_results/Dataset219_PETCT/nnUNetTrainer_1500epochs_NoMirroring__nnUNetPlans__3d_fullres/crossval_results_folds_0_1_2_3_4/PETCT_d3f13dff4b_08242003.nii.gz,/well/papiez/users/hri611/python/nnUnet_raw/Dataset219_PETCT/labelsTr/PETCT_d3f13dff4b_08242003.nii.gz,,0.0,0.0,0,0
754,754,0.9022915163957166,699,1062,0.8219773554387384,52150108,8131,9193,8830,/well/papiez/users/hri611/python/nnUNet_results/Dataset219_PETCT/nnUNetTrainer_1500epochs_NoMirroring__nnUNetPlans__3d_fullres/crossval_results_folds_0_1_2_3_4/PETCT_d40a16781a_09132003.nii.gz,/well/papiez/users/hri611/python/nnUnet_raw/Dataset219_PETCT/labelsTr/PETCT_d40a16781a_09132003.nii.gz,0.9022915163957166,0.5100818595886231,0.0124410209655761,9,6
755,755,0.7507132819486437,8872,2836,0.6009135221733647,45410663,17629,20465,26501,/well/papiez/users/hri611/python/nnUNet_results/Dataset219_PETCT/nnUNetTrainer_1500epochs_NoMirroring__nnUNetPlans__3d_fullres/crossval_results_folds_0_1_2_3_4/PETCT_d4112bc7ba_01292001.nii.gz,/well/papiez/users/hri611/python/nnUnet_raw/Dataset219_PETCT/labelsTr/PETCT_d4112bc7ba_01292001.nii.gz,0.7507132819486437,10.002580856323242,8.559422424316406,18,19
756,756,0.7870353073043154,3858,702,0.6488526105036193,52147014,8426,9128,12284,/well/papiez/users/hri611/python/nnUNet_results/Dataset219_PETCT/nnUNetTrainer_1500epochs_NoMirroring__nnUNetPlans__3d_fullres/crossval_results_folds_0_1_2_3_4/PETCT_d46f0109f8_09092000.nii.gz,/well/papiez/users/hri611/python/nnUnet_raw/Dataset219_PETCT/labelsTr/PETCT_d46f0109f8_09092000.nii.gz,0.7870353073043154,2.537968276977539,16.758055240631105,11,10
757,757,0.0,0,149,0.0,45439851,0,149,0,/well/papiez/users/hri611/python/nnUNet_results/Dataset219_PETCT/nnUNetTrainer_1500epochs_NoMirroring__nnUNetPlans__3d_fullres/crossval_results_folds_0_1_2_3_4/PETCT_d472033d3b_09282002.nii.gz,/well/papiez/users/hri611/python/nnUnet_raw/Dataset219_PETCT/labelsTr/PETCT_d472033d3b_09282002.nii.gz,0.0,1.8537121238708496,0.0,5,0
758,758,,0,0,,50080000,0,0,0,/well/papiez/users/hri611/python/nnUNet_results/Dataset219_PETCT/nnUNetTrainer_1500epochs_NoMirroring__nnUNetPlans__3d_fullres/crossval_results_folds_0_1_2_3_4/PETCT_d4a08e4bde_03162006.nii.gz,/well/papiez/users/hri611/python/nnUnet_raw/Dataset219_PETCT/labelsTr/PETCT_d4a08e4bde_03162006.nii.gz,,0.0,0.0,0,0
759,759,0.6837688346366584,62161,4159,0.5194899289957977,45301980,71700,75859,133861,/well/papiez/users/hri611/python/nnUNet_results/Dataset219_PETCT/nnUNetTrainer_1500epochs_NoMirroring__nnUNetPlans__3d_fullres/crossval_results_folds_0_1_2_3_4/PETCT_d4b2ff9721_12162001.nii.gz,/well/papiez/users/hri611/python/nnUnet_raw/Dataset219_PETCT/labelsTr/PETCT_d4b2ff9721_12162001.nii.gz,0.6837688346366584,0.8335484046936035,135.24633891677857,51,65
760,760,0.0,0,174,0.0,49759826,0,174,0,/well/papiez/users/hri611/python/nnUNet_results/Dataset219_PETCT/nnUNetTrainer_1500epochs_NoMirroring__nnUNetPlans__3d_fullres/crossval_results_folds_0_1_2_3_4/PETCT_d4d3d7dfc1_09122005.nii.gz,/well/papiez/users/hri611/python/nnUnet_raw/Dataset219_PETCT/labelsTr/PETCT_d4d3d7dfc1_09122005.nii.gz,0.0,2.164737648010254,0.0,1,0
761,761,0.5343222344958182,1780,4122,0.3645564168819983,91830712,3386,7508,5166,/well/papiez/users/hri611/python/nnUNet_results/Dataset219_PETCT/nnUNetTrainer_1500epochs_NoMirroring__nnUNetPlans__3d_fullres/crossval_results_folds_0_1_2_3_4/PETCT_d4f3375362_05272005.nii.gz,/well/papiez/users/hri611/python/nnUnet_raw/Dataset219_PETCT/labelsTr/PETCT_d4f3375362_05272005.nii.gz,0.5343222344958182,47.11414639663696,4.1553010025024415,25,16
762,762,0.8946553059643687,1130,1046,0.8093903293622985,75188584,9240,10286,10370,/well/papiez/users/hri611/python/nnUNet_results/Dataset219_PETCT/nnUNetTrainer_1500epochs_NoMirroring__nnUNetPlans__3d_fullres/crossval_results_folds_0_1_2_3_4/PETCT_d5103c8fbf_04142006.nii.gz,/well/papiez/users/hri611/python/nnUnet_raw/Dataset219_PETCT/labelsTr/PETCT_d5103c8fbf_04142006.nii.gz,0.8946553059643687,2.4384401092529298,0.0,9,5
763,763,0.9166831781256192,486,1196,0.8461819844535894,45429065,9253,10449,9739,/well/papiez/users/hri611/python/nnUNet_results/Dataset219_PETCT/nnUNetTrainer_1500epochs_NoMirroring__nnUNetPlans__3d_fullres/crossval_results_folds_0_1_2_3_4/PETCT_d51664a9e4_11052004.nii.gz,/well/papiez/users/hri611/python/nnUnet_raw/Dataset219_PETCT/labelsTr/PETCT_d51664a9e4_11052004.nii.gz,0.9166831781256192,2.01544539642334,0.0,6,6
764,764,0.8814961745536979,1846,245,0.7881029590595865,45430132,7777,8022,9623,/well/papiez/users/hri611/python/nnUNet_results/Dataset219_PETCT/nnUNetTrainer_1500epochs_NoMirroring__nnUNetPlans__3d_fullres/crossval_results_folds_0_1_2_3_4/PETCT_d51bacdaba_06282001.nii.gz,/well/papiez/users/hri611/python/nnUnet_raw/Dataset219_PETCT/labelsTr/PETCT_d51bacdaba_06282001.nii.gz,0.8814961745536979,0.4603177757263184,0.0124410209655761,4,3
765,765,0.0,0,13,0.0,85599987,0,13,0,/well/papiez/users/hri611/python/nnUNet_results/Dataset219_PETCT/nnUNetTrainer_1500epochs_NoMirroring__nnUNetPlans__3d_fullres/crossval_results_folds_0_1_2_3_4/PETCT_d539f5a88b_06232003.nii.gz,/well/papiez/users/hri611/python/nnUnet_raw/Dataset219_PETCT/labelsTr/PETCT_d539f5a88b_06232003.nii.gz,0.0,0.1617332725524902,0.0,2,0
766,766,0.0,0,37,0.0,72159963,0,37,0,/well/papiez/users/hri611/python/nnUNet_results/Dataset219_PETCT/nnUNetTrainer_1500epochs_NoMirroring__nnUNetPlans__3d_fullres/crossval_results_folds_0_1_2_3_4/PETCT_d5e2aa7feb_04172003.nii.gz,/well/papiez/users/hri611/python/nnUnet_raw/Dataset219_PETCT/labelsTr/PETCT_d5e2aa7feb_04172003.nii.gz,0.0,0.4603177757263184,0.0,5,0
767,767,0.0,0,310,0.0,58879690,0,310,0,/well/papiez/users/hri611/python/nnUNet_results/Dataset219_PETCT/nnUNetTrainer_1500epochs_NoMirroring__nnUNetPlans__3d_fullres/crossval_results_folds_0_1_2_3_4/PETCT_d626611daf_04032003.nii.gz,/well/papiez/users/hri611/python/nnUnet_raw/Dataset219_PETCT/labelsTr/PETCT_d626611daf_04032003.nii.gz,0.0,3.856716499328613,0.0,4,0
768,768,0.0,0,31,0.0,55359969,0,31,0,/well/papiez/users/hri611/python/nnUNet_results/Dataset219_PETCT/nnUNetTrainer_1500epochs_NoMirroring__nnUNetPlans__3d_fullres/crossval_results_folds_0_1_2_3_4/PETCT_d626611daf_06192005.nii.gz,/well/papiez/users/hri611/python/nnUnet_raw/Dataset219_PETCT/labelsTr/PETCT_d626611daf_06192005.nii.gz,0.0,0.3856716499328613,0.0,1,0
769,769,,0,0,,58880000,0,0,0,/well/papiez/users/hri611/python/nnUNet_results/Dataset219_PETCT/nnUNetTrainer_1500epochs_NoMirroring__nnUNetPlans__3d_fullres/crossval_results_folds_0_1_2_3_4/PETCT_d626611daf_10022003.nii.gz,/well/papiez/users/hri611/python/nnUnet_raw/Dataset219_PETCT/labelsTr/PETCT_d626611daf_10022003.nii.gz,,0.0,0.0,0,0
770,770,0.0,0,16,0.0,58879984,0,16,0,/well/papiez/users/hri611/python/nnUNet_results/Dataset219_PETCT/nnUNetTrainer_1500epochs_NoMirroring__nnUNetPlans__3d_fullres/crossval_results_folds_0_1_2_3_4/PETCT_d626611daf_11122004.nii.gz,/well/papiez/users/hri611/python/nnUnet_raw/Dataset219_PETCT/labelsTr/PETCT_d626611daf_11122004.nii.gz,0.0,0.1990563354492187,0.0,1,0
771,771,0.5280365993137629,30887,62,0.3587294351663835,105711738,17313,17375,48200,/well/papiez/users/hri611/python/nnUNet_results/Dataset219_PETCT/nnUNetTrainer_1500epochs_NoMirroring__nnUNetPlans__3d_fullres/crossval_results_folds_0_1_2_3_4/PETCT_d626611daf_11292002.nii.gz,/well/papiez/users/hri611/python/nnUnet_raw/Dataset219_PETCT/labelsTr/PETCT_d626611daf_11292002.nii.gz,0.5280365993137629,0.0,0.0373230628967285,2,3
772,772,0.8227363260303355,78,1079,0.6988547631441957,73116158,2685,3764,2763,/well/papiez/users/hri611/python/nnUNet_results/Dataset219_PETCT/nnUNetTrainer_1500epochs_NoMirroring__nnUNetPlans__3d_fullres/crossval_results_folds_0_1_2_3_4/PETCT_d63f6162a6_07082005.nii.gz,/well/papiez/users/hri611/python/nnUnet_raw/Dataset219_PETCT/labelsTr/PETCT_d63f6162a6_07082005.nii.gz,0.8227363260303355,0.4105536918640137,0.0248820419311523,14,14
773,773,0.0,0,11,0.0,45439989,0,11,0,/well/papiez/users/hri611/python/nnUNet_results/Dataset219_PETCT/nnUNetTrainer_1500epochs_NoMirroring__nnUNetPlans__3d_fullres/crossval_results_folds_0_1_2_3_4/PETCT_d64d6a87c8_12182004.nii.gz,/well/papiez/users/hri611/python/nnUnet_raw/Dataset219_PETCT/labelsTr/PETCT_d64d6a87c8_12182004.nii.gz,0.0,0.1368512306213379,0.0,1,0
774,774,0.8298755186721992,0,41,0.7092198581560284,52479859,100,141,100,/well/papiez/users/hri611/python/nnUNet_results/Dataset219_PETCT/nnUNetTrainer_1500epochs_NoMirroring__nnUNetPlans__3d_fullres/crossval_results_folds_0_1_2_3_4/PETCT_d65cf203be_04282007.nii.gz,/well/papiez/users/hri611/python/nnUnet_raw/Dataset219_PETCT/labelsTr/PETCT_d65cf203be_04282007.nii.gz,0.8298755186721992,0.0,0.0,1,1
775,775,0.8370044052863436,14,23,0.7196969696969697,45439868,95,118,109,/well/papiez/users/hri611/python/nnUNet_results/Dataset219_PETCT/nnUNetTrainer_1500epochs_NoMirroring__nnUNetPlans__3d_fullres/crossval_results_folds_0_1_2_3_4/PETCT_d674a028b1_12032001.nii.gz,/well/papiez/users/hri611/python/nnUnet_raw/Dataset219_PETCT/labelsTr/PETCT_d674a028b1_12032001.nii.gz,0.8370044052863436,0.0,0.0,1,1
776,776,0.8058977230309817,221,819,0.6748984057517975,52156801,2159,2978,2380,/well/papiez/users/hri611/python/nnUNet_results/Dataset219_PETCT/nnUNetTrainer_1500epochs_NoMirroring__nnUNetPlans__3d_fullres/crossval_results_folds_0_1_2_3_4/PETCT_d69c3fceba_04052003.nii.gz,/well/papiez/users/hri611/python/nnUnet_raw/Dataset219_PETCT/labelsTr/PETCT_d69c3fceba_04052003.nii.gz,0.8058977230309817,1.505363536834717,2.687260528564453,13,10
777,777,0.628136116095319,11197,616,0.4578705828361634,45418210,9977,10593,21174,/well/papiez/users/hri611/python/nnUNet_results/Dataset219_PETCT/nnUNetTrainer_1500epochs_NoMirroring__nnUNetPlans__3d_fullres/crossval_results_folds_0_1_2_3_4/PETCT_d69eabbb20_02012001.nii.gz,/well/papiez/users/hri611/python/nnUnet_raw/Dataset219_PETCT/labelsTr/PETCT_d69eabbb20_02012001.nii.gz,0.628136116095319,5.760192707061767,55.7606559677124,5,9
778,778,,0,0,,58880000,0,0,0,/well/papiez/users/hri611/python/nnUNet_results/Dataset219_PETCT/nnUNetTrainer_1500epochs_NoMirroring__nnUNetPlans__3d_fullres/crossval_results_folds_0_1_2_3_4/PETCT_d6a48a629d_03062003.nii.gz,/well/papiez/users/hri611/python/nnUnet_raw/Dataset219_PETCT/labelsTr/PETCT_d6a48a629d_03062003.nii.gz,,0.0,0.0,0,0
779,779,0.0,0,1,0.0,52159999,0,1,0,/well/papiez/users/hri611/python/nnUNet_results/Dataset219_PETCT/nnUNetTrainer_1500epochs_NoMirroring__nnUNetPlans__3d_fullres/crossval_results_folds_0_1_2_3_4/PETCT_d6a48a629d_07272002.nii.gz,/well/papiez/users/hri611/python/nnUnet_raw/Dataset219_PETCT/labelsTr/PETCT_d6a48a629d_07272002.nii.gz,0.0,0.0124410209655761,0.0,1,0
780,780,0.0,0,1779,0.0,99038221,0,1779,0,/well/papiez/users/hri611/python/nnUNet_results/Dataset219_PETCT/nnUNetTrainer_1500epochs_NoMirroring__nnUNetPlans__3d_fullres/crossval_results_folds_0_1_2_3_4/PETCT_d6a491e16d_05302003.nii.gz,/well/papiez/users/hri611/python/nnUnet_raw/Dataset219_PETCT/labelsTr/PETCT_d6a491e16d_05302003.nii.gz,0.0,22.13257629776001,0.0,10,0
781,781,0.0,0,1,0.0,45439999,0,1,0,/well/papiez/users/hri611/python/nnUNet_results/Dataset219_PETCT/nnUNetTrainer_1500epochs_NoMirroring__nnUNetPlans__3d_fullres/crossval_results_folds_0_1_2_3_4/PETCT_d6b2218bf3_12182004.nii.gz,/well/papiez/users/hri611/python/nnUnet_raw/Dataset219_PETCT/labelsTr/PETCT_d6b2218bf3_12182004.nii.gz,0.0,0.0124410209655761,0.0,1,0
782,782,0.2651162790697674,1104,160,0.1528150134048257,54078508,228,388,1332,/well/papiez/users/hri611/python/nnUNet_results/Dataset219_PETCT/nnUNetTrainer_1500epochs_NoMirroring__nnUNetPlans__3d_fullres/crossval_results_folds_0_1_2_3_4/PETCT_d6de1252d9_05132007.nii.gz,/well/papiez/users/hri611/python/nnUnet_raw/Dataset219_PETCT/labelsTr/PETCT_d6de1252d9_05132007.nii.gz,0.2651162790697674,1.965681312561035,12.93866180419922,2,2
783,783,0.4378283712784588,709,1217,0.2802690582959641,47837324,750,1967,1459,/well/papiez/users/hri611/python/nnUNet_results/Dataset219_PETCT/nnUNetTrainer_1500epochs_NoMirroring__nnUNetPlans__3d_fullres/crossval_results_folds_0_1_2_3_4/PETCT_d8a92bafe3_03182007.nii.gz,/well/papiez/users/hri611/python/nnUnet_raw/Dataset219_PETCT/labelsTr/PETCT_d8a92bafe3_03182007.nii.gz,0.4378283712784588,9.504940017700196,7.178469097137451,17,19
784,784,0.68860484090291,35,1110,0.5250933222729158,92317589,1266,2376,1301,/well/papiez/users/hri611/python/nnUNet_results/Dataset219_PETCT/nnUNetTrainer_1500epochs_NoMirroring__nnUNetPlans__3d_fullres/crossval_results_folds_0_1_2_3_4/PETCT_d8d9e52cd5_03132005.nii.gz,/well/papiez/users/hri611/python/nnUnet_raw/Dataset219_PETCT/labelsTr/PETCT_d8d9e52cd5_03132005.nii.gz,0.68860484090291,4.478767547607422,0.0124410209655761,9,7
785,785,0.8333198150701597,151,1904,0.714265850945495,100472808,5137,7041,5288,/well/papiez/users/hri611/python/nnUNet_results/Dataset219_PETCT/nnUNetTrainer_1500epochs_NoMirroring__nnUNetPlans__3d_fullres/crossval_results_folds_0_1_2_3_4/PETCT_d8d9e52cd5_05072007.nii.gz,/well/papiez/users/hri611/python/nnUnet_raw/Dataset219_PETCT/labelsTr/PETCT_d8d9e52cd5_05072007.nii.gz,0.8333198150701597,2.9236399269104005,0.0,17,10
786,786,0.7535211267605634,252,658,0.6045197740112994,92317699,1391,2049,1643,/well/papiez/users/hri611/python/nnUNet_results/Dataset219_PETCT/nnUNetTrainer_1500epochs_NoMirroring__nnUNetPlans__3d_fullres/crossval_results_folds_0_1_2_3_4/PETCT_d8d9e52cd5_07042004.nii.gz,/well/papiez/users/hri611/python/nnUnet_raw/Dataset219_PETCT/labelsTr/PETCT_d8d9e52cd5_07042004.nii.gz,0.7535211267605634,4.19262406539917,0.7837843208312988,14,10
787,787,0.3786931818181818,7383,1365,0.2335728053267916,94068586,2666,4031,10049,/well/papiez/users/hri611/python/nnUNet_results/Dataset219_PETCT/nnUNetTrainer_1500epochs_NoMirroring__nnUNetPlans__3d_fullres/crossval_results_folds_0_1_2_3_4/PETCT_d8d9e52cd5_10072005.nii.gz,/well/papiez/users/hri611/python/nnUnet_raw/Dataset219_PETCT/labelsTr/PETCT_d8d9e52cd5_10072005.nii.gz,0.3786931818181818,8.497217319488525,18.636649406433104,21,14
788,788,0.0,0,407,0.0,52159593,0,407,0,/well/papiez/users/hri611/python/nnUNet_results/Dataset219_PETCT/nnUNetTrainer_1500epochs_NoMirroring__nnUNetPlans__3d_fullres/crossval_results_folds_0_1_2_3_4/PETCT_d8e3aa97a0_05192005.nii.gz,/well/papiez/users/hri611/python/nnUnet_raw/Dataset219_PETCT/labelsTr/PETCT_d8e3aa97a0_05192005.nii.gz,0.0,5.063495532989502,0.0,5,0
789,789,0.9037131968567672,2520,335,0.8243401218236633,45423747,13398,13733,15918,/well/papiez/users/hri611/python/nnUNet_results/Dataset219_PETCT/nnUNetTrainer_1500epochs_NoMirroring__nnUNetPlans__3d_fullres/crossval_results_folds_0_1_2_3_4/PETCT_d951eeb735_01232003.nii.gz,/well/papiez/users/hri611/python/nnUnet_raw/Dataset219_PETCT/labelsTr/PETCT_d951eeb735_01232003.nii.gz,0.9037131968567672,2.5006452140808104,0.6842561531066894,2,3
790,790,0.777045926193269,2245,226,0.6353843883724362,99033223,4306,4532,6551,/well/papiez/users/hri611/python/nnUNet_results/Dataset219_PETCT/nnUNetTrainer_1500epochs_NoMirroring__nnUNetPlans__3d_fullres/crossval_results_folds_0_1_2_3_4/PETCT_d9da6129f8_04142002.nii.gz,/well/papiez/users/hri611/python/nnUnet_raw/Dataset219_PETCT/labelsTr/PETCT_d9da6129f8_04142002.nii.gz,0.777045926193269,2.60017338180542,1.1943380126953125,10,7
791,791,0.0,0,87,0.0,52159913,0,87,0,/well/papiez/users/hri611/python/nnUNet_results/Dataset219_PETCT/nnUNetTrainer_1500epochs_NoMirroring__nnUNetPlans__3d_fullres/crossval_results_folds_0_1_2_3_4/PETCT_da4ce0da01_06132003.nii.gz,/well/papiez/users/hri611/python/nnUnet_raw/Dataset219_PETCT/labelsTr/PETCT_da4ce0da01_06132003.nii.gz,0.0,1.082368824005127,0.0,3,0
792,792,0.8002364066193853,348,666,0.6669950738916256,45436955,2031,2697,2379,/well/papiez/users/hri611/python/nnUNet_results/Dataset219_PETCT/nnUNetTrainer_1500epochs_NoMirroring__nnUNetPlans__3d_fullres/crossval_results_folds_0_1_2_3_4/PETCT_da6161d7eb_06202003.nii.gz,/well/papiez/users/hri611/python/nnUnet_raw/Dataset219_PETCT/labelsTr/PETCT_da6161d7eb_06202003.nii.gz,0.8002364066193853,0.8833124885559082,1.517804557800293,11,8
793,793,0.8085252327290544,6613,1203,0.6785919894728185,52135682,16502,17705,23115,/well/papiez/users/hri611/python/nnUNet_results/Dataset219_PETCT/nnUNetTrainer_1500epochs_NoMirroring__nnUNetPlans__3d_fullres/crossval_results_folds_0_1_2_3_4/PETCT_dac5cd2a4d_12022001.nii.gz,/well/papiez/users/hri611/python/nnUnet_raw/Dataset219_PETCT/labelsTr/PETCT_dac5cd2a4d_12022001.nii.gz,0.8085252327290544,0.0,6.966971740722656,22,36
794,794,0.2545454545454545,73,9,0.1458333333333333,99039904,14,23,87,/well/papiez/users/hri611/python/nnUNet_results/Dataset219_PETCT/nnUNetTrainer_1500epochs_NoMirroring__nnUNetPlans__3d_fullres/crossval_results_folds_0_1_2_3_4/PETCT_dadcd69ba9_05192005.nii.gz,/well/papiez/users/hri611/python/nnUnet_raw/Dataset219_PETCT/labelsTr/PETCT_dadcd69ba9_05192005.nii.gz,0.2545454545454545,0.1119691886901855,0.0,2,1
795,795,0.0,0,6934,0.0,52153066,0,6934,0,/well/papiez/users/hri611/python/nnUNet_results/Dataset219_PETCT/nnUNetTrainer_1500epochs_NoMirroring__nnUNetPlans__3d_fullres/crossval_results_folds_0_1_2_3_4/PETCT_dae86b88e2_06212003.nii.gz,/well/papiez/users/hri611/python/nnUnet_raw/Dataset219_PETCT/labelsTr/PETCT_dae86b88e2_06212003.nii.gz,0.0,86.26603937530517,0.0,4,0
796,796,0.0,0,288,0.0,51039712,0,288,0,/well/papiez/users/hri611/python/nnUNet_results/Dataset219_PETCT/nnUNetTrainer_1500epochs_NoMirroring__nnUNetPlans__3d_fullres/crossval_results_folds_0_1_2_3_4/PETCT_db3bac356a_08212005.nii.gz,/well/papiez/users/hri611/python/nnUnet_raw/Dataset219_PETCT/labelsTr/PETCT_db3bac356a_08212005.nii.gz,0.0,3.583014038085937,0.0,6,0
797,797,0.9217283268912204,574,560,0.8548201254640891,52152189,6677,7237,7251,/well/papiez/users/hri611/python/nnUNet_results/Dataset219_PETCT/nnUNetTrainer_1500epochs_NoMirroring__nnUNetPlans__3d_fullres/crossval_results_folds_0_1_2_3_4/PETCT_db3daf78d2_10302000.nii.gz,/well/papiez/users/hri611/python/nnUnet_raw/Dataset219_PETCT/labelsTr/PETCT_db3daf78d2_10302000.nii.gz,0.9217283268912204,0.6593741111755371,0.0,11,9
798,798,,0,0,,48000000,0,0,0,/well/papiez/users/hri611/python/nnUNet_results/Dataset219_PETCT/nnUNetTrainer_1500epochs_NoMirroring__nnUNetPlans__3d_fullres/crossval_results_folds_0_1_2_3_4/PETCT_dc15c1d9bb_06032005.nii.gz,/well/papiez/users/hri611/python/nnUnet_raw/Dataset219_PETCT/labelsTr/PETCT_dc15c1d9bb_06032005.nii.gz,,0.0,0.0,0,0
799,799,0.8088318594300907,663,15874,0.6790240872653869,45388479,34984,50858,35647,/well/papiez/users/hri611/python/nnUNet_results/Dataset219_PETCT/nnUNetTrainer_1500epochs_NoMirroring__nnUNetPlans__3d_fullres/crossval_results_folds_0_1_2_3_4/PETCT_dc6174cb5d_03292003.nii.gz,/well/papiez/users/hri611/python/nnUnet_raw/Dataset219_PETCT/labelsTr/PETCT_dc6174cb5d_03292003.nii.gz,0.8088318594300907,3.782070373535156,6.942089698791504,33,42
800,800,0.8741142770993517,1186,2989,0.7763792179967863,45421330,14495,17484,15681,/well/papiez/users/hri611/python/nnUNet_results/Dataset219_PETCT/nnUNetTrainer_1500epochs_NoMirroring__nnUNetPlans__3d_fullres/crossval_results_folds_0_1_2_3_4/PETCT_dc6174cb5d_12152002.nii.gz,/well/papiez/users/hri611/python/nnUnet_raw/Dataset219_PETCT/labelsTr/PETCT_dc6174cb5d_12152002.nii.gz,0.8741142770993517,0.4105536918640137,0.5722869644165038,22,26
801,801,0.0,0,10,0.0,48159990,0,10,0,/well/papiez/users/hri611/python/nnUNet_results/Dataset219_PETCT/nnUNetTrainer_1500epochs_NoMirroring__nnUNetPlans__3d_fullres/crossval_results_folds_0_1_2_3_4/PETCT_dd6165ae36_06012006.nii.gz,/well/papiez/users/hri611/python/nnUnet_raw/Dataset219_PETCT/labelsTr/PETCT_dd6165ae36_06012006.nii.gz,0.0,0.1244102096557617,0.0,1,0
802,802,0.7602905569007264,276,21,0.61328125,45439232,471,492,747,/well/papiez/users/hri611/python/nnUNet_results/Dataset219_PETCT/nnUNetTrainer_1500epochs_NoMirroring__nnUNetPlans__3d_fullres/crossval_results_folds_0_1_2_3_4/PETCT_dd68a71e0a_11202004.nii.gz,/well/papiez/users/hri611/python/nnUnet_raw/Dataset219_PETCT/labelsTr/PETCT_dd68a71e0a_11202004.nii.gz,0.7602905569007264,0.1617332725524902,0.4105536918640137,5,2
803,803,0.0,0,17,0.0,47999983,0,17,0,/well/papiez/users/hri611/python/nnUNet_results/Dataset219_PETCT/nnUNetTrainer_1500epochs_NoMirroring__nnUNetPlans__3d_fullres/crossval_results_folds_0_1_2_3_4/PETCT_dd887591a9_05062006.nii.gz,/well/papiez/users/hri611/python/nnUnet_raw/Dataset219_PETCT/labelsTr/PETCT_dd887591a9_05062006.nii.gz,0.0,0.2114973564147949,0.0,2,0
804,804,0.6732194650338382,3106,950,0.5074083070196745,52151766,4178,5128,7284,/well/papiez/users/hri611/python/nnUNet_results/Dataset219_PETCT/nnUNetTrainer_1500epochs_NoMirroring__nnUNetPlans__3d_fullres/crossval_results_folds_0_1_2_3_4/PETCT_dd8f9f217c_02152004.nii.gz,/well/papiez/users/hri611/python/nnUnet_raw/Dataset219_PETCT/labelsTr/PETCT_dd8f9f217c_02152004.nii.gz,0.6732194650338382,9.75376043701172,6.655946216583252,13,8
805,805,0.8700561733348618,3055,1479,0.7699994927205397,45420287,15179,16658,18234,/well/papiez/users/hri611/python/nnUNet_results/Dataset219_PETCT/nnUNetTrainer_1500epochs_NoMirroring__nnUNetPlans__3d_fullres/crossval_results_folds_0_1_2_3_4/PETCT_dd975744e7_09232001.nii.gz,/well/papiez/users/hri611/python/nnUnet_raw/Dataset219_PETCT/labelsTr/PETCT_dd975744e7_09232001.nii.gz,0.8700561733348618,0.0,6.892325614929199,4,8
806,806,0.7480356374416269,2102,76943,0.5974895610550972,51963620,117335,194278,119437,/well/papiez/users/hri611/python/nnUNet_results/Dataset219_PETCT/nnUNetTrainer_1500epochs_NoMirroring__nnUNetPlans__3d_fullres/crossval_results_folds_0_1_2_3_4/PETCT_ddbb3c69f0_08112003.nii.gz,/well/papiez/users/hri611/python/nnUnet_raw/Dataset219_PETCT/labelsTr/PETCT_ddbb3c69f0_08112003.nii.gz,0.7480356374416269,131.153243019104,1.8537121238708496,104,74
807,807,0.0,1769,0,0.0,45438231,0,0,1769,/well/papiez/users/hri611/python/nnUNet_results/Dataset219_PETCT/nnUNetTrainer_1500epochs_NoMirroring__nnUNetPlans__3d_fullres/crossval_results_folds_0_1_2_3_4/PETCT_de118d7ab9_06022001.nii.gz,/well/papiez/users/hri611/python/nnUnet_raw/Dataset219_PETCT/labelsTr/PETCT_de118d7ab9_06022001.nii.gz,0.0,0.0,22.008166088104247,0,1
808,808,0.0,0,1,0.0,52159999,0,1,0,/well/papiez/users/hri611/python/nnUNet_results/Dataset219_PETCT/nnUNetTrainer_1500epochs_NoMirroring__nnUNetPlans__3d_fullres/crossval_results_folds_0_1_2_3_4/PETCT_dec9ff6a91_03032003.nii.gz,/well/papiez/users/hri611/python/nnUnet_raw/Dataset219_PETCT/labelsTr/PETCT_dec9ff6a91_03032003.nii.gz,0.0,0.0124410209655761,0.0,1,0
809,809,,0,0,,52160000,0,0,0,/well/papiez/users/hri611/python/nnUNet_results/Dataset219_PETCT/nnUNetTrainer_1500epochs_NoMirroring__nnUNetPlans__3d_fullres/crossval_results_folds_0_1_2_3_4/PETCT_df2e16771a_11142003.nii.gz,/well/papiez/users/hri611/python/nnUnet_raw/Dataset219_PETCT/labelsTr/PETCT_df2e16771a_11142003.nii.gz,,0.0,0.0,0,0
810,810,0.0,0,433,0.0,52159567,0,433,0,/well/papiez/users/hri611/python/nnUNet_results/Dataset219_PETCT/nnUNetTrainer_1500epochs_NoMirroring__nnUNetPlans__3d_fullres/crossval_results_folds_0_1_2_3_4/PETCT_e00c98b415_10192002.nii.gz,/well/papiez/users/hri611/python/nnUnet_raw/Dataset219_PETCT/labelsTr/PETCT_e00c98b415_10192002.nii.gz,0.0,5.3869620780944825,0.0,8,0
811,811,0.778096484310684,23841,1766,0.636790445661116,38649498,44895,46661,68736,/well/papiez/users/hri611/python/nnUNet_results/Dataset219_PETCT/nnUNetTrainer_1500epochs_NoMirroring__nnUNetPlans__3d_fullres/crossval_results_folds_0_1_2_3_4/PETCT_e03b96666f_05172001.nii.gz,/well/papiez/users/hri611/python/nnUnet_raw/Dataset219_PETCT/labelsTr/PETCT_e03b96666f_05172001.nii.gz,0.778096484310684,0.0124410209655761,39.64953381729126,102,132
812,812,0.8087649402390438,639,33,0.6789297658862876,52157907,1421,1454,2060,/well/papiez/users/hri611/python/nnUNet_results/Dataset219_PETCT/nnUNetTrainer_1500epochs_NoMirroring__nnUNetPlans__3d_fullres/crossval_results_folds_0_1_2_3_4/PETCT_e04b7fa860_06012002.nii.gz,/well/papiez/users/hri611/python/nnUnet_raw/Dataset219_PETCT/labelsTr/PETCT_e04b7fa860_06012002.nii.gz,0.8087649402390438,0.0,2.811670738220214,2,3
813,813,0.0,0,3,0.0,47359997,0,3,0,/well/papiez/users/hri611/python/nnUNet_results/Dataset219_PETCT/nnUNetTrainer_1500epochs_NoMirroring__nnUNetPlans__3d_fullres/crossval_results_folds_0_1_2_3_4/PETCT_e09a20d8fc_03162006.nii.gz,/well/papiez/users/hri611/python/nnUnet_raw/Dataset219_PETCT/labelsTr/PETCT_e09a20d8fc_03162006.nii.gz,0.0,0.0373230628967285,0.0,1,0
814,814,,0,0,,47360000,0,0,0,/well/papiez/users/hri611/python/nnUNet_results/Dataset219_PETCT/nnUNetTrainer_1500epochs_NoMirroring__nnUNetPlans__3d_fullres/crossval_results_folds_0_1_2_3_4/PETCT_e0a7ccecad_01282006.nii.gz,/well/papiez/users/hri611/python/nnUnet_raw/Dataset219_PETCT/labelsTr/PETCT_e0a7ccecad_01282006.nii.gz,,0.0,0.0,0,0
815,815,0.9451816510113812,975,128,0.8960610629476065,45429388,9509,9637,10484,/well/papiez/users/hri611/python/nnUNet_results/Dataset219_PETCT/nnUNetTrainer_1500epochs_NoMirroring__nnUNetPlans__3d_fullres/crossval_results_folds_0_1_2_3_4/PETCT_e0aa99fa04_08292003.nii.gz,/well/papiez/users/hri611/python/nnUnet_raw/Dataset219_PETCT/labelsTr/PETCT_e0aa99fa04_08292003.nii.gz,0.9451816510113812,0.0,0.0,3,3
816,816,0.0,0,12,0.0,45439988,0,12,0,/well/papiez/users/hri611/python/nnUNet_results/Dataset219_PETCT/nnUNetTrainer_1500epochs_NoMirroring__nnUNetPlans__3d_fullres/crossval_results_folds_0_1_2_3_4/PETCT_e0fdc6212a_05292003.nii.gz,/well/papiez/users/hri611/python/nnUnet_raw/Dataset219_PETCT/labelsTr/PETCT_e0fdc6212a_05292003.nii.gz,0.0,0.149292251586914,0.0,2,0
817,817,0.928110599078341,22,134,0.8658641444539983,51678837,1007,1141,1029,/well/papiez/users/hri611/python/nnUNet_results/Dataset219_PETCT/nnUNetTrainer_1500epochs_NoMirroring__nnUNetPlans__3d_fullres/crossval_results_folds_0_1_2_3_4/PETCT_e1a4145b63_03052006.nii.gz,/well/papiez/users/hri611/python/nnUnet_raw/Dataset219_PETCT/labelsTr/PETCT_e1a4145b63_03052006.nii.gz,0.928110599078341,1.0699278030395507,0.0,3,1
818,818,0.0,0,1434,0.0,45438566,0,1434,0,/well/papiez/users/hri611/python/nnUNet_results/Dataset219_PETCT/nnUNetTrainer_1500epochs_NoMirroring__nnUNetPlans__3d_fullres/crossval_results_folds_0_1_2_3_4/PETCT_e1a5b05186_02272005.nii.gz,/well/papiez/users/hri611/python/nnUnet_raw/Dataset219_PETCT/labelsTr/PETCT_e1a5b05186_02272005.nii.gz,0.0,17.84042406463623,0.0,6,0
819,819,,0,0,,38720000,0,0,0,/well/papiez/users/hri611/python/nnUNet_results/Dataset219_PETCT/nnUNetTrainer_1500epochs_NoMirroring__nnUNetPlans__3d_fullres/crossval_results_folds_0_1_2_3_4/PETCT_e207c7a1a4_12232005.nii.gz,/well/papiez/users/hri611/python/nnUnet_raw/Dataset219_PETCT/labelsTr/PETCT_e207c7a1a4_12232005.nii.gz,,0.0,0.0,0,0
820,820,0.5605566870332654,48452,3332,0.3894260246191576,52075188,33028,36360,81480,/well/papiez/users/hri611/python/nnUNet_results/Dataset219_PETCT/nnUNetTrainer_1500epochs_NoMirroring__nnUNetPlans__3d_fullres/crossval_results_folds_0_1_2_3_4/PETCT_e252be4334_07092004.nii.gz,/well/papiez/users/hri611/python/nnUnet_raw/Dataset219_PETCT/labelsTr/PETCT_e252be4334_07092004.nii.gz,0.5605566870332654,0.1741742935180664,6.021454147338867,23,58
821,821,0.759110269758637,2238,6924,0.6117467581998475,52136402,14436,21360,16674,/well/papiez/users/hri611/python/nnUNet_results/Dataset219_PETCT/nnUNetTrainer_1500epochs_NoMirroring__nnUNetPlans__3d_fullres/crossval_results_folds_0_1_2_3_4/PETCT_e2834e6f5c_06142002.nii.gz,/well/papiez/users/hri611/python/nnUnet_raw/Dataset219_PETCT/labelsTr/PETCT_e2834e6f5c_06142002.nii.gz,0.759110269758637,2.4384401092529298,3.6576601638793935,43,35
822,822,0.0,0,83,0.0,50879917,0,83,0,/well/papiez/users/hri611/python/nnUNet_results/Dataset219_PETCT/nnUNetTrainer_1500epochs_NoMirroring__nnUNetPlans__3d_fullres/crossval_results_folds_0_1_2_3_4/PETCT_e344879c2e_03082007.nii.gz,/well/papiez/users/hri611/python/nnUnet_raw/Dataset219_PETCT/labelsTr/PETCT_e344879c2e_03082007.nii.gz,0.0,1.0326047401428222,0.0,4,0
823,823,0.0,0,7876,0.0,49912124,0,7876,0,/well/papiez/users/hri611/python/nnUNet_results/Dataset219_PETCT/nnUNetTrainer_1500epochs_NoMirroring__nnUNetPlans__3d_fullres/crossval_results_folds_0_1_2_3_4/PETCT_e344879c2e_11172006.nii.gz,/well/papiez/users/hri611/python/nnUnet_raw/Dataset219_PETCT/labelsTr/PETCT_e344879c2e_11172006.nii.gz,0.0,97.98548112487792,0.0,27,0
824,824,0.0,0,12,0.0,45439988,0,12,0,/well/papiez/users/hri611/python/nnUNet_results/Dataset219_PETCT/nnUNetTrainer_1500epochs_NoMirroring__nnUNetPlans__3d_fullres/crossval_results_folds_0_1_2_3_4/PETCT_e37d5b9bc2_12102004.nii.gz,/well/papiez/users/hri611/python/nnUnet_raw/Dataset219_PETCT/labelsTr/PETCT_e37d5b9bc2_12102004.nii.gz,0.0,0.149292251586914,0.0,1,0
825,825,0.8324011571841852,1441,297,0.7129170796167823,52153946,4316,4613,5757,/well/papiez/users/hri611/python/nnUNet_results/Dataset219_PETCT/nnUNetTrainer_1500epochs_NoMirroring__nnUNetPlans__3d_fullres/crossval_results_folds_0_1_2_3_4/PETCT_e4712dc58c_02121999.nii.gz,/well/papiez/users/hri611/python/nnUnet_raw/Dataset219_PETCT/labelsTr/PETCT_e4712dc58c_02121999.nii.gz,0.8324011571841852,0.1990563354492187,2.550409297943115,7,4
826,826,0.751481458855153,2599,5537,0.601898517394921,48779563,12301,17838,14900,/well/papiez/users/hri611/python/nnUNet_results/Dataset219_PETCT/nnUNetTrainer_1500epochs_NoMirroring__nnUNetPlans__3d_fullres/crossval_results_folds_0_1_2_3_4/PETCT_e4749cda88_11032005.nii.gz,/well/papiez/users/hri611/python/nnUnet_raw/Dataset219_PETCT/labelsTr/PETCT_e4749cda88_11032005.nii.gz,0.751481458855153,4.254829170227051,0.0124410209655761,22,14
827,827,0.0,0,194,0.0,52159806,0,194,0,/well/papiez/users/hri611/python/nnUNet_results/Dataset219_PETCT/nnUNetTrainer_1500epochs_NoMirroring__nnUNetPlans__3d_fullres/crossval_results_folds_0_1_2_3_4/PETCT_e4e5baf901_02142005.nii.gz,/well/papiez/users/hri611/python/nnUnet_raw/Dataset219_PETCT/labelsTr/PETCT_e4e5baf901_02142005.nii.gz,0.0,2.413558067321777,0.0,7,0
828,828,,0,0,,45600000,0,0,0,/well/papiez/users/hri611/python/nnUNet_results/Dataset219_PETCT/nnUNetTrainer_1500epochs_NoMirroring__nnUNetPlans__3d_fullres/crossval_results_folds_0_1_2_3_4/PETCT_e4e99dbb47_07172005.nii.gz,/well/papiez/users/hri611/python/nnUnet_raw/Dataset219_PETCT/labelsTr/PETCT_e4e99dbb47_07172005.nii.gz,,0.0,0.0,0,0
829,829,,0,0,,47360000,0,0,0,/well/papiez/users/hri611/python/nnUNet_results/Dataset219_PETCT/nnUNetTrainer_1500epochs_NoMirroring__nnUNetPlans__3d_fullres/crossval_results_folds_0_1_2_3_4/PETCT_e52eca67d7_03132006.nii.gz,/well/papiez/users/hri611/python/nnUnet_raw/Dataset219_PETCT/labelsTr/PETCT_e52eca67d7_03132006.nii.gz,,0.0,0.0,0,0
830,830,0.0,0,123,0.0,45439877,0,123,0,/well/papiez/users/hri611/python/nnUNet_results/Dataset219_PETCT/nnUNetTrainer_1500epochs_NoMirroring__nnUNetPlans__3d_fullres/crossval_results_folds_0_1_2_3_4/PETCT_e5b1d6b4bd_10232004.nii.gz,/well/papiez/users/hri611/python/nnUnet_raw/Dataset219_PETCT/labelsTr/PETCT_e5b1d6b4bd_10232004.nii.gz,0.0,1.530245578765869,0.0,6,0
831,831,0.0,0,4,0.0,92319996,0,4,0,/well/papiez/users/hri611/python/nnUNet_results/Dataset219_PETCT/nnUNetTrainer_1500epochs_NoMirroring__nnUNetPlans__3d_fullres/crossval_results_folds_0_1_2_3_4/PETCT_e5c7be07a8_04082005.nii.gz,/well/papiez/users/hri611/python/nnUnet_raw/Dataset219_PETCT/labelsTr/PETCT_e5c7be07a8_04082005.nii.gz,0.0,0.0497640838623046,0.0,3,0
832,832,,0,0,,54080000,0,0,0,/well/papiez/users/hri611/python/nnUNet_results/Dataset219_PETCT/nnUNetTrainer_1500epochs_NoMirroring__nnUNetPlans__3d_fullres/crossval_results_folds_0_1_2_3_4/PETCT_e5d50c5569_08242006.nii.gz,/well/papiez/users/hri611/python/nnUnet_raw/Dataset219_PETCT/labelsTr/PETCT_e5d50c5569_08242006.nii.gz,,0.0,0.0,0,0
833,833,,0,0,,45440000,0,0,0,/well/papiez/users/hri611/python/nnUNet_results/Dataset219_PETCT/nnUNetTrainer_1500epochs_NoMirroring__nnUNetPlans__3d_fullres/crossval_results_folds_0_1_2_3_4/PETCT_e5e1918765_07242003.nii.gz,/well/papiez/users/hri611/python/nnUnet_raw/Dataset219_PETCT/labelsTr/PETCT_e5e1918765_07242003.nii.gz,,0.0,0.0,0,0
834,834,0.9055243164355926,1733,468,0.8273590085496901,52147251,10548,11016,12281,/well/papiez/users/hri611/python/nnUNet_results/Dataset219_PETCT/nnUNetTrainer_1500epochs_NoMirroring__nnUNetPlans__3d_fullres/crossval_results_folds_0_1_2_3_4/PETCT_e61c9da258_12132002.nii.gz,/well/papiez/users/hri611/python/nnUnet_raw/Dataset219_PETCT/labelsTr/PETCT_e61c9da258_12132002.nii.gz,0.9055243164355926,3.209783409118652,0.0248820419311523,3,2
835,835,0.0,0,198,0.0,51839802,0,198,0,/well/papiez/users/hri611/python/nnUNet_results/Dataset219_PETCT/nnUNetTrainer_1500epochs_NoMirroring__nnUNetPlans__3d_fullres/crossval_results_folds_0_1_2_3_4/PETCT_e664932bbc_06092007.nii.gz,/well/papiez/users/hri611/python/nnUnet_raw/Dataset219_PETCT/labelsTr/PETCT_e664932bbc_06092007.nii.gz,0.0,2.463322151184082,0.0,3,0
836,836,0.0,0,257,0.0,51199743,0,257,0,/well/papiez/users/hri611/python/nnUNet_results/Dataset219_PETCT/nnUNetTrainer_1500epochs_NoMirroring__nnUNetPlans__3d_fullres/crossval_results_folds_0_1_2_3_4/PETCT_e68c4577d8_05252007.nii.gz,/well/papiez/users/hri611/python/nnUnet_raw/Dataset219_PETCT/labelsTr/PETCT_e68c4577d8_05252007.nii.gz,0.0,3.1973423881530763,0.0,2,0
837,837,0.0,0,1055,0.0,48158945,0,1055,0,/well/papiez/users/hri611/python/nnUNet_results/Dataset219_PETCT/nnUNetTrainer_1500epochs_NoMirroring__nnUNetPlans__3d_fullres/crossval_results_folds_0_1_2_3_4/PETCT_e6a91fef70_03022006.nii.gz,/well/papiez/users/hri611/python/nnUnet_raw/Dataset219_PETCT/labelsTr/PETCT_e6a91fef70_03022006.nii.gz,0.0,13.12527711868286,0.0,2,0
838,838,0.0,0,50,0.0,44479950,0,50,0,/well/papiez/users/hri611/python/nnUNet_results/Dataset219_PETCT/nnUNetTrainer_1500epochs_NoMirroring__nnUNetPlans__3d_fullres/crossval_results_folds_0_1_2_3_4/PETCT_e6f6c84ec5_11052005.nii.gz,/well/papiez/users/hri611/python/nnUnet_raw/Dataset219_PETCT/labelsTr/PETCT_e6f6c84ec5_11052005.nii.gz,0.0,0.6220510482788086,0.0,2,0
839,839,0.880756074028594,4044,1394,0.7869205752125701,46374479,20083,21477,24127,/well/papiez/users/hri611/python/nnUNet_results/Dataset219_PETCT/nnUNetTrainer_1500epochs_NoMirroring__nnUNetPlans__3d_fullres/crossval_results_folds_0_1_2_3_4/PETCT_e77124b7f4_09292005.nii.gz,/well/papiez/users/hri611/python/nnUnet_raw/Dataset219_PETCT/labelsTr/PETCT_e77124b7f4_09292005.nii.gz,0.880756074028594,0.0124410209655761,0.435435733795166,8,11
840,840,0.8270754037650447,1601,80,0.7051394492194352,52154299,4020,4100,5621,/well/papiez/users/hri611/python/nnUNet_results/Dataset219_PETCT/nnUNetTrainer_1500epochs_NoMirroring__nnUNetPlans__3d_fullres/crossval_results_folds_0_1_2_3_4/PETCT_e77c5fca12_10282002.nii.gz,/well/papiez/users/hri611/python/nnUnet_raw/Dataset219_PETCT/labelsTr/PETCT_e77c5fca12_10282002.nii.gz,0.8270754037650447,0.0,7.875166271209717,1,2
841,841,0.1696658097686375,81,888,0.0926966292134831,89758932,99,987,180,/well/papiez/users/hri611/python/nnUNet_results/Dataset219_PETCT/nnUNetTrainer_1500epochs_NoMirroring__nnUNetPlans__3d_fullres/crossval_results_folds_0_1_2_3_4/PETCT_e79291780d_05142007.nii.gz,/well/papiez/users/hri611/python/nnUnet_raw/Dataset219_PETCT/labelsTr/PETCT_e79291780d_05142007.nii.gz,0.1696658097686375,11.04762661743164,0.0,8,2
842,842,,0,0,,49920000,0,0,0,/well/papiez/users/hri611/python/nnUNet_results/Dataset219_PETCT/nnUNetTrainer_1500epochs_NoMirroring__nnUNetPlans__3d_fullres/crossval_results_folds_0_1_2_3_4/PETCT_e8624bab41_07072007.nii.gz,/well/papiez/users/hri611/python/nnUnet_raw/Dataset219_PETCT/labelsTr/PETCT_e8624bab41_07072007.nii.gz,,0.0,0.0,0,0
843,843,0.0,0,2,0.0,85599998,0,2,0,/well/papiez/users/hri611/python/nnUNet_results/Dataset219_PETCT/nnUNetTrainer_1500epochs_NoMirroring__nnUNetPlans__3d_fullres/crossval_results_folds_0_1_2_3_4/PETCT_e90a287d09_02242003.nii.gz,/well/papiez/users/hri611/python/nnUnet_raw/Dataset219_PETCT/labelsTr/PETCT_e90a287d09_02242003.nii.gz,0.0,0.0248820419311523,0.0,1,0
844,844,0.0,0,306,0.0,92319694,0,306,0,/well/papiez/users/hri611/python/nnUNet_results/Dataset219_PETCT/nnUNetTrainer_1500epochs_NoMirroring__nnUNetPlans__3d_fullres/crossval_results_folds_0_1_2_3_4/PETCT_e90a287d09_08222002.nii.gz,/well/papiez/users/hri611/python/nnUnet_raw/Dataset219_PETCT/labelsTr/PETCT_e90a287d09_08222002.nii.gz,0.0,3.806952415466309,0.0,3,0
845,845,0.2305591831888875,5804,677,0.1303005904455179,105752548,971,1648,6775,/well/papiez/users/hri611/python/nnUNet_results/Dataset219_PETCT/nnUNetTrainer_1500epochs_NoMirroring__nnUNetPlans__3d_fullres/crossval_results_folds_0_1_2_3_4/PETCT_e9be8ec30f_12122002.nii.gz,/well/papiez/users/hri611/python/nnUnet_raw/Dataset219_PETCT/labelsTr/PETCT_e9be8ec30f_12122002.nii.gz,0.2305591831888875,7.86272525024414,19.109408203125,11,17
846,846,0.8193582325092057,1434,283,0.6939939404740688,45434389,3894,4177,5328,/well/papiez/users/hri611/python/nnUNet_results/Dataset219_PETCT/nnUNetTrainer_1500epochs_NoMirroring__nnUNetPlans__3d_fullres/crossval_results_folds_0_1_2_3_4/PETCT_e9e1a391b5_10112001.nii.gz,/well/papiez/users/hri611/python/nnUnet_raw/Dataset219_PETCT/labelsTr/PETCT_e9e1a391b5_10112001.nii.gz,0.8193582325092057,0.0,0.0,1,1
847,847,0.0,0,377,0.0,42399623,0,377,0,/well/papiez/users/hri611/python/nnUNet_results/Dataset219_PETCT/nnUNetTrainer_1500epochs_NoMirroring__nnUNetPlans__3d_fullres/crossval_results_folds_0_1_2_3_4/PETCT_e9feb1135e_07012005.nii.gz,/well/papiez/users/hri611/python/nnUnet_raw/Dataset219_PETCT/labelsTr/PETCT_e9feb1135e_07012005.nii.gz,0.0,4.690264904022217,0.0,3,0
848,848,0.0,0,471,0.0,44319529,0,471,0,/well/papiez/users/hri611/python/nnUNet_results/Dataset219_PETCT/nnUNetTrainer_1500epochs_NoMirroring__nnUNetPlans__3d_fullres/crossval_results_folds_0_1_2_3_4/PETCT_e9feb1135e_09092005.nii.gz,/well/papiez/users/hri611/python/nnUnet_raw/Dataset219_PETCT/labelsTr/PETCT_e9feb1135e_09092005.nii.gz,0.0,5.859720874786377,0.0,1,0
849,849,0.8136912456338183,12819,729,0.6859017457631048,52116867,29585,30314,42404,/well/papiez/users/hri611/python/nnUNet_results/Dataset219_PETCT/nnUNetTrainer_1500epochs_NoMirroring__nnUNetPlans__3d_fullres/crossval_results_folds_0_1_2_3_4/PETCT_ea0fd89f0f_10252003.nii.gz,/well/papiez/users/hri611/python/nnUnet_raw/Dataset219_PETCT/labelsTr/PETCT_ea0fd89f0f_10252003.nii.gz,0.8136912456338183,0.2114973564147949,9.666673290252684,21,25
850,850,0.8690682502638045,15954,1045,0.7684533133555813,47126585,56416,57461,72370,/well/papiez/users/hri611/python/nnUNet_results/Dataset219_PETCT/nnUNetTrainer_1500epochs_NoMirroring__nnUNetPlans__3d_fullres/crossval_results_folds_0_1_2_3_4/PETCT_ea42c88cc7_02262006.nii.gz,/well/papiez/users/hri611/python/nnUnet_raw/Dataset219_PETCT/labelsTr/PETCT_ea42c88cc7_02262006.nii.gz,0.8690682502638045,3.782070373535156,3.856716499328613,20,22
851,851,0.6704691812327507,535,1256,0.5042900636590091,51516387,1822,3078,2357,/well/papiez/users/hri611/python/nnUNet_results/Dataset219_PETCT/nnUNetTrainer_1500epochs_NoMirroring__nnUNetPlans__3d_fullres/crossval_results_folds_0_1_2_3_4/PETCT_ea6c621616_08082005.nii.gz,/well/papiez/users/hri611/python/nnUnet_raw/Dataset219_PETCT/labelsTr/PETCT_ea6c621616_08082005.nii.gz,0.6704691812327507,8.397689151763917,0.0,3,1
852,852,0.3422066549912434,347,7165,0.2064229875343334,58870534,1954,9119,2301,/well/papiez/users/hri611/python/nnUNet_results/Dataset219_PETCT/nnUNetTrainer_1500epochs_NoMirroring__nnUNetPlans__3d_fullres/crossval_results_folds_0_1_2_3_4/PETCT_ea9302fb0f_08232003.nii.gz,/well/papiez/users/hri611/python/nnUnet_raw/Dataset219_PETCT/labelsTr/PETCT_ea9302fb0f_08232003.nii.gz,0.3422066549912434,86.5148597946167,0.0,9,4
853,853,0.8125,4,422,0.6842105263157895,52158651,923,1345,927,/well/papiez/users/hri611/python/nnUNet_results/Dataset219_PETCT/nnUNetTrainer_1500epochs_NoMirroring__nnUNetPlans__3d_fullres/crossval_results_folds_0_1_2_3_4/PETCT_eafa147e24_04182005.nii.gz,/well/papiez/users/hri611/python/nnUnet_raw/Dataset219_PETCT/labelsTr/PETCT_eafa147e24_04182005.nii.gz,0.8125,0.8086663627624512,0.0,3,1
854,854,0.0,0,10,0.0,52159990,0,10,0,/well/papiez/users/hri611/python/nnUNet_results/Dataset219_PETCT/nnUNetTrainer_1500epochs_NoMirroring__nnUNetPlans__3d_fullres/crossval_results_folds_0_1_2_3_4/PETCT_ebaa30ba2e_04172003.nii.gz,/well/papiez/users/hri611/python/nnUnet_raw/Dataset219_PETCT/labelsTr/PETCT_ebaa30ba2e_04172003.nii.gz,0.0,0.1244102096557617,0.0,1,0
855,855,0.9192000495325366,554,751,0.8504812098991751,52151272,7423,8174,7977,/well/papiez/users/hri611/python/nnUNet_results/Dataset219_PETCT/nnUNetTrainer_1500epochs_NoMirroring__nnUNetPlans__3d_fullres/crossval_results_folds_0_1_2_3_4/PETCT_ebb0045704_09272002.nii.gz,/well/papiez/users/hri611/python/nnUnet_raw/Dataset219_PETCT/labelsTr/PETCT_ebb0045704_09272002.nii.gz,0.9192000495325366,0.0497640838623046,0.0,5,2
856,856,0.6622015142690739,0,1160,0.4949934697431432,58877703,1137,2297,1137,/well/papiez/users/hri611/python/nnUNet_results/Dataset219_PETCT/nnUNetTrainer_1500epochs_NoMirroring__nnUNetPlans__3d_fullres/crossval_results_folds_0_1_2_3_4/PETCT_ec581d49ef_01232003.nii.gz,/well/papiez/users/hri611/python/nnUnet_raw/Dataset219_PETCT/labelsTr/PETCT_ec581d49ef_01232003.nii.gz,0.6622015142690739,0.3359075660705566,0.0,3,4
857,857,0.8446745562130178,281,139,0.7311139564660691,52158438,1142,1281,1423,/well/papiez/users/hri611/python/nnUNet_results/Dataset219_PETCT/nnUNetTrainer_1500epochs_NoMirroring__nnUNetPlans__3d_fullres/crossval_results_folds_0_1_2_3_4/PETCT_ec581d49ef_03252002.nii.gz,/well/papiez/users/hri611/python/nnUnet_raw/Dataset219_PETCT/labelsTr/PETCT_ec581d49ef_03252002.nii.gz,0.8446745562130178,0.0,2.052768459320068,5,8
858,858,0.9379074208204384,710,233,0.8830750154990701,45431935,7122,7355,7832,/well/papiez/users/hri611/python/nnUNet_results/Dataset219_PETCT/nnUNetTrainer_1500epochs_NoMirroring__nnUNetPlans__3d_fullres/crossval_results_folds_0_1_2_3_4/PETCT_ec6b934720_10252002.nii.gz,/well/papiez/users/hri611/python/nnUnet_raw/Dataset219_PETCT/labelsTr/PETCT_ec6b934720_10252002.nii.gz,0.9379074208204384,0.0248820419311523,0.0,2,1
859,859,0.0,0,78,0.0,52159922,0,78,0,/well/papiez/users/hri611/python/nnUNet_results/Dataset219_PETCT/nnUNetTrainer_1500epochs_NoMirroring__nnUNetPlans__3d_fullres/crossval_results_folds_0_1_2_3_4/PETCT_eca59074b9_07202002.nii.gz,/well/papiez/users/hri611/python/nnUnet_raw/Dataset219_PETCT/labelsTr/PETCT_eca59074b9_07202002.nii.gz,0.0,0.9703996353149412,0.0,1,0
860,860,0.8211000633076379,51,9557,0.6964968253466848,52128343,22049,31606,22100,/well/papiez/users/hri611/python/nnUNet_results/Dataset219_PETCT/nnUNetTrainer_1500epochs_NoMirroring__nnUNetPlans__3d_fullres/crossval_results_folds_0_1_2_3_4/PETCT_ed9dca00d2_09252004.nii.gz,/well/papiez/users/hri611/python/nnUnet_raw/Dataset219_PETCT/labelsTr/PETCT_ed9dca00d2_09252004.nii.gz,0.8211000633076379,1.7168608932495115,0.0870871467590332,13,15
861,861,,0,0,,56480000,0,0,0,/well/papiez/users/hri611/python/nnUNet_results/Dataset219_PETCT/nnUNetTrainer_1500epochs_NoMirroring__nnUNetPlans__3d_fullres/crossval_results_folds_0_1_2_3_4/PETCT_eda00de6b0_06242006.nii.gz,/well/papiez/users/hri611/python/nnUnet_raw/Dataset219_PETCT/labelsTr/PETCT_eda00de6b0_06242006.nii.gz,,0.0,0.0,0,0
862,862,0.7606915377616015,6269,306,0.6138032305433186,45422975,10450,10756,16719,/well/papiez/users/hri611/python/nnUNet_results/Dataset219_PETCT/nnUNetTrainer_1500epochs_NoMirroring__nnUNetPlans__3d_fullres/crossval_results_folds_0_1_2_3_4/PETCT_ede28cc3c2_01042001.nii.gz,/well/papiez/users/hri611/python/nnUnet_raw/Dataset219_PETCT/labelsTr/PETCT_ede28cc3c2_01042001.nii.gz,0.7606915377616015,0.0,0.0,11,9
863,863,0.628600303183426,3651,24,0.4583640383198231,52153215,3110,3134,6761,/well/papiez/users/hri611/python/nnUNet_results/Dataset219_PETCT/nnUNetTrainer_1500epochs_NoMirroring__nnUNetPlans__3d_fullres/crossval_results_folds_0_1_2_3_4/PETCT_ee97822c60_03032003.nii.gz,/well/papiez/users/hri611/python/nnUnet_raw/Dataset219_PETCT/labelsTr/PETCT_ee97822c60_03032003.nii.gz,0.628600303183426,0.0,0.0124410209655761,3,3
864,864,,0,0,,48160000,0,0,0,/well/papiez/users/hri611/python/nnUNet_results/Dataset219_PETCT/nnUNetTrainer_1500epochs_NoMirroring__nnUNetPlans__3d_fullres/crossval_results_folds_0_1_2_3_4/PETCT_eee2ede9ad_11242006.nii.gz,/well/papiez/users/hri611/python/nnUnet_raw/Dataset219_PETCT/labelsTr/PETCT_eee2ede9ad_11242006.nii.gz,,0.0,0.0,0,0
865,865,0.8941480206540448,1961,991,0.8085603112840467,45424580,12468,13459,14429,/well/papiez/users/hri611/python/nnUNet_results/Dataset219_PETCT/nnUNetTrainer_1500epochs_NoMirroring__nnUNetPlans__3d_fullres/crossval_results_folds_0_1_2_3_4/PETCT_eeeda112bb_06072003.nii.gz,/well/papiez/users/hri611/python/nnUnet_raw/Dataset219_PETCT/labelsTr/PETCT_eeeda112bb_06072003.nii.gz,0.8941480206540448,0.721579216003418,0.0,13,8
866,866,0.8193443270465093,27184,2088,0.6939739890436164,52064348,66380,68468,93564,/well/papiez/users/hri611/python/nnUNet_results/Dataset219_PETCT/nnUNetTrainer_1500epochs_NoMirroring__nnUNetPlans__3d_fullres/crossval_results_folds_0_1_2_3_4/PETCT_ef9d41b836_05212001.nii.gz,/well/papiez/users/hri611/python/nnUnet_raw/Dataset219_PETCT/labelsTr/PETCT_ef9d41b836_05212001.nii.gz,0.8193443270465093,0.3359075660705566,29.27372233200073,43,48
867,867,0.8297990628226511,1935,208,0.7091081851499932,45432633,5224,5432,7159,/well/papiez/users/hri611/python/nnUNet_results/Dataset219_PETCT/nnUNetTrainer_1500epochs_NoMirroring__nnUNetPlans__3d_fullres/crossval_results_folds_0_1_2_3_4/PETCT_efd619ecbf_02232003.nii.gz,/well/papiez/users/hri611/python/nnUnet_raw/Dataset219_PETCT/labelsTr/PETCT_efd619ecbf_02232003.nii.gz,0.8297990628226511,0.0,0.0,4,3
868,868,0.7564259485924113,163,235,0.6082677165354331,45438984,618,853,781,/well/papiez/users/hri611/python/nnUNet_results/Dataset219_PETCT/nnUNetTrainer_1500epochs_NoMirroring__nnUNetPlans__3d_fullres/crossval_results_folds_0_1_2_3_4/PETCT_f01e83894d_03242005.nii.gz,/well/papiez/users/hri611/python/nnUnet_raw/Dataset219_PETCT/labelsTr/PETCT_f01e83894d_03242005.nii.gz,0.7564259485924113,1.9283582496643064,1.7790659980773926,7,4
869,869,0.0,0,2566,0.0,92477434,0,2566,0,/well/papiez/users/hri611/python/nnUNet_results/Dataset219_PETCT/nnUNetTrainer_1500epochs_NoMirroring__nnUNetPlans__3d_fullres/crossval_results_folds_0_1_2_3_4/PETCT_f068e22258_05142007.nii.gz,/well/papiez/users/hri611/python/nnUnet_raw/Dataset219_PETCT/labelsTr/PETCT_f068e22258_05142007.nii.gz,0.0,31.923659797668456,0.0,2,0
870,870,0.0,0,83,0.0,52159917,0,83,0,/well/papiez/users/hri611/python/nnUNet_results/Dataset219_PETCT/nnUNetTrainer_1500epochs_NoMirroring__nnUNetPlans__3d_fullres/crossval_results_folds_0_1_2_3_4/PETCT_f0a1a38a3b_03272005.nii.gz,/well/papiez/users/hri611/python/nnUnet_raw/Dataset219_PETCT/labelsTr/PETCT_f0a1a38a3b_03272005.nii.gz,0.0,1.0326047401428222,0.0,2,0
871,871,,0,0,,52160000,0,0,0,/well/papiez/users/hri611/python/nnUNet_results/Dataset219_PETCT/nnUNetTrainer_1500epochs_NoMirroring__nnUNetPlans__3d_fullres/crossval_results_folds_0_1_2_3_4/PETCT_f0e1b89b41_05172007.nii.gz,/well/papiez/users/hri611/python/nnUnet_raw/Dataset219_PETCT/labelsTr/PETCT_f0e1b89b41_05172007.nii.gz,,0.0,0.0,0,0
872,872,0.7075816209734561,2295,3070,0.5474865047233468,52148144,6491,9561,8786,/well/papiez/users/hri611/python/nnUNet_results/Dataset219_PETCT/nnUNetTrainer_1500epochs_NoMirroring__nnUNetPlans__3d_fullres/crossval_results_folds_0_1_2_3_4/PETCT_f11f3d3692_10242003.nii.gz,/well/papiez/users/hri611/python/nnUnet_raw/Dataset219_PETCT/labelsTr/PETCT_f11f3d3692_10242003.nii.gz,0.7075816209734561,1.9034762077331544,19.29602351760864,29,46
873,873,0.9564441801694664,363,1102,0.9165242165242166,45422450,16085,17187,16448,/well/papiez/users/hri611/python/nnUNet_results/Dataset219_PETCT/nnUNetTrainer_1500epochs_NoMirroring__nnUNetPlans__3d_fullres/crossval_results_folds_0_1_2_3_4/PETCT_f1501b1f45_03202005.nii.gz,/well/papiez/users/hri611/python/nnUnet_raw/Dataset219_PETCT/labelsTr/PETCT_f1501b1f45_03202005.nii.gz,0.9564441801694664,2.2767068367004395,0.4105536918640137,10,8
874,874,0.0,0,348,0.0,72159652,0,348,0,/well/papiez/users/hri611/python/nnUNet_results/Dataset219_PETCT/nnUNetTrainer_1500epochs_NoMirroring__nnUNetPlans__3d_fullres/crossval_results_folds_0_1_2_3_4/PETCT_f1594a7d8a_04252003.nii.gz,/well/papiez/users/hri611/python/nnUnet_raw/Dataset219_PETCT/labelsTr/PETCT_f1594a7d8a_04252003.nii.gz,0.0,4.329475296020508,0.0,3,0
875,875,0.0,0,3,0.0,47519997,0,3,0,/well/papiez/users/hri611/python/nnUNet_results/Dataset219_PETCT/nnUNetTrainer_1500epochs_NoMirroring__nnUNetPlans__3d_fullres/crossval_results_folds_0_1_2_3_4/PETCT_f15b868db6_02032006.nii.gz,/well/papiez/users/hri611/python/nnUnet_raw/Dataset219_PETCT/labelsTr/PETCT_f15b868db6_02032006.nii.gz,0.0,0.0373230628967285,0.0,1,0
876,876,0.7825383993532741,250,826,0.6427622841965471,99036988,1936,2762,2186,/well/papiez/users/hri611/python/nnUNet_results/Dataset219_PETCT/nnUNetTrainer_1500epochs_NoMirroring__nnUNetPlans__3d_fullres/crossval_results_folds_0_1_2_3_4/PETCT_f1ca0f7c4c_12222001.nii.gz,/well/papiez/users/hri611/python/nnUnet_raw/Dataset219_PETCT/labelsTr/PETCT_f1ca0f7c4c_12222001.nii.gz,0.7825383993532741,2.01544539642334,0.5598459434509278,36,45
877,877,0.9027668089116598,9298,5353,0.8227665880360491,45357335,68014,73367,77312,/well/papiez/users/hri611/python/nnUNet_results/Dataset219_PETCT/nnUNetTrainer_1500epochs_NoMirroring__nnUNetPlans__3d_fullres/crossval_results_folds_0_1_2_3_4/PETCT_f21755a99b_05052005.nii.gz,/well/papiez/users/hri611/python/nnUnet_raw/Dataset219_PETCT/labelsTr/PETCT_f21755a99b_05052005.nii.gz,0.9027668089116598,3.135137283325195,0.435435733795166,19,21
878,878,0.9196132198008372,48,2737,0.8511888859203847,105581285,15930,18667,15978,/well/papiez/users/hri611/python/nnUNet_results/Dataset219_PETCT/nnUNetTrainer_1500epochs_NoMirroring__nnUNetPlans__3d_fullres/crossval_results_folds_0_1_2_3_4/PETCT_f24f3ce1da_09142001.nii.gz,/well/papiez/users/hri611/python/nnUnet_raw/Dataset219_PETCT/labelsTr/PETCT_f24f3ce1da_09142001.nii.gz,0.9196132198008372,9.728878395080566,0.0,9,5
879,879,0.5869773380146824,2557,31,0.4154054664558391,52155573,1839,1870,4396,/well/papiez/users/hri611/python/nnUNet_results/Dataset219_PETCT/nnUNetTrainer_1500epochs_NoMirroring__nnUNetPlans__3d_fullres/crossval_results_folds_0_1_2_3_4/PETCT_f2f28337ba_05032001.nii.gz,/well/papiez/users/hri611/python/nnUnet_raw/Dataset219_PETCT/labelsTr/PETCT_f2f28337ba_05032001.nii.gz,0.5869773380146824,0.0,0.0,2,2
880,880,0.9336188436830836,168,359,0.8755020080321285,45435767,3706,4065,3874,/well/papiez/users/hri611/python/nnUNet_results/Dataset219_PETCT/nnUNetTrainer_1500epochs_NoMirroring__nnUNetPlans__3d_fullres/crossval_results_folds_0_1_2_3_4/PETCT_f4668d2bdc_09042000.nii.gz,/well/papiez/users/hri611/python/nnUnet_raw/Dataset219_PETCT/labelsTr/PETCT_f4668d2bdc_09042000.nii.gz,0.9336188436830836,0.3981126708984375,0.0,3,1
881,881,0.8589743589743589,70,84,0.7528089887640449,52159377,469,553,539,/well/papiez/users/hri611/python/nnUNet_results/Dataset219_PETCT/nnUNetTrainer_1500epochs_NoMirroring__nnUNetPlans__3d_fullres/crossval_results_folds_0_1_2_3_4/PETCT_f47e31ceb5_07262003.nii.gz,/well/papiez/users/hri611/python/nnUnet_raw/Dataset219_PETCT/labelsTr/PETCT_f47e31ceb5_07262003.nii.gz,0.8589743589743589,0.2861434822082519,0.6344920692443847,4,8
882,882,0.7323251417769376,1106,310,0.5776916194452729,45436647,1937,2247,3043,/well/papiez/users/hri611/python/nnUNet_results/Dataset219_PETCT/nnUNetTrainer_1500epochs_NoMirroring__nnUNetPlans__3d_fullres/crossval_results_folds_0_1_2_3_4/PETCT_f4813007a0_11252000.nii.gz,/well/papiez/users/hri611/python/nnUnet_raw/Dataset219_PETCT/labelsTr/PETCT_f4813007a0_11252000.nii.gz,0.7323251417769376,0.0,10.214078212738038,3,5
883,883,0.0,0,218,0.0,99039782,0,218,0,/well/papiez/users/hri611/python/nnUNet_results/Dataset219_PETCT/nnUNetTrainer_1500epochs_NoMirroring__nnUNetPlans__3d_fullres/crossval_results_folds_0_1_2_3_4/PETCT_f4a5ebd915_10032003.nii.gz,/well/papiez/users/hri611/python/nnUnet_raw/Dataset219_PETCT/labelsTr/PETCT_f4a5ebd915_10032003.nii.gz,0.0,2.712142570495605,0.0,4,0
884,884,0.9228930414249482,1852,793,0.856825809245426,52141526,15829,16622,17681,/well/papiez/users/hri611/python/nnUNet_results/Dataset219_PETCT/nnUNetTrainer_1500epochs_NoMirroring__nnUNetPlans__3d_fullres/crossval_results_folds_0_1_2_3_4/PETCT_f5c2c09846_10282002.nii.gz,/well/papiez/users/hri611/python/nnUnet_raw/Dataset219_PETCT/labelsTr/PETCT_f5c2c09846_10282002.nii.gz,0.9228930414249482,0.0995281677246093,7.4024074745178225,4,6
885,885,0.6822125126646403,17044,3030,0.5176953941519906,92278379,21547,24577,38591,/well/papiez/users/hri611/python/nnUNet_results/Dataset219_PETCT/nnUNetTrainer_1500epochs_NoMirroring__nnUNetPlans__3d_fullres/crossval_results_folds_0_1_2_3_4/PETCT_f5c9b0de6c_04022004.nii.gz,/well/papiez/users/hri611/python/nnUnet_raw/Dataset219_PETCT/labelsTr/PETCT_f5c9b0de6c_04022004.nii.gz,0.6822125126646403,23.836996170043943,78.12961166381835,119,127
886,886,0.0,0,15,0.0,65279985,0,15,0,/well/papiez/users/hri611/python/nnUNet_results/Dataset219_PETCT/nnUNetTrainer_1500epochs_NoMirroring__nnUNetPlans__3d_fullres/crossval_results_folds_0_1_2_3_4/PETCT_f5cff2e59d_05102007.nii.gz,/well/papiez/users/hri611/python/nnUnet_raw/Dataset219_PETCT/labelsTr/PETCT_f5cff2e59d_05102007.nii.gz,0.0,0.1866153144836425,0.0,2,0
887,887,,0,0,,52160000,0,0,0,/well/papiez/users/hri611/python/nnUNet_results/Dataset219_PETCT/nnUNetTrainer_1500epochs_NoMirroring__nnUNetPlans__3d_fullres/crossval_results_folds_0_1_2_3_4/PETCT_f603eeceba_03172003.nii.gz,/well/papiez/users/hri611/python/nnUnet_raw/Dataset219_PETCT/labelsTr/PETCT_f603eeceba_03172003.nii.gz,,0.0,0.0,0,0
888,888,0.8823468316157548,8263,1932,0.7894639021972576,52111576,38229,40161,46492,/well/papiez/users/hri611/python/nnUNet_results/Dataset219_PETCT/nnUNetTrainer_1500epochs_NoMirroring__nnUNetPlans__3d_fullres/crossval_results_folds_0_1_2_3_4/PETCT_f60ea3abc5_05032003.nii.gz,/well/papiez/users/hri611/python/nnUnet_raw/Dataset219_PETCT/labelsTr/PETCT_f60ea3abc5_05032003.nii.gz,0.8823468316157548,0.0,1.6297737464904785,6,7
889,889,0.0,0,4842,0.0,47195158,0,4842,0,/well/papiez/users/hri611/python/nnUNet_results/Dataset219_PETCT/nnUNetTrainer_1500epochs_NoMirroring__nnUNetPlans__3d_fullres/crossval_results_folds_0_1_2_3_4/PETCT_f6295a93a6_10092006.nii.gz,/well/papiez/users/hri611/python/nnUnet_raw/Dataset219_PETCT/labelsTr/PETCT_f6295a93a6_10092006.nii.gz,0.0,60.23942351531982,0.0,9,0
890,890,0.7027027027027027,63,3,0.5416666666666666,92319856,78,81,141,/well/papiez/users/hri611/python/nnUNet_results/Dataset219_PETCT/nnUNetTrainer_1500epochs_NoMirroring__nnUNetPlans__3d_fullres/crossval_results_folds_0_1_2_3_4/PETCT_f637b5930b_07272003.nii.gz,/well/papiez/users/hri611/python/nnUnet_raw/Dataset219_PETCT/labelsTr/PETCT_f637b5930b_07272003.nii.gz,0.7027027027027027,0.0,0.0,2,2
891,891,0.0,0,9,0.0,52159991,0,9,0,/well/papiez/users/hri611/python/nnUNet_results/Dataset219_PETCT/nnUNetTrainer_1500epochs_NoMirroring__nnUNetPlans__3d_fullres/crossval_results_folds_0_1_2_3_4/PETCT_f650c87621_03112005.nii.gz,/well/papiez/users/hri611/python/nnUnet_raw/Dataset219_PETCT/labelsTr/PETCT_f650c87621_03112005.nii.gz,0.0,0.1119691886901855,0.0,4,0
892,892,0.0,0,78,0.0,47519922,0,78,0,/well/papiez/users/hri611/python/nnUNet_results/Dataset219_PETCT/nnUNetTrainer_1500epochs_NoMirroring__nnUNetPlans__3d_fullres/crossval_results_folds_0_1_2_3_4/PETCT_f650c87621_12082005.nii.gz,/well/papiez/users/hri611/python/nnUnet_raw/Dataset219_PETCT/labelsTr/PETCT_f650c87621_12082005.nii.gz,0.0,0.9703996353149412,0.0,1,0
893,893,0.850654470903643,476,1418,0.7401207464324918,52312712,5394,6812,5870,/well/papiez/users/hri611/python/nnUNet_results/Dataset219_PETCT/nnUNetTrainer_1500epochs_NoMirroring__nnUNetPlans__3d_fullres/crossval_results_folds_0_1_2_3_4/PETCT_f65602d938_03252007.nii.gz,/well/papiez/users/hri611/python/nnUnet_raw/Dataset219_PETCT/labelsTr/PETCT_f65602d938_03252007.nii.gz,0.850654470903643,3.93136262512207,0.0124410209655761,41,36
894,894,0.771625493688531,5126,772,0.6281679485562981,52144138,9964,10736,15090,/well/papiez/users/hri611/python/nnUNet_results/Dataset219_PETCT/nnUNetTrainer_1500epochs_NoMirroring__nnUNetPlans__3d_fullres/crossval_results_folds_0_1_2_3_4/PETCT_f7067b7bbb_05262001.nii.gz,/well/papiez/users/hri611/python/nnUnet_raw/Dataset219_PETCT/labelsTr/PETCT_f7067b7bbb_05262001.nii.gz,0.771625493688531,0.8584304466247559,6.232951503753662,11,7
895,895,0.0,0,93,0.0,52159907,0,93,0,/well/papiez/users/hri611/python/nnUNet_results/Dataset219_PETCT/nnUNetTrainer_1500epochs_NoMirroring__nnUNetPlans__3d_fullres/crossval_results_folds_0_1_2_3_4/PETCT_f75d25523c_09132002.nii.gz,/well/papiez/users/hri611/python/nnUnet_raw/Dataset219_PETCT/labelsTr/PETCT_f75d25523c_09132002.nii.gz,0.0,1.157014949798584,0.0,1,0
896,896,0.0,0,492,0.0,52159508,0,492,0,/well/papiez/users/hri611/python/nnUNet_results/Dataset219_PETCT/nnUNetTrainer_1500epochs_NoMirroring__nnUNetPlans__3d_fullres/crossval_results_folds_0_1_2_3_4/PETCT_f7a9267a69_02012003.nii.gz,/well/papiez/users/hri611/python/nnUnet_raw/Dataset219_PETCT/labelsTr/PETCT_f7a9267a69_02012003.nii.gz,0.0,6.120982315063476,0.0,2,0
897,897,0.0,0,370,0.0,52159630,0,370,0,/well/papiez/users/hri611/python/nnUNet_results/Dataset219_PETCT/nnUNetTrainer_1500epochs_NoMirroring__nnUNetPlans__3d_fullres/crossval_results_folds_0_1_2_3_4/PETCT_f7a9267a69_11012002.nii.gz,/well/papiez/users/hri611/python/nnUnet_raw/Dataset219_PETCT/labelsTr/PETCT_f7a9267a69_11012002.nii.gz,0.0,4.603177757263183,0.0,5,0
898,898,0.0,0,24,0.0,45439976,0,24,0,/well/papiez/users/hri611/python/nnUNet_results/Dataset219_PETCT/nnUNetTrainer_1500epochs_NoMirroring__nnUNetPlans__3d_fullres/crossval_results_folds_0_1_2_3_4/PETCT_f8314eb3f7_03142003.nii.gz,/well/papiez/users/hri611/python/nnUnet_raw/Dataset219_PETCT/labelsTr/PETCT_f8314eb3f7_03142003.nii.gz,0.0,0.2985845031738281,0.0,4,0
899,899,0.0,0,7,0.0,45439993,0,7,0,/well/papiez/users/hri611/python/nnUNet_results/Dataset219_PETCT/nnUNetTrainer_1500epochs_NoMirroring__nnUNetPlans__3d_fullres/crossval_results_folds_0_1_2_3_4/PETCT_f8314eb3f7_09202003.nii.gz,/well/papiez/users/hri611/python/nnUnet_raw/Dataset219_PETCT/labelsTr/PETCT_f8314eb3f7_09202003.nii.gz,0.0,0.0870871467590332,0.0,4,0
900,900,0.0,0,13,0.0,52319987,0,13,0,/well/papiez/users/hri611/python/nnUNet_results/Dataset219_PETCT/nnUNetTrainer_1500epochs_NoMirroring__nnUNetPlans__3d_fullres/crossval_results_folds_0_1_2_3_4/PETCT_f8aac0e202_02262006.nii.gz,/well/papiez/users/hri611/python/nnUnet_raw/Dataset219_PETCT/labelsTr/PETCT_f8aac0e202_02262006.nii.gz,0.0,0.1617332725524902,0.0,1,0
901,901,,0,0,,50880000,0,0,0,/well/papiez/users/hri611/python/nnUNet_results/Dataset219_PETCT/nnUNetTrainer_1500epochs_NoMirroring__nnUNetPlans__3d_fullres/crossval_results_folds_0_1_2_3_4/PETCT_f8aac0e202_07302006.nii.gz,/well/papiez/users/hri611/python/nnUnet_raw/Dataset219_PETCT/labelsTr/PETCT_f8aac0e202_07302006.nii.gz,,0.0,0.0,0,0
902,902,0.0,0,1,0.0,53439999,0,1,0,/well/papiez/users/hri611/python/nnUNet_results/Dataset219_PETCT/nnUNetTrainer_1500epochs_NoMirroring__nnUNetPlans__3d_fullres/crossval_results_folds_0_1_2_3_4/PETCT_f8de0cde56_12052005.nii.gz,/well/papiez/users/hri611/python/nnUnet_raw/Dataset219_PETCT/labelsTr/PETCT_f8de0cde56_12052005.nii.gz,0.0,0.0124410209655761,0.0,1,0
903,903,0.7513202112337974,1651,9745,0.6016916570549788,63491389,17215,26960,18866,/well/papiez/users/hri611/python/nnUNet_results/Dataset219_PETCT/nnUNetTrainer_1500epochs_NoMirroring__nnUNetPlans__3d_fullres/crossval_results_folds_0_1_2_3_4/PETCT_f9c4d4f9ab_03222007.nii.gz,/well/papiez/users/hri611/python/nnUnet_raw/Dataset219_PETCT/labelsTr/PETCT_f9c4d4f9ab_03222007.nii.gz,0.7513202112337974,2.985845031738281,18.99743901443481,9,9
904,904,0.8370488322717622,9,605,0.7197626654495665,52157809,1577,2182,1586,/well/papiez/users/hri611/python/nnUNet_results/Dataset219_PETCT/nnUNetTrainer_1500epochs_NoMirroring__nnUNetPlans__3d_fullres/crossval_results_folds_0_1_2_3_4/PETCT_f9e0c504af_06292003.nii.gz,/well/papiez/users/hri611/python/nnUnet_raw/Dataset219_PETCT/labelsTr/PETCT_f9e0c504af_06292003.nii.gz,0.8370488322717622,0.0,0.0124410209655761,2,3
905,905,,0,0,,45440000,0,0,0,/well/papiez/users/hri611/python/nnUNet_results/Dataset219_PETCT/nnUNetTrainer_1500epochs_NoMirroring__nnUNetPlans__3d_fullres/crossval_results_folds_0_1_2_3_4/PETCT_fa45f610c4_10072004.nii.gz,/well/papiez/users/hri611/python/nnUnet_raw/Dataset219_PETCT/labelsTr/PETCT_fa45f610c4_10072004.nii.gz,,0.0,0.0,0,0
906,906,0.679194328794869,2572,279,0.5142272959618334,52154131,3018,3297,5590,/well/papiez/users/hri611/python/nnUNet_results/Dataset219_PETCT/nnUNetTrainer_1500epochs_NoMirroring__nnUNetPlans__3d_fullres/crossval_results_folds_0_1_2_3_4/PETCT_faf4a6dbaa_01102003.nii.gz,/well/papiez/users/hri611/python/nnUnet_raw/Dataset219_PETCT/labelsTr/PETCT_faf4a6dbaa_01102003.nii.gz,0.679194328794869,2.699701549530029,5.013731449127198,6,3
907,907,0.3669724770642202,2,2275,0.2247191011235955,47997063,660,2935,662,/well/papiez/users/hri611/python/nnUNet_results/Dataset219_PETCT/nnUNetTrainer_1500epochs_NoMirroring__nnUNetPlans__3d_fullres/crossval_results_folds_0_1_2_3_4/PETCT_fb014a1ea0_12012005.nii.gz,/well/papiez/users/hri611/python/nnUnet_raw/Dataset219_PETCT/labelsTr/PETCT_fb014a1ea0_12012005.nii.gz,0.3669724770642202,4.043331813812256,0.0,3,1
908,908,0.6835616438356165,238,224,0.5192507804370448,45439039,499,723,737,/well/papiez/users/hri611/python/nnUNet_results/Dataset219_PETCT/nnUNetTrainer_1500epochs_NoMirroring__nnUNetPlans__3d_fullres/crossval_results_folds_0_1_2_3_4/PETCT_fbd907a179_10042003.nii.gz,/well/papiez/users/hri611/python/nnUnet_raw/Dataset219_PETCT/labelsTr/PETCT_fbd907a179_10042003.nii.gz,0.6835616438356165,2.7370246124267577,0.0,8,1
909,909,0.0,0,44,0.0,95519956,0,44,0,/well/papiez/users/hri611/python/nnUNet_results/Dataset219_PETCT/nnUNetTrainer_1500epochs_NoMirroring__nnUNetPlans__3d_fullres/crossval_results_folds_0_1_2_3_4/PETCT_fc0389a486_05302005.nii.gz,/well/papiez/users/hri611/python/nnUnet_raw/Dataset219_PETCT/labelsTr/PETCT_fc0389a486_05302005.nii.gz,0.0,0.5474049224853516,0.0,2,0
910,910,0.8546607592737382,1329,344,0.7462075242718447,99033408,4919,5263,6248,/well/papiez/users/hri611/python/nnUNet_results/Dataset219_PETCT/nnUNetTrainer_1500epochs_NoMirroring__nnUNetPlans__3d_fullres/crossval_results_folds_0_1_2_3_4/PETCT_fcdbe15200_12142003.nii.gz,/well/papiez/users/hri611/python/nnUnet_raw/Dataset219_PETCT/labelsTr/PETCT_fcdbe15200_12142003.nii.gz,0.8546607592737382,0.1244102096557617,0.0622051048278808,9,10
911,911,0.3362410785091198,279,558,0.2020972354623451,47838951,212,770,491,/well/papiez/users/hri611/python/nnUNet_results/Dataset219_PETCT/nnUNetTrainer_1500epochs_NoMirroring__nnUNetPlans__3d_fullres/crossval_results_folds_0_1_2_3_4/PETCT_fde66dd53a_12222005.nii.gz,/well/papiez/users/hri611/python/nnUnet_raw/Dataset219_PETCT/labelsTr/PETCT_fde66dd53a_12222005.nii.gz,0.3362410785091198,5.424285140991211,3.471044849395752,6,5
912,912,,0,0,,92320000,0,0,0,/well/papiez/users/hri611/python/nnUNet_results/Dataset219_PETCT/nnUNetTrainer_1500epochs_NoMirroring__nnUNetPlans__3d_fullres/crossval_results_folds_0_1_2_3_4/PETCT_fde79b6aa9_02232003.nii.gz,/well/papiez/users/hri611/python/nnUnet_raw/Dataset219_PETCT/labelsTr/PETCT_fde79b6aa9_02232003.nii.gz,,0.0,0.0,0,0
913,913,0.9158664182313316,303,284,0.8447911158117398,92316218,3195,3479,3498,/well/papiez/users/hri611/python/nnUNet_results/Dataset219_PETCT/nnUNetTrainer_1500epochs_NoMirroring__nnUNetPlans__3d_fullres/crossval_results_folds_0_1_2_3_4/PETCT_fde79b6aa9_05092005.nii.gz,/well/papiez/users/hri611/python/nnUnet_raw/Dataset219_PETCT/labelsTr/PETCT_fde79b6aa9_05092005.nii.gz,0.9158664182313316,1.5426865997314452,0.0,3,1
914,914,0.0,0,19,0.0,92319981,0,19,0,/well/papiez/users/hri611/python/nnUNet_results/Dataset219_PETCT/nnUNetTrainer_1500epochs_NoMirroring__nnUNetPlans__3d_fullres/crossval_results_folds_0_1_2_3_4/PETCT_fde79b6aa9_08162003.nii.gz,/well/papiez/users/hri611/python/nnUnet_raw/Dataset219_PETCT/labelsTr/PETCT_fde79b6aa9_08162003.nii.gz,0.0,0.2363793983459472,0.0,1,0
915,915,0.0,0,249,0.0,45439751,0,249,0,/well/papiez/users/hri611/python/nnUNet_results/Dataset219_PETCT/nnUNetTrainer_1500epochs_NoMirroring__nnUNetPlans__3d_fullres/crossval_results_folds_0_1_2_3_4/PETCT_fe705ea1cc_04272003.nii.gz,/well/papiez/users/hri611/python/nnUnet_raw/Dataset219_PETCT/labelsTr/PETCT_fe705ea1cc_04272003.nii.gz,0.0,3.0978142204284667,0.0,3,0
916,916,0.7992467225186508,4514,3801,0.6656211042747416,45415133,16552,20353,21066,/well/papiez/users/hri611/python/nnUNet_results/Dataset219_PETCT/nnUNetTrainer_1500epochs_NoMirroring__nnUNetPlans__3d_fullres/crossval_results_folds_0_1_2_3_4/PETCT_fe705ea1cc_12292002.nii.gz,/well/papiez/users/hri611/python/nnUnet_raw/Dataset219_PETCT/labelsTr/PETCT_fe705ea1cc_12292002.nii.gz,0.7992467225186508,4.429003463745117,34.79753564071655,58,93
917,917,0.0,0,2,0.0,52159998,0,2,0,/well/papiez/users/hri611/python/nnUNet_results/Dataset219_PETCT/nnUNetTrainer_1500epochs_NoMirroring__nnUNetPlans__3d_fullres/crossval_results_folds_0_1_2_3_4/PETCT_ff1451316e_03312003.nii.gz,/well/papiez/users/hri611/python/nnUnet_raw/Dataset219_PETCT/labelsTr/PETCT_ff1451316e_03312003.nii.gz,0.0,0.0248820419311523,0.0,1,0
918,918,0.0,0,775,0.0,86079225,0,775,0,/well/papiez/users/hri611/python/nnUNet_results/Dataset219_PETCT/nnUNetTrainer_1500epochs_NoMirroring__nnUNetPlans__3d_fullres/crossval_results_folds_0_1_2_3_4/PETCT_ff39795341_09222005.nii.gz,/well/papiez/users/hri611/python/nnUnet_raw/Dataset219_PETCT/labelsTr/PETCT_ff39795341_09222005.nii.gz,0.0,9.641791248321534,0.0,1,0
