,DICE,FN,FP,IoU,TN,TP,n_pred,n_ref,prediction_file,reference_file,challenge_DICE,challenge_FP,challenge_FN
0,0.6161772282328697,701,44,0.44527177959791514,52158657,598,642,1299,/well/papiez/users/hri611/python/nnUNet_results/Dataset219_PETCT/nnUNetTrainer_1500epochs_1e2lr__nnUNetPlans__3d_fullres_maxnum_512_patch_192/crossval_results_folds_0_1_2/PETCT_0011f3deaf_03232003.nii.gz,/well/papiez/users/hri611/python/nnUnet_raw/Dataset219_PETCT/labelsTr/PETCT_0011f3deaf_03232003.nii.gz,0.6161772282328697,0.3981126708984375,0.0
1,0.7328086164043082,5608,842,0.5782935599869238,45424705,8845,9687,14453,/well/papiez/users/hri611/python/nnUNet_results/Dataset219_PETCT/nnUNetTrainer_1500epochs_1e2lr__nnUNetPlans__3d_fullres_maxnum_512_patch_192/crossval_results_folds_0_1_2/PETCT_0117d7f11f_09132001.nii.gz,/well/papiez/users/hri611/python/nnUnet_raw/Dataset219_PETCT/labelsTr/PETCT_0117d7f11f_09132001.nii.gz,0.7328086164043082,0.0,0.09952816772460937
2,0.0,0,134,0.0,46079866,0,134,0,/well/papiez/users/hri611/python/nnUNet_results/Dataset219_PETCT/nnUNetTrainer_1500epochs_1e2lr__nnUNetPlans__3d_fullres_maxnum_512_patch_192/crossval_results_folds_0_1_2/PETCT_0143bab87a_07172005.nii.gz,/well/papiez/users/hri611/python/nnUnet_raw/Dataset219_PETCT/labelsTr/PETCT_0143bab87a_07172005.nii.gz,0.0,1.667096809387207,0.0
3,0.6601115837154062,5818,335,0.49266160949868076,52147872,5975,6310,11793,/well/papiez/users/hri611/python/nnUNet_results/Dataset219_PETCT/nnUNetTrainer_1500epochs_1e2lr__nnUNetPlans__3d_fullres_maxnum_512_patch_192/crossval_results_folds_0_1_2/PETCT_01682f60c3_03112002.nii.gz,/well/papiez/users/hri611/python/nnUnet_raw/Dataset219_PETCT/labelsTr/PETCT_01682f60c3_03112002.nii.gz,0.6601115837154062,0.0,46.765797809600826
4,0.7,1,5,0.5384615384615384,99039987,7,12,8,/well/papiez/users/hri611/python/nnUNet_results/Dataset219_PETCT/nnUNetTrainer_1500epochs_1e2lr__nnUNetPlans__3d_fullres_maxnum_512_patch_192/crossval_results_folds_0_1_2/PETCT_0223010e46_09042003.nii.gz,/well/papiez/users/hri611/python/nnUnet_raw/Dataset219_PETCT/labelsTr/PETCT_0223010e46_09042003.nii.gz,0.7,0.0,0.012441020965576172
5,,0,0,,37120000,0,0,0,/well/papiez/users/hri611/python/nnUNet_results/Dataset219_PETCT/nnUNetTrainer_1500epochs_1e2lr__nnUNetPlans__3d_fullres_maxnum_512_patch_192/crossval_results_folds_0_1_2/PETCT_0225325b91_08222005.nii.gz,/well/papiez/users/hri611/python/nnUnet_raw/Dataset219_PETCT/labelsTr/PETCT_0225325b91_08222005.nii.gz,,0.0,0.0
6,0.0,0,571,0.0,45439429,0,571,0,/well/papiez/users/hri611/python/nnUNet_results/Dataset219_PETCT/nnUNetTrainer_1500epochs_1e2lr__nnUNetPlans__3d_fullres_maxnum_512_patch_192/crossval_results_folds_0_1_2/PETCT_0410759456_08222003.nii.gz,/well/papiez/users/hri611/python/nnUnet_raw/Dataset219_PETCT/labelsTr/PETCT_0410759456_08222003.nii.gz,0.0,7.103822971343994,0.0
7,,0,0,,45440000,0,0,0,/well/papiez/users/hri611/python/nnUNet_results/Dataset219_PETCT/nnUNetTrainer_1500epochs_1e2lr__nnUNetPlans__3d_fullres_maxnum_512_patch_192/crossval_results_folds_0_1_2/PETCT_0410759456_11072002.nii.gz,/well/papiez/users/hri611/python/nnUnet_raw/Dataset219_PETCT/labelsTr/PETCT_0410759456_11072002.nii.gz,,0.0,0.0
8,0.8285871761896013,498,3234,0.7073400250941029,45427248,9020,12254,9518,/well/papiez/users/hri611/python/nnUNet_results/Dataset219_PETCT/nnUNetTrainer_1500epochs_1e2lr__nnUNetPlans__3d_fullres_maxnum_512_patch_192/crossval_results_folds_0_1_2/PETCT_04606080a0_02202003.nii.gz,/well/papiez/users/hri611/python/nnUnet_raw/Dataset219_PETCT/labelsTr/PETCT_04606080a0_02202003.nii.gz,0.8285871761896013,4.466326526641845,0.0
9,0.9289542929539031,436,1022,0.8673339399454049,45429010,9532,10554,9968,/well/papiez/users/hri611/python/nnUNet_results/Dataset219_PETCT/nnUNetTrainer_1500epochs_1e2lr__nnUNetPlans__3d_fullres_maxnum_512_patch_192/crossval_results_folds_0_1_2/PETCT_04a4e1c874_11182001.nii.gz,/well/papiez/users/hri611/python/nnUnet_raw/Dataset219_PETCT/labelsTr/PETCT_04a4e1c874_11182001.nii.gz,0.9289542929539031,2.6623784866333007,0.0
10,,0,0,,51840000,0,0,0,/well/papiez/users/hri611/python/nnUNet_results/Dataset219_PETCT/nnUNetTrainer_1500epochs_1e2lr__nnUNetPlans__3d_fullres_maxnum_512_patch_192/crossval_results_folds_0_1_2/PETCT_05808cf24e_03182006.nii.gz,/well/papiez/users/hri611/python/nnUnet_raw/Dataset219_PETCT/labelsTr/PETCT_05808cf24e_03182006.nii.gz,,0.0,0.0
11,0.8518859245630175,0,161,0.7419871794871795,40639376,463,624,463,/well/papiez/users/hri611/python/nnUNet_results/Dataset219_PETCT/nnUNetTrainer_1500epochs_1e2lr__nnUNetPlans__3d_fullres_maxnum_512_patch_192/crossval_results_folds_0_1_2/PETCT_06a46414eb_03122006.nii.gz,/well/papiez/users/hri611/python/nnUnet_raw/Dataset219_PETCT/labelsTr/PETCT_06a46414eb_03122006.nii.gz,0.8518859245630175,0.360789608001709,0.0
12,,0,0,,38720000,0,0,0,/well/papiez/users/hri611/python/nnUNet_results/Dataset219_PETCT/nnUNetTrainer_1500epochs_1e2lr__nnUNetPlans__3d_fullres_maxnum_512_patch_192/crossval_results_folds_0_1_2/PETCT_06d55e8295_04172003.nii.gz,/well/papiez/users/hri611/python/nnUnet_raw/Dataset219_PETCT/labelsTr/PETCT_06d55e8295_04172003.nii.gz,,0.0,0.0
13,0.5821525757717931,7686,1220,0.4105890138980807,45424890,6204,7424,13890,/well/papiez/users/hri611/python/nnUNet_results/Dataset219_PETCT/nnUNetTrainer_1500epochs_1e2lr__nnUNetPlans__3d_fullres_maxnum_512_patch_192/crossval_results_folds_0_1_2/PETCT_06e7c24059_04222005.nii.gz,/well/papiez/users/hri611/python/nnUnet_raw/Dataset219_PETCT/labelsTr/PETCT_06e7c24059_04222005.nii.gz,0.5821525757717931,4.628059799194336,66.54702114486695
14,0.0,0,2472,0.0,38877528,0,2472,0,/well/papiez/users/hri611/python/nnUNet_results/Dataset219_PETCT/nnUNetTrainer_1500epochs_1e2lr__nnUNetPlans__3d_fullres_maxnum_512_patch_192/crossval_results_folds_0_1_2/PETCT_072833774e_07232006.nii.gz,/well/papiez/users/hri611/python/nnUnet_raw/Dataset219_PETCT/labelsTr/PETCT_072833774e_07232006.nii.gz,0.0,30.754203826904295,0.0
15,0.9213333993758978,4127,3814,0.8541410282313613,45385557,46502,50316,50629,/well/papiez/users/hri611/python/nnUNet_results/Dataset219_PETCT/nnUNetTrainer_1500epochs_1e2lr__nnUNetPlans__3d_fullres_maxnum_512_patch_192/crossval_results_folds_0_1_2/PETCT_07574bfa00_04202003.nii.gz,/well/papiez/users/hri611/python/nnUnet_raw/Dataset219_PETCT/labelsTr/PETCT_07574bfa00_04202003.nii.gz,0.9213333993758978,0.796225341796875,0.3359075660705566
16,,0,0,,45440000,0,0,0,/well/papiez/users/hri611/python/nnUNet_results/Dataset219_PETCT/nnUNetTrainer_1500epochs_1e2lr__nnUNetPlans__3d_fullres_maxnum_512_patch_192/crossval_results_folds_0_1_2/PETCT_07b7e9abfc_02102003.nii.gz,/well/papiez/users/hri611/python/nnUnet_raw/Dataset219_PETCT/labelsTr/PETCT_07b7e9abfc_02102003.nii.gz,,0.0,0.0
17,0.0,0,163,0.0,41439837,0,163,0,/well/papiez/users/hri611/python/nnUNet_results/Dataset219_PETCT/nnUNetTrainer_1500epochs_1e2lr__nnUNetPlans__3d_fullres_maxnum_512_patch_192/crossval_results_folds_0_1_2/PETCT_080922db5a_01282006.nii.gz,/well/papiez/users/hri611/python/nnUnet_raw/Dataset219_PETCT/labelsTr/PETCT_080922db5a_01282006.nii.gz,0.0,2.027886417388916,0.0
18,,0,0,,49440000,0,0,0,/well/papiez/users/hri611/python/nnUNet_results/Dataset219_PETCT/nnUNetTrainer_1500epochs_1e2lr__nnUNetPlans__3d_fullres_maxnum_512_patch_192/crossval_results_folds_0_1_2/PETCT_08198c4f0c_11102005.nii.gz,/well/papiez/users/hri611/python/nnUnet_raw/Dataset219_PETCT/labelsTr/PETCT_08198c4f0c_11102005.nii.gz,,0.0,0.0
19,0.0,0,326,0.0,52159674,0,326,0,/well/papiez/users/hri611/python/nnUNet_results/Dataset219_PETCT/nnUNetTrainer_1500epochs_1e2lr__nnUNetPlans__3d_fullres_maxnum_512_patch_192/crossval_results_folds_0_1_2/PETCT_098c4b7b87_08312003.nii.gz,/well/papiez/users/hri611/python/nnUnet_raw/Dataset219_PETCT/labelsTr/PETCT_098c4b7b87_08312003.nii.gz,0.0,4.055772834777832,0.0
20,0.8216939078751857,107,2533,0.6973518284993695,94871277,6083,8616,6190,/well/papiez/users/hri611/python/nnUNet_results/Dataset219_PETCT/nnUNetTrainer_1500epochs_1e2lr__nnUNetPlans__3d_fullres_maxnum_512_patch_192/crossval_results_folds_0_1_2/PETCT_09ee00bdc6_09302005.nii.gz,/well/papiez/users/hri611/python/nnUnet_raw/Dataset219_PETCT/labelsTr/PETCT_09ee00bdc6_09302005.nii.gz,0.8216939078751857,0.1368512306213379,0.0
21,0.8175889888393433,1781,5296,0.6914592143697955,52137063,15860,21156,17641,/well/papiez/users/hri611/python/nnUNet_results/Dataset219_PETCT/nnUNetTrainer_1500epochs_1e2lr__nnUNetPlans__3d_fullres_maxnum_512_patch_192/crossval_results_folds_0_1_2/PETCT_0b57b247b6_05022002.nii.gz,/well/papiez/users/hri611/python/nnUnet_raw/Dataset219_PETCT/labelsTr/PETCT_0b57b247b6_05022002.nii.gz,0.8175889888393433,7.514376663208008,0.0
22,0.8634413477972723,6685,1145,0.7596980112938866,52127416,24754,25899,31439,/well/papiez/users/hri611/python/nnUNet_results/Dataset219_PETCT/nnUNetTrainer_1500epochs_1e2lr__nnUNetPlans__3d_fullres_maxnum_512_patch_192/crossval_results_folds_0_1_2/PETCT_0b98dbe00d_08112002.nii.gz,/well/papiez/users/hri611/python/nnUnet_raw/Dataset219_PETCT/labelsTr/PETCT_0b98dbe00d_08112002.nii.gz,0.8634413477972723,0.0,4.8768802185058595
23,,0,0,,52160000,0,0,0,/well/papiez/users/hri611/python/nnUNet_results/Dataset219_PETCT/nnUNetTrainer_1500epochs_1e2lr__nnUNetPlans__3d_fullres_maxnum_512_patch_192/crossval_results_folds_0_1_2/PETCT_0c13e4df10_10112003.nii.gz,/well/papiez/users/hri611/python/nnUnet_raw/Dataset219_PETCT/labelsTr/PETCT_0c13e4df10_10112003.nii.gz,,0.0,0.0
24,0.7855082730354703,4058,181,0.6467794350470795,45427999,7762,7943,11820,/well/papiez/users/hri611/python/nnUNet_results/Dataset219_PETCT/nnUNetTrainer_1500epochs_1e2lr__nnUNetPlans__3d_fullres_maxnum_512_patch_192/crossval_results_folds_0_1_2/PETCT_0e2034240b_01312003.nii.gz,/well/papiez/users/hri611/python/nnUnet_raw/Dataset219_PETCT/labelsTr/PETCT_0e2034240b_01312003.nii.gz,0.7855082730354703,0.0,1.1072508659362792
25,,0,0,,46080000,0,0,0,/well/papiez/users/hri611/python/nnUNet_results/Dataset219_PETCT/nnUNetTrainer_1500epochs_1e2lr__nnUNetPlans__3d_fullres_maxnum_512_patch_192/crossval_results_folds_0_1_2/PETCT_0fa313309d_10032005.nii.gz,/well/papiez/users/hri611/python/nnUnet_raw/Dataset219_PETCT/labelsTr/PETCT_0fa313309d_10032005.nii.gz,,0.0,0.0
26,0.8524590163934426,40,23,0.7428571428571429,54079755,182,205,222,/well/papiez/users/hri611/python/nnUNet_results/Dataset219_PETCT/nnUNetTrainer_1500epochs_1e2lr__nnUNetPlans__3d_fullres_maxnum_512_patch_192/crossval_results_folds_0_1_2/PETCT_1019ae8551_04062007.nii.gz,/well/papiez/users/hri611/python/nnUnet_raw/Dataset219_PETCT/labelsTr/PETCT_1019ae8551_04062007.nii.gz,0.8524590163934426,0.09952816772460937,0.0
27,0.7621052631578947,225,1,0.6156462585034014,52159412,362,363,587,/well/papiez/users/hri611/python/nnUNet_results/Dataset219_PETCT/nnUNetTrainer_1500epochs_1e2lr__nnUNetPlans__3d_fullres_maxnum_512_patch_192/crossval_results_folds_0_1_2/PETCT_12025abab5_11012004.nii.gz,/well/papiez/users/hri611/python/nnUnet_raw/Dataset219_PETCT/labelsTr/PETCT_12025abab5_11012004.nii.gz,0.7621052631578947,0.0,1.9159172286987305
28,0.9146528844810727,193,418,0.8427284427284427,104476115,3274,3692,3467,/well/papiez/users/hri611/python/nnUNet_results/Dataset219_PETCT/nnUNetTrainer_1500epochs_1e2lr__nnUNetPlans__3d_fullres_maxnum_512_patch_192/crossval_results_folds_0_1_2/PETCT_1253499c80_10072005.nii.gz,/well/papiez/users/hri611/python/nnUnet_raw/Dataset219_PETCT/labelsTr/PETCT_1253499c80_10072005.nii.gz,0.9146528844810727,3.7198652687072755,0.0
29,0.8539243163000217,29758,15900,0.7450854498048696,47820889,133453,149353,163211,/well/papiez/users/hri611/python/nnUNet_results/Dataset219_PETCT/nnUNetTrainer_1500epochs_1e2lr__nnUNetPlans__3d_fullres_maxnum_512_patch_192/crossval_results_folds_0_1_2/PETCT_1285b86bea_02242006.nii.gz,/well/papiez/users/hri611/python/nnUnet_raw/Dataset219_PETCT/labelsTr/PETCT_1285b86bea_02242006.nii.gz,0.8539243163000217,6.95453071975708,113.92242898178101
30,0.0,0,67,0.0,105759933,0,67,0,/well/papiez/users/hri611/python/nnUNet_results/Dataset219_PETCT/nnUNetTrainer_1500epochs_1e2lr__nnUNetPlans__3d_fullres_maxnum_512_patch_192/crossval_results_folds_0_1_2/PETCT_141fffa2a9_03012003.nii.gz,/well/papiez/users/hri611/python/nnUnet_raw/Dataset219_PETCT/labelsTr/PETCT_141fffa2a9_03012003.nii.gz,0.0,0.8335484046936035,0.0
31,0.8148007650117755,9597,2120,0.6874799957324229,52122508,25775,27895,35372,/well/papiez/users/hri611/python/nnUNet_results/Dataset219_PETCT/nnUNetTrainer_1500epochs_1e2lr__nnUNetPlans__3d_fullres_maxnum_512_patch_192/crossval_results_folds_0_1_2/PETCT_1472967bef_12212002.nii.gz,/well/papiez/users/hri611/python/nnUnet_raw/Dataset219_PETCT/labelsTr/PETCT_1472967bef_12212002.nii.gz,0.8148007650117755,0.0870871467590332,5.1630237007141115
32,0.8985837465933968,3305,1235,0.8158439135196528,52135347,20113,21348,23418,/well/papiez/users/hri611/python/nnUNet_results/Dataset219_PETCT/nnUNetTrainer_1500epochs_1e2lr__nnUNetPlans__3d_fullres_maxnum_512_patch_192/crossval_results_folds_0_1_2/PETCT_147a9fcff3_08162001.nii.gz,/well/papiez/users/hri611/python/nnUnet_raw/Dataset219_PETCT/labelsTr/PETCT_147a9fcff3_08162001.nii.gz,0.8985837465933968,0.0,3.9935677299499512
33,,0,0,,45440000,0,0,0,/well/papiez/users/hri611/python/nnUNet_results/Dataset219_PETCT/nnUNetTrainer_1500epochs_1e2lr__nnUNetPlans__3d_fullres_maxnum_512_patch_192/crossval_results_folds_0_1_2/PETCT_14929994cf_04302005.nii.gz,/well/papiez/users/hri611/python/nnUnet_raw/Dataset219_PETCT/labelsTr/PETCT_14929994cf_04302005.nii.gz,,0.0,0.0
34,0.7379480840543882,848,0,0.584720861900098,52157958,1194,1194,2042,/well/papiez/users/hri611/python/nnUNet_results/Dataset219_PETCT/nnUNetTrainer_1500epochs_1e2lr__nnUNetPlans__3d_fullres_maxnum_512_patch_192/crossval_results_folds_0_1_2/PETCT_14c4d2c208_09222002.nii.gz,/well/papiez/users/hri611/python/nnUnet_raw/Dataset219_PETCT/labelsTr/PETCT_14c4d2c208_09222002.nii.gz,0.7379480840543882,0.0,2.898757884979248
35,0.8500698357655445,2484,629,0.739236052940191,52148062,8825,9454,11309,/well/papiez/users/hri611/python/nnUNet_results/Dataset219_PETCT/nnUNetTrainer_1500epochs_1e2lr__nnUNetPlans__3d_fullres_maxnum_512_patch_192/crossval_results_folds_0_1_2/PETCT_154e94256c_11252000.nii.gz,/well/papiez/users/hri611/python/nnUnet_raw/Dataset219_PETCT/labelsTr/PETCT_154e94256c_11252000.nii.gz,0.8500698357655445,5.411844120025635,4.491208568572998
36,0.9078064545495926,4854,5273,0.8311772746974294,45380014,49859,55132,54713,/well/papiez/users/hri611/python/nnUNet_results/Dataset219_PETCT/nnUNetTrainer_1500epochs_1e2lr__nnUNetPlans__3d_fullres_maxnum_512_patch_192/crossval_results_folds_0_1_2/PETCT_15cfa01130_02242001.nii.gz,/well/papiez/users/hri611/python/nnUnet_raw/Dataset219_PETCT/labelsTr/PETCT_15cfa01130_02242001.nii.gz,0.9078064545495926,0.4478767547607422,4.976408386230469
37,0.9453456640388114,807,635,0.8963559261122691,45426087,12471,13106,13278,/well/papiez/users/hri611/python/nnUNet_results/Dataset219_PETCT/nnUNetTrainer_1500epochs_1e2lr__nnUNetPlans__3d_fullres_maxnum_512_patch_192/crossval_results_folds_0_1_2/PETCT_15f4b7254f_07182003.nii.gz,/well/papiez/users/hri611/python/nnUnet_raw/Dataset219_PETCT/labelsTr/PETCT_15f4b7254f_07182003.nii.gz,0.9453456640388114,0.0,2.4882041931152346
38,0.9230769230769231,1,7,0.8571428571428571,45439944,48,55,49,/well/papiez/users/hri611/python/nnUNet_results/Dataset219_PETCT/nnUNetTrainer_1500epochs_1e2lr__nnUNetPlans__3d_fullres_maxnum_512_patch_192/crossval_results_folds_0_1_2/PETCT_15f4b7254f_10112003.nii.gz,/well/papiez/users/hri611/python/nnUnet_raw/Dataset219_PETCT/labelsTr/PETCT_15f4b7254f_10112003.nii.gz,0.9230769230769231,0.0,0.0
39,0.0,0,459,0.0,92319541,0,459,0,/well/papiez/users/hri611/python/nnUNet_results/Dataset219_PETCT/nnUNetTrainer_1500epochs_1e2lr__nnUNetPlans__3d_fullres_maxnum_512_patch_192/crossval_results_folds_0_1_2/PETCT_173b804eda_10112004.nii.gz,/well/papiez/users/hri611/python/nnUnet_raw/Dataset219_PETCT/labelsTr/PETCT_173b804eda_10112004.nii.gz,0.0,5.710428623199463,0.0
40,,0,0,,43840000,0,0,0,/well/papiez/users/hri611/python/nnUNet_results/Dataset219_PETCT/nnUNetTrainer_1500epochs_1e2lr__nnUNetPlans__3d_fullres_maxnum_512_patch_192/crossval_results_folds_0_1_2/PETCT_176bdc5388_06222006.nii.gz,/well/papiez/users/hri611/python/nnUnet_raw/Dataset219_PETCT/labelsTr/PETCT_176bdc5388_06222006.nii.gz,,0.0,0.0
41,0.0,0,25,0.0,49119975,0,25,0,/well/papiez/users/hri611/python/nnUNet_results/Dataset219_PETCT/nnUNetTrainer_1500epochs_1e2lr__nnUNetPlans__3d_fullres_maxnum_512_patch_192/crossval_results_folds_0_1_2/PETCT_1774857f8e_11232006.nii.gz,/well/papiez/users/hri611/python/nnUnet_raw/Dataset219_PETCT/labelsTr/PETCT_1774857f8e_11232006.nii.gz,0.0,0.3110255241394043,0.0
42,0.0,0,37,0.0,45439963,0,37,0,/well/papiez/users/hri611/python/nnUNet_results/Dataset219_PETCT/nnUNetTrainer_1500epochs_1e2lr__nnUNetPlans__3d_fullres_maxnum_512_patch_192/crossval_results_folds_0_1_2/PETCT_1781ba966c_08082002.nii.gz,/well/papiez/users/hri611/python/nnUnet_raw/Dataset219_PETCT/labelsTr/PETCT_1781ba966c_08082002.nii.gz,0.0,0.4603177757263184,0.0
43,,0,0,,38720000,0,0,0,/well/papiez/users/hri611/python/nnUNet_results/Dataset219_PETCT/nnUNetTrainer_1500epochs_1e2lr__nnUNetPlans__3d_fullres_maxnum_512_patch_192/crossval_results_folds_0_1_2/PETCT_17b46d7275_11132003.nii.gz,/well/papiez/users/hri611/python/nnUnet_raw/Dataset219_PETCT/labelsTr/PETCT_17b46d7275_11132003.nii.gz,,0.0,0.0
44,0.0,0,440,0.0,49439560,0,440,0,/well/papiez/users/hri611/python/nnUNet_results/Dataset219_PETCT/nnUNetTrainer_1500epochs_1e2lr__nnUNetPlans__3d_fullres_maxnum_512_patch_192/crossval_results_folds_0_1_2/PETCT_182bdeba22_05102007.nii.gz,/well/papiez/users/hri611/python/nnUnet_raw/Dataset219_PETCT/labelsTr/PETCT_182bdeba22_05102007.nii.gz,0.0,5.474049224853515,0.0
45,0.9555084745762712,2,40,0.9148073022312373,52319507,451,491,453,/well/papiez/users/hri611/python/nnUNet_results/Dataset219_PETCT/nnUNetTrainer_1500epochs_1e2lr__nnUNetPlans__3d_fullres_maxnum_512_patch_192/crossval_results_folds_0_1_2/PETCT_18e8b02af3_08142005.nii.gz,/well/papiez/users/hri611/python/nnUnet_raw/Dataset219_PETCT/labelsTr/PETCT_18e8b02af3_08142005.nii.gz,0.9555084745762712,0.0,0.0
46,0.0,0,431,0.0,99039569,0,431,0,/well/papiez/users/hri611/python/nnUNet_results/Dataset219_PETCT/nnUNetTrainer_1500epochs_1e2lr__nnUNetPlans__3d_fullres_maxnum_512_patch_192/crossval_results_folds_0_1_2/PETCT_1928952a0f_06202003.nii.gz,/well/papiez/users/hri611/python/nnUnet_raw/Dataset219_PETCT/labelsTr/PETCT_1928952a0f_06202003.nii.gz,0.0,5.36208003616333,0.0
47,,0,0,,38720000,0,0,0,/well/papiez/users/hri611/python/nnUNet_results/Dataset219_PETCT/nnUNetTrainer_1500epochs_1e2lr__nnUNetPlans__3d_fullres_maxnum_512_patch_192/crossval_results_folds_0_1_2/PETCT_193dea6ac7_04102003.nii.gz,/well/papiez/users/hri611/python/nnUnet_raw/Dataset219_PETCT/labelsTr/PETCT_193dea6ac7_04102003.nii.gz,,0.0,0.0
48,0.5320746916557569,1560,5231,0.36246714232069094,52149348,3861,9092,5421,/well/papiez/users/hri611/python/nnUNet_results/Dataset219_PETCT/nnUNetTrainer_1500epochs_1e2lr__nnUNetPlans__3d_fullres_maxnum_512_patch_192/crossval_results_folds_0_1_2/PETCT_1a1712f7d0_07052001.nii.gz,/well/papiez/users/hri611/python/nnUnet_raw/Dataset219_PETCT/labelsTr/PETCT_1a1712f7d0_07052001.nii.gz,0.5320746916557569,63.33723773574829,4.628059799194336
49,0.0,0,718,0.0,45119282,0,718,0,/well/papiez/users/hri611/python/nnUNet_results/Dataset219_PETCT/nnUNetTrainer_1500epochs_1e2lr__nnUNetPlans__3d_fullres_maxnum_512_patch_192/crossval_results_folds_0_1_2/PETCT_1a8bd52f71_05052006.nii.gz,/well/papiez/users/hri611/python/nnUnet_raw/Dataset219_PETCT/labelsTr/PETCT_1a8bd52f71_05052006.nii.gz,0.0,8.93265305328369,0.0
50,0.5856246985045828,153,706,0.4140518417462483,58878534,607,1313,760,/well/papiez/users/hri611/python/nnUNet_results/Dataset219_PETCT/nnUNetTrainer_1500epochs_1e2lr__nnUNetPlans__3d_fullres_maxnum_512_patch_192/crossval_results_folds_0_1_2/PETCT_1a90052cb2_06222001.nii.gz,/well/papiez/users/hri611/python/nnUnet_raw/Dataset219_PETCT/labelsTr/PETCT_1a90052cb2_06222001.nii.gz,0.5856246985045828,8.435012214660645,0.0
51,,0,0,,45440000,0,0,0,/well/papiez/users/hri611/python/nnUNet_results/Dataset219_PETCT/nnUNetTrainer_1500epochs_1e2lr__nnUNetPlans__3d_fullres_maxnum_512_patch_192/crossval_results_folds_0_1_2/PETCT_1ac497ed9d_10282004.nii.gz,/well/papiez/users/hri611/python/nnUnet_raw/Dataset219_PETCT/labelsTr/PETCT_1ac497ed9d_10282004.nii.gz,,0.0,0.0
52,0.8412151126919029,1237,3138,0.7259458782260085,52144036,11589,14727,12826,/well/papiez/users/hri611/python/nnUNet_results/Dataset219_PETCT/nnUNetTrainer_1500epochs_1e2lr__nnUNetPlans__3d_fullres_maxnum_512_patch_192/crossval_results_folds_0_1_2/PETCT_1b1bdfc35b_10292000.nii.gz,/well/papiez/users/hri611/python/nnUnet_raw/Dataset219_PETCT/labelsTr/PETCT_1b1bdfc35b_10292000.nii.gz,0.8412151126919029,14.792373928070068,2.5628503189086915
53,0.8164019083121014,9725,1012,0.6897627784680286,52125391,23872,24884,33597,/well/papiez/users/hri611/python/nnUNet_results/Dataset219_PETCT/nnUNetTrainer_1500epochs_1e2lr__nnUNetPlans__3d_fullres_maxnum_512_patch_192/crossval_results_folds_0_1_2/PETCT_1bb48bfb40_12022000.nii.gz,/well/papiez/users/hri611/python/nnUnet_raw/Dataset219_PETCT/labelsTr/PETCT_1bb48bfb40_12022000.nii.gz,0.8164019083121014,0.4478767547607422,14.207645942687988
54,,0,0,,47520000,0,0,0,/well/papiez/users/hri611/python/nnUNet_results/Dataset219_PETCT/nnUNetTrainer_1500epochs_1e2lr__nnUNetPlans__3d_fullres_maxnum_512_patch_192/crossval_results_folds_0_1_2/PETCT_1f2a4f4280_06122005.nii.gz,/well/papiez/users/hri611/python/nnUnet_raw/Dataset219_PETCT/labelsTr/PETCT_1f2a4f4280_06122005.nii.gz,,0.0,0.0
55,0.0,39,0,0.0,105759961,0,0,39,/well/papiez/users/hri611/python/nnUNet_results/Dataset219_PETCT/nnUNetTrainer_1500epochs_1e2lr__nnUNetPlans__3d_fullres_maxnum_512_patch_192/crossval_results_folds_0_1_2/PETCT_1f65acff65_05062007.nii.gz,/well/papiez/users/hri611/python/nnUnet_raw/Dataset219_PETCT/labelsTr/PETCT_1f65acff65_05062007.nii.gz,0.0,0.0,0.48519981765747067
56,0.8057445200302343,0,1799,0.6746835443037975,52154470,3731,5530,3731,/well/papiez/users/hri611/python/nnUNet_results/Dataset219_PETCT/nnUNetTrainer_1500epochs_1e2lr__nnUNetPlans__3d_fullres_maxnum_512_patch_192/crossval_results_folds_0_1_2/PETCT_1fc35d02da_08092003.nii.gz,/well/papiez/users/hri611/python/nnUnet_raw/Dataset219_PETCT/labelsTr/PETCT_1fc35d02da_08092003.nii.gz,0.8057445200302343,0.0,0.0
57,0.8573687539531942,1219,5997,0.7503459728757266,52131096,21688,27685,22907,/well/papiez/users/hri611/python/nnUNet_results/Dataset219_PETCT/nnUNetTrainer_1500epochs_1e2lr__nnUNetPlans__3d_fullres_maxnum_512_patch_192/crossval_results_folds_0_1_2/PETCT_1fe6e48293_06262003.nii.gz,/well/papiez/users/hri611/python/nnUnet_raw/Dataset219_PETCT/labelsTr/PETCT_1fe6e48293_06262003.nii.gz,0.8573687539531942,1.2067790336608886,0.1741742935180664
58,0.8783783783783784,0,180,0.7831325301204819,55199170,650,830,650,/well/papiez/users/hri611/python/nnUNet_results/Dataset219_PETCT/nnUNetTrainer_1500epochs_1e2lr__nnUNetPlans__3d_fullres_maxnum_512_patch_192/crossval_results_folds_0_1_2/PETCT_20995a0fe1_12022005.nii.gz,/well/papiez/users/hri611/python/nnUnet_raw/Dataset219_PETCT/labelsTr/PETCT_20995a0fe1_12022005.nii.gz,0.8783783783783784,0.0,0.0
59,0.0,0,2480,0.0,45437520,0,2480,0,/well/papiez/users/hri611/python/nnUNet_results/Dataset219_PETCT/nnUNetTrainer_1500epochs_1e2lr__nnUNetPlans__3d_fullres_maxnum_512_patch_192/crossval_results_folds_0_1_2/PETCT_20f4a3aa02_03172005.nii.gz,/well/papiez/users/hri611/python/nnUnet_raw/Dataset219_PETCT/labelsTr/PETCT_20f4a3aa02_03172005.nii.gz,0.0,30.853731994628905,0.0
60,0.0,0,576,0.0,43519424,0,576,0,/well/papiez/users/hri611/python/nnUNet_results/Dataset219_PETCT/nnUNetTrainer_1500epochs_1e2lr__nnUNetPlans__3d_fullres_maxnum_512_patch_192/crossval_results_folds_0_1_2/PETCT_2122b88719_09092006.nii.gz,/well/papiez/users/hri611/python/nnUnet_raw/Dataset219_PETCT/labelsTr/PETCT_2122b88719_09092006.nii.gz,0.0,7.166028076171875,0.0
61,0.4744557478057725,55556,909,0.31100752870547754,54638047,25488,26397,81044,/well/papiez/users/hri611/python/nnUNet_results/Dataset219_PETCT/nnUNetTrainer_1500epochs_1e2lr__nnUNetPlans__3d_fullres_maxnum_512_patch_192/crossval_results_folds_0_1_2/PETCT_2140db0ca5_04132007.nii.gz,/well/papiez/users/hri611/python/nnUnet_raw/Dataset219_PETCT/labelsTr/PETCT_2140db0ca5_04132007.nii.gz,0.4744557478057725,0.48519981765747067,35.855022422790526
62,0.8929121725731896,467,89,0.8065414057063326,52157126,2318,2407,2785,/well/papiez/users/hri611/python/nnUNet_results/Dataset219_PETCT/nnUNetTrainer_1500epochs_1e2lr__nnUNetPlans__3d_fullres_maxnum_512_patch_192/crossval_results_folds_0_1_2/PETCT_21853fc15b_10122002.nii.gz,/well/papiez/users/hri611/python/nnUnet_raw/Dataset219_PETCT/labelsTr/PETCT_21853fc15b_10122002.nii.gz,0.8929121725731896,0.0,0.012441020965576172
63,0.7995079950799509,1141,1793,0.6659836065573771,45431216,5850,7643,6991,/well/papiez/users/hri611/python/nnUNet_results/Dataset219_PETCT/nnUNetTrainer_1500epochs_1e2lr__nnUNetPlans__3d_fullres_maxnum_512_patch_192/crossval_results_folds_0_1_2/PETCT_2202a936e0_05312002.nii.gz,/well/papiez/users/hri611/python/nnUnet_raw/Dataset219_PETCT/labelsTr/PETCT_2202a936e0_05312002.nii.gz,0.7995079950799509,0.4105536918640137,1.6919788513183593
64,0.0,0,2,0.0,51839998,0,2,0,/well/papiez/users/hri611/python/nnUNet_results/Dataset219_PETCT/nnUNetTrainer_1500epochs_1e2lr__nnUNetPlans__3d_fullres_maxnum_512_patch_192/crossval_results_folds_0_1_2/PETCT_234f8427c0_12032005.nii.gz,/well/papiez/users/hri611/python/nnUnet_raw/Dataset219_PETCT/labelsTr/PETCT_234f8427c0_12032005.nii.gz,0.0,0.024882041931152343,0.0
65,0.0,0,21,0.0,45439979,0,21,0,/well/papiez/users/hri611/python/nnUNet_results/Dataset219_PETCT/nnUNetTrainer_1500epochs_1e2lr__nnUNetPlans__3d_fullres_maxnum_512_patch_192/crossval_results_folds_0_1_2/PETCT_234f8427c0_12092004.nii.gz,/well/papiez/users/hri611/python/nnUnet_raw/Dataset219_PETCT/labelsTr/PETCT_234f8427c0_12092004.nii.gz,0.0,0.26126144027709963,0.0
66,0.4444444444444444,42,68,0.2857142857142857,92319846,44,112,86,/well/papiez/users/hri611/python/nnUNet_results/Dataset219_PETCT/nnUNetTrainer_1500epochs_1e2lr__nnUNetPlans__3d_fullres_maxnum_512_patch_192/crossval_results_folds_0_1_2/PETCT_23ed525e82_08012003.nii.gz,/well/papiez/users/hri611/python/nnUnet_raw/Dataset219_PETCT/labelsTr/PETCT_23ed525e82_08012003.nii.gz,0.4444444444444444,0.7340202369689941,0.0
67,,0,0,,99520000,0,0,0,/well/papiez/users/hri611/python/nnUNet_results/Dataset219_PETCT/nnUNetTrainer_1500epochs_1e2lr__nnUNetPlans__3d_fullres_maxnum_512_patch_192/crossval_results_folds_0_1_2/PETCT_2428b44e92_03222007.nii.gz,/well/papiez/users/hri611/python/nnUnet_raw/Dataset219_PETCT/labelsTr/PETCT_2428b44e92_03222007.nii.gz,,0.0,0.0
68,0.5678098092803198,28533,881,0.39646257386736705,52111264,19322,20203,47855,/well/papiez/users/hri611/python/nnUNet_results/Dataset219_PETCT/nnUNetTrainer_1500epochs_1e2lr__nnUNetPlans__3d_fullres_maxnum_512_patch_192/crossval_results_folds_0_1_2/PETCT_249c02c01c_03062003.nii.gz,/well/papiez/users/hri611/python/nnUnet_raw/Dataset219_PETCT/labelsTr/PETCT_249c02c01c_03062003.nii.gz,0.5678098092803198,0.0,44.09097830200195
69,,0,0,,45440000,0,0,0,/well/papiez/users/hri611/python/nnUNet_results/Dataset219_PETCT/nnUNetTrainer_1500epochs_1e2lr__nnUNetPlans__3d_fullres_maxnum_512_patch_192/crossval_results_folds_0_1_2/PETCT_249c02c01c_07262003.nii.gz,/well/papiez/users/hri611/python/nnUnet_raw/Dataset219_PETCT/labelsTr/PETCT_249c02c01c_07262003.nii.gz,,0.0,0.0
70,0.0,0,47,0.0,72159953,0,47,0,/well/papiez/users/hri611/python/nnUNet_results/Dataset219_PETCT/nnUNetTrainer_1500epochs_1e2lr__nnUNetPlans__3d_fullres_maxnum_512_patch_192/crossval_results_folds_0_1_2/PETCT_24cb79a92b_04132003.nii.gz,/well/papiez/users/hri611/python/nnUnet_raw/Dataset219_PETCT/labelsTr/PETCT_24cb79a92b_04132003.nii.gz,0.0,0.58472798538208,0.0
71,0.0,0,72,0.0,47839928,0,72,0,/well/papiez/users/hri611/python/nnUNet_results/Dataset219_PETCT/nnUNetTrainer_1500epochs_1e2lr__nnUNetPlans__3d_fullres_maxnum_512_patch_192/crossval_results_folds_0_1_2/PETCT_265c26907a_11102005.nii.gz,/well/papiez/users/hri611/python/nnUnet_raw/Dataset219_PETCT/labelsTr/PETCT_265c26907a_11102005.nii.gz,0.0,0.8957535095214844,0.0
72,0.0,0,491,0.0,58879509,0,491,0,/well/papiez/users/hri611/python/nnUNet_results/Dataset219_PETCT/nnUNetTrainer_1500epochs_1e2lr__nnUNetPlans__3d_fullres_maxnum_512_patch_192/crossval_results_folds_0_1_2/PETCT_2716c9bfff_10042003.nii.gz,/well/papiez/users/hri611/python/nnUnet_raw/Dataset219_PETCT/labelsTr/PETCT_2716c9bfff_10042003.nii.gz,0.0,6.1085412940979005,0.0
73,0.0,0,176,0.0,54559824,0,176,0,/well/papiez/users/hri611/python/nnUNet_results/Dataset219_PETCT/nnUNetTrainer_1500epochs_1e2lr__nnUNetPlans__3d_fullres_maxnum_512_patch_192/crossval_results_folds_0_1_2/PETCT_274688d0a8_03242007.nii.gz,/well/papiez/users/hri611/python/nnUnet_raw/Dataset219_PETCT/labelsTr/PETCT_274688d0a8_03242007.nii.gz,0.0,2.189619689941406,0.0
74,0.36118247277200854,17526,129,0.22039212222909124,52137354,4991,5120,22517,/well/papiez/users/hri611/python/nnUNet_results/Dataset219_PETCT/nnUNetTrainer_1500epochs_1e2lr__nnUNetPlans__3d_fullres_maxnum_512_patch_192/crossval_results_folds_0_1_2/PETCT_27d69a8466_12162001.nii.gz,/well/papiez/users/hri611/python/nnUnet_raw/Dataset219_PETCT/labelsTr/PETCT_27d69a8466_12162001.nii.gz,0.36118247277200854,0.0,67.9777385559082
75,,0,0,,52160000,0,0,0,/well/papiez/users/hri611/python/nnUNet_results/Dataset219_PETCT/nnUNetTrainer_1500epochs_1e2lr__nnUNetPlans__3d_fullres_maxnum_512_patch_192/crossval_results_folds_0_1_2/PETCT_28a0a0a163_10222004.nii.gz,/well/papiez/users/hri611/python/nnUnet_raw/Dataset219_PETCT/labelsTr/PETCT_28a0a0a163_10222004.nii.gz,,0.0,0.0
76,0.7560833737275812,9,5023,0.607824799314161,52147169,7799,12822,7808,/well/papiez/users/hri611/python/nnUNet_results/Dataset219_PETCT/nnUNetTrainer_1500epochs_1e2lr__nnUNetPlans__3d_fullres_maxnum_512_patch_192/crossval_results_folds_0_1_2/PETCT_29ab45ef17_06272002.nii.gz,/well/papiez/users/hri611/python/nnUnet_raw/Dataset219_PETCT/labelsTr/PETCT_29ab45ef17_06272002.nii.gz,0.7560833737275812,1.4555994529724121,0.09952816772460937
77,0.7643160577740017,1190,197,0.6185368536853685,45436364,2249,2446,3439,/well/papiez/users/hri611/python/nnUNet_results/Dataset219_PETCT/nnUNetTrainer_1500epochs_1e2lr__nnUNetPlans__3d_fullres_maxnum_512_patch_192/crossval_results_folds_0_1_2/PETCT_2a78eed085_12222001.nii.gz,/well/papiez/users/hri611/python/nnUnet_raw/Dataset219_PETCT/labelsTr/PETCT_2a78eed085_12222001.nii.gz,0.7643160577740017,0.0,13.983707565307617
78,,0,0,,32000000,0,0,0,/well/papiez/users/hri611/python/nnUNet_results/Dataset219_PETCT/nnUNetTrainer_1500epochs_1e2lr__nnUNetPlans__3d_fullres_maxnum_512_patch_192/crossval_results_folds_0_1_2/PETCT_2ad62beb52_03082003.nii.gz,/well/papiez/users/hri611/python/nnUnet_raw/Dataset219_PETCT/labelsTr/PETCT_2ad62beb52_03082003.nii.gz,,0.0,0.0
79,0.8547848664688428,19,1547,0.7463967611336032,51033825,4609,6156,4628,/well/papiez/users/hri611/python/nnUNet_results/Dataset219_PETCT/nnUNetTrainer_1500epochs_1e2lr__nnUNetPlans__3d_fullres_maxnum_512_patch_192/crossval_results_folds_0_1_2/PETCT_2b29531d8c_10162005.nii.gz,/well/papiez/users/hri611/python/nnUnet_raw/Dataset219_PETCT/labelsTr/PETCT_2b29531d8c_10162005.nii.gz,0.8547848664688428,2.090091522216797,0.0
80,0.0,0,72,0.0,47839928,0,72,0,/well/papiez/users/hri611/python/nnUNet_results/Dataset219_PETCT/nnUNetTrainer_1500epochs_1e2lr__nnUNetPlans__3d_fullres_maxnum_512_patch_192/crossval_results_folds_0_1_2/PETCT_2b8064fbe2_06112006.nii.gz,/well/papiez/users/hri611/python/nnUnet_raw/Dataset219_PETCT/labelsTr/PETCT_2b8064fbe2_06112006.nii.gz,0.0,0.8957535095214844,0.0
81,0.9177489177489178,3,16,0.848,43839875,106,122,109,/well/papiez/users/hri611/python/nnUNet_results/Dataset219_PETCT/nnUNetTrainer_1500epochs_1e2lr__nnUNetPlans__3d_fullres_maxnum_512_patch_192/crossval_results_folds_0_1_2/PETCT_2ce074c2ea_02042006.nii.gz,/well/papiez/users/hri611/python/nnUnet_raw/Dataset219_PETCT/labelsTr/PETCT_2ce074c2ea_02042006.nii.gz,0.9177489177489178,0.06220510482788086,0.0
82,0.7011494252873564,104,0,0.5398230088495575,94079774,122,122,226,/well/papiez/users/hri611/python/nnUNet_results/Dataset219_PETCT/nnUNetTrainer_1500epochs_1e2lr__nnUNetPlans__3d_fullres_maxnum_512_patch_192/crossval_results_folds_0_1_2/PETCT_2d70838805_04302007.nii.gz,/well/papiez/users/hri611/python/nnUnet_raw/Dataset219_PETCT/labelsTr/PETCT_2d70838805_04302007.nii.gz,0.7011494252873564,0.0,0.0
83,0.3597185576077397,1117,3251,0.2193029490616622,45434405,1227,4478,2344,/well/papiez/users/hri611/python/nnUNet_results/Dataset219_PETCT/nnUNetTrainer_1500epochs_1e2lr__nnUNetPlans__3d_fullres_maxnum_512_patch_192/crossval_results_folds_0_1_2/PETCT_2dac5ef654_11042000.nii.gz,/well/papiez/users/hri611/python/nnUnet_raw/Dataset219_PETCT/labelsTr/PETCT_2dac5ef654_11042000.nii.gz,0.3597185576077397,40.37111303329468,0.0
84,0.8611191553794091,2393,14392,0.7561099648368255,46651178,52037,66429,54430,/well/papiez/users/hri611/python/nnUNet_results/Dataset219_PETCT/nnUNetTrainer_1500epochs_1e2lr__nnUNetPlans__3d_fullres_maxnum_512_patch_192/crossval_results_folds_0_1_2/PETCT_2f7200f771_11052005.nii.gz,/well/papiez/users/hri611/python/nnUnet_raw/Dataset219_PETCT/labelsTr/PETCT_2f7200f771_11052005.nii.gz,0.8611191553794091,0.3483485870361328,2.413558067321777
85,0.7548740861088545,2143,271,0.6062632523242538,52153869,3717,3988,5860,/well/papiez/users/hri611/python/nnUNet_results/Dataset219_PETCT/nnUNetTrainer_1500epochs_1e2lr__nnUNetPlans__3d_fullres_maxnum_512_patch_192/crossval_results_folds_0_1_2/PETCT_3049d4f1a4_02242002.nii.gz,/well/papiez/users/hri611/python/nnUnet_raw/Dataset219_PETCT/labelsTr/PETCT_3049d4f1a4_02242002.nii.gz,0.7548740861088545,0.0,3.2844295349121095
86,0.8697333170969314,15861,1255,0.7694938993185553,45365746,57138,58393,72999,/well/papiez/users/hri611/python/nnUNet_results/Dataset219_PETCT/nnUNetTrainer_1500epochs_1e2lr__nnUNetPlans__3d_fullres_maxnum_512_patch_192/crossval_results_folds_0_1_2/PETCT_30c4b7062b_01182001.nii.gz,/well/papiez/users/hri611/python/nnUnet_raw/Dataset219_PETCT/labelsTr/PETCT_30c4b7062b_01182001.nii.gz,0.8697333170969314,7.004294803619385,11.109831722259521
87,0.0,0,292,0.0,99039708,0,292,0,/well/papiez/users/hri611/python/nnUNet_results/Dataset219_PETCT/nnUNetTrainer_1500epochs_1e2lr__nnUNetPlans__3d_fullres_maxnum_512_patch_192/crossval_results_folds_0_1_2/PETCT_30e2b83b74_04262003.nii.gz,/well/papiez/users/hri611/python/nnUnet_raw/Dataset219_PETCT/labelsTr/PETCT_30e2b83b74_04262003.nii.gz,0.0,3.6327781219482422,0.0
88,,0,0,,92320000,0,0,0,/well/papiez/users/hri611/python/nnUNet_results/Dataset219_PETCT/nnUNetTrainer_1500epochs_1e2lr__nnUNetPlans__3d_fullres_maxnum_512_patch_192/crossval_results_folds_0_1_2/PETCT_30e2b83b74_07212003.nii.gz,/well/papiez/users/hri611/python/nnUnet_raw/Dataset219_PETCT/labelsTr/PETCT_30e2b83b74_07212003.nii.gz,,0.0,0.0
89,0.9461642954171731,569,184,0.8978290366350068,52152630,6617,6801,7186,/well/papiez/users/hri611/python/nnUNet_results/Dataset219_PETCT/nnUNetTrainer_1500epochs_1e2lr__nnUNetPlans__3d_fullres_maxnum_512_patch_192/crossval_results_folds_0_1_2/PETCT_31ddf5013a_02222001.nii.gz,/well/papiez/users/hri611/python/nnUnet_raw/Dataset219_PETCT/labelsTr/PETCT_31ddf5013a_02222001.nii.gz,0.9461642954171731,0.0,0.0
90,0.6567185091775256,2470,7330,0.48889120684259935,45420826,9374,16704,11844,/well/papiez/users/hri611/python/nnUNet_results/Dataset219_PETCT/nnUNetTrainer_1500epochs_1e2lr__nnUNetPlans__3d_fullres_maxnum_512_patch_192/crossval_results_folds_0_1_2/PETCT_321bba14bc_03072002.nii.gz,/well/papiez/users/hri611/python/nnUnet_raw/Dataset219_PETCT/labelsTr/PETCT_321bba14bc_03072002.nii.gz,0.6567185091775256,1.7541839561462402,4.565854694366455
91,,0,0,,45440000,0,0,0,/well/papiez/users/hri611/python/nnUNet_results/Dataset219_PETCT/nnUNetTrainer_1500epochs_1e2lr__nnUNetPlans__3d_fullres_maxnum_512_patch_192/crossval_results_folds_0_1_2/PETCT_32219760da_03132003.nii.gz,/well/papiez/users/hri611/python/nnUnet_raw/Dataset219_PETCT/labelsTr/PETCT_32219760da_03132003.nii.gz,,0.0,0.0
92,0.8703296703296703,31,28,0.7704280155642024,99839743,198,226,229,/well/papiez/users/hri611/python/nnUNet_results/Dataset219_PETCT/nnUNetTrainer_1500epochs_1e2lr__nnUNetPlans__3d_fullres_maxnum_512_patch_192/crossval_results_folds_0_1_2/PETCT_32aa845af1_01262007.nii.gz,/well/papiez/users/hri611/python/nnUnet_raw/Dataset219_PETCT/labelsTr/PETCT_32aa845af1_01262007.nii.gz,0.8703296703296703,0.0,0.0
93,0.914661704107404,247,1037,0.8427434170238824,50871835,6881,7918,7128,/well/papiez/users/hri611/python/nnUNet_results/Dataset219_PETCT/nnUNetTrainer_1500epochs_1e2lr__nnUNetPlans__3d_fullres_maxnum_512_patch_192/crossval_results_folds_0_1_2/PETCT_32aa845af1_06152007.nii.gz,/well/papiez/users/hri611/python/nnUnet_raw/Dataset219_PETCT/labelsTr/PETCT_32aa845af1_06152007.nii.gz,0.914661704107404,2.239383773803711,1.5426865997314452
94,0.8504663348561586,7740,2505,0.739835953173011,45400621,29134,31639,36874,/well/papiez/users/hri611/python/nnUNet_results/Dataset219_PETCT/nnUNetTrainer_1500epochs_1e2lr__nnUNetPlans__3d_fullres_maxnum_512_patch_192/crossval_results_folds_0_1_2/PETCT_335a00191d_02162001.nii.gz,/well/papiez/users/hri611/python/nnUnet_raw/Dataset219_PETCT/labelsTr/PETCT_335a00191d_02162001.nii.gz,0.8504663348561586,0.5100818595886231,21.970843025207518
95,0.0,0,85,0.0,49919915,0,85,0,/well/papiez/users/hri611/python/nnUNet_results/Dataset219_PETCT/nnUNetTrainer_1500epochs_1e2lr__nnUNetPlans__3d_fullres_maxnum_512_patch_192/crossval_results_folds_0_1_2/PETCT_345b11778a_10142005.nii.gz,/well/papiez/users/hri611/python/nnUnet_raw/Dataset219_PETCT/labelsTr/PETCT_345b11778a_10142005.nii.gz,0.0,1.0574867820739746,0.0
96,,0,0,,54240000,0,0,0,/well/papiez/users/hri611/python/nnUNet_results/Dataset219_PETCT/nnUNetTrainer_1500epochs_1e2lr__nnUNetPlans__3d_fullres_maxnum_512_patch_192/crossval_results_folds_0_1_2/PETCT_3481507253_06172007.nii.gz,/well/papiez/users/hri611/python/nnUnet_raw/Dataset219_PETCT/labelsTr/PETCT_3481507253_06172007.nii.gz,,0.0,0.0
97,,0,0,,52160000,0,0,0,/well/papiez/users/hri611/python/nnUNet_results/Dataset219_PETCT/nnUNetTrainer_1500epochs_1e2lr__nnUNetPlans__3d_fullres_maxnum_512_patch_192/crossval_results_folds_0_1_2/PETCT_34d3efa936_10222004.nii.gz,/well/papiez/users/hri611/python/nnUnet_raw/Dataset219_PETCT/labelsTr/PETCT_34d3efa936_10222004.nii.gz,,0.0,0.0
98,0.6670635865682305,2641,155,0.5004466678577809,45594403,2801,2956,5442,/well/papiez/users/hri611/python/nnUNet_results/Dataset219_PETCT/nnUNetTrainer_1500epochs_1e2lr__nnUNetPlans__3d_fullres_maxnum_512_patch_192/crossval_results_folds_0_1_2/PETCT_350e91119a_10232005.nii.gz,/well/papiez/users/hri611/python/nnUnet_raw/Dataset219_PETCT/labelsTr/PETCT_350e91119a_10232005.nii.gz,0.6670635865682305,0.6966971740722656,5.78507474899292
99,0.8657701091093631,654,404,0.7633109619686801,92315530,3412,3816,4066,/well/papiez/users/hri611/python/nnUNet_results/Dataset219_PETCT/nnUNetTrainer_1500epochs_1e2lr__nnUNetPlans__3d_fullres_maxnum_512_patch_192/crossval_results_folds_0_1_2/PETCT_35c9c85a96_04082005.nii.gz,/well/papiez/users/hri611/python/nnUnet_raw/Dataset219_PETCT/labelsTr/PETCT_35c9c85a96_04082005.nii.gz,0.8657701091093631,0.037323062896728515,1.082368824005127
100,0.09544626593806922,12329,86,0.05011476664116297,52146930,655,741,12984,/well/papiez/users/hri611/python/nnUNet_results/Dataset219_PETCT/nnUNetTrainer_1500epochs_1e2lr__nnUNetPlans__3d_fullres_maxnum_512_patch_192/crossval_results_folds_0_1_2/PETCT_36bb0257fc_08032003.nii.gz,/well/papiez/users/hri611/python/nnUnet_raw/Dataset219_PETCT/labelsTr/PETCT_36bb0257fc_08032003.nii.gz,0.09544626593806922,0.0,150.4741485786438
101,0.7627915845674696,3195,4269,0.6165425122013871,100940535,12001,16270,15196,/well/papiez/users/hri611/python/nnUNet_results/Dataset219_PETCT/nnUNetTrainer_1500epochs_1e2lr__nnUNetPlans__3d_fullres_maxnum_512_patch_192/crossval_results_folds_0_1_2/PETCT_36d8219e3f_02092006.nii.gz,/well/papiez/users/hri611/python/nnUnet_raw/Dataset219_PETCT/labelsTr/PETCT_36d8219e3f_02092006.nii.gz,0.7627915845674696,18.97255697250366,5.411844120025635
102,0.0,0,60,0.0,48799940,0,60,0,/well/papiez/users/hri611/python/nnUNet_results/Dataset219_PETCT/nnUNetTrainer_1500epochs_1e2lr__nnUNetPlans__3d_fullres_maxnum_512_patch_192/crossval_results_folds_0_1_2/PETCT_372746cc99_07152006.nii.gz,/well/papiez/users/hri611/python/nnUnet_raw/Dataset219_PETCT/labelsTr/PETCT_372746cc99_07152006.nii.gz,0.0,0.7464612579345703,0.0
103,0.8862940187475529,3415,1522,0.7958061047233022,52135822,19241,20763,22656,/well/papiez/users/hri611/python/nnUNet_results/Dataset219_PETCT/nnUNetTrainer_1500epochs_1e2lr__nnUNetPlans__3d_fullres_maxnum_512_patch_192/crossval_results_folds_0_1_2/PETCT_37952b7ffb_08242002.nii.gz,/well/papiez/users/hri611/python/nnUnet_raw/Dataset219_PETCT/labelsTr/PETCT_37952b7ffb_08242002.nii.gz,0.8862940187475529,0.3856716499328613,4.1553010025024415
104,0.0,0,45,0.0,52159955,0,45,0,/well/papiez/users/hri611/python/nnUNet_results/Dataset219_PETCT/nnUNetTrainer_1500epochs_1e2lr__nnUNetPlans__3d_fullres_maxnum_512_patch_192/crossval_results_folds_0_1_2/PETCT_389462c0ac_03032005.nii.gz,/well/papiez/users/hri611/python/nnUnet_raw/Dataset219_PETCT/labelsTr/PETCT_389462c0ac_03032005.nii.gz,0.0,0.5598459434509278,0.0
105,0.0,0,85,0.0,56159915,0,85,0,/well/papiez/users/hri611/python/nnUNet_results/Dataset219_PETCT/nnUNetTrainer_1500epochs_1e2lr__nnUNetPlans__3d_fullres_maxnum_512_patch_192/crossval_results_folds_0_1_2/PETCT_389462c0ac_08292005.nii.gz,/well/papiez/users/hri611/python/nnUnet_raw/Dataset219_PETCT/labelsTr/PETCT_389462c0ac_08292005.nii.gz,0.0,1.0574867820739746,0.0
106,0.0,0,13,0.0,97279987,0,13,0,/well/papiez/users/hri611/python/nnUNet_results/Dataset219_PETCT/nnUNetTrainer_1500epochs_1e2lr__nnUNetPlans__3d_fullres_maxnum_512_patch_192/crossval_results_folds_0_1_2/PETCT_389c968170_02172006.nii.gz,/well/papiez/users/hri611/python/nnUnet_raw/Dataset219_PETCT/labelsTr/PETCT_389c968170_02172006.nii.gz,0.0,0.16173327255249023,0.0
107,,0,0,,100960000,0,0,0,/well/papiez/users/hri611/python/nnUNet_results/Dataset219_PETCT/nnUNetTrainer_1500epochs_1e2lr__nnUNetPlans__3d_fullres_maxnum_512_patch_192/crossval_results_folds_0_1_2/PETCT_389c968170_08192005.nii.gz,/well/papiez/users/hri611/python/nnUnet_raw/Dataset219_PETCT/labelsTr/PETCT_389c968170_08192005.nii.gz,,0.0,0.0
108,0.0,0,919,0.0,52799081,0,919,0,/well/papiez/users/hri611/python/nnUNet_results/Dataset219_PETCT/nnUNetTrainer_1500epochs_1e2lr__nnUNetPlans__3d_fullres_maxnum_512_patch_192/crossval_results_folds_0_1_2/PETCT_38a374d01a_05242007.nii.gz,/well/papiez/users/hri611/python/nnUnet_raw/Dataset219_PETCT/labelsTr/PETCT_38a374d01a_05242007.nii.gz,0.0,11.433298267364501,0.0
109,,0,0,,71520000,0,0,0,/well/papiez/users/hri611/python/nnUNet_results/Dataset219_PETCT/nnUNetTrainer_1500epochs_1e2lr__nnUNetPlans__3d_fullres_maxnum_512_patch_192/crossval_results_folds_0_1_2/PETCT_390129c0d2_04272007.nii.gz,/well/papiez/users/hri611/python/nnUnet_raw/Dataset219_PETCT/labelsTr/PETCT_390129c0d2_04272007.nii.gz,,0.0,0.0
110,0.0,0,67,0.0,65439933,0,67,0,/well/papiez/users/hri611/python/nnUNet_results/Dataset219_PETCT/nnUNetTrainer_1500epochs_1e2lr__nnUNetPlans__3d_fullres_maxnum_512_patch_192/crossval_results_folds_0_1_2/PETCT_39eca178a1_06082003.nii.gz,/well/papiez/users/hri611/python/nnUnet_raw/Dataset219_PETCT/labelsTr/PETCT_39eca178a1_06082003.nii.gz,0.0,0.8335484046936035,0.0
111,,0,0,,49440000,0,0,0,/well/papiez/users/hri611/python/nnUNet_results/Dataset219_PETCT/nnUNetTrainer_1500epochs_1e2lr__nnUNetPlans__3d_fullres_maxnum_512_patch_192/crossval_results_folds_0_1_2/PETCT_3a40a26443_10022005.nii.gz,/well/papiez/users/hri611/python/nnUnet_raw/Dataset219_PETCT/labelsTr/PETCT_3a40a26443_10022005.nii.gz,,0.0,0.0
112,0.6515004840271055,18150,3450,0.48312993539124194,58838210,20190,23640,38340,/well/papiez/users/hri611/python/nnUNet_results/Dataset219_PETCT/nnUNetTrainer_1500epochs_1e2lr__nnUNetPlans__3d_fullres_maxnum_512_patch_192/crossval_results_folds_0_1_2/PETCT_3b1c9155f5_01312003.nii.gz,/well/papiez/users/hri611/python/nnUnet_raw/Dataset219_PETCT/labelsTr/PETCT_3b1c9155f5_01312003.nii.gz,0.6515004840271055,2.2891478576660154,76.47495587539673
113,0.8973068552774756,3649,881,0.8137412112988776,52135679,19791,20672,23440,/well/papiez/users/hri611/python/nnUNet_results/Dataset219_PETCT/nnUNetTrainer_1500epochs_1e2lr__nnUNetPlans__3d_fullres_maxnum_512_patch_192/crossval_results_folds_0_1_2/PETCT_3b26172779_11102001.nii.gz,/well/papiez/users/hri611/python/nnUnet_raw/Dataset219_PETCT/labelsTr/PETCT_3b26172779_11102001.nii.gz,0.8973068552774756,1.3685123062133788,11.707000728607177
114,0.0,0,19,0.0,45439981,0,19,0,/well/papiez/users/hri611/python/nnUNet_results/Dataset219_PETCT/nnUNetTrainer_1500epochs_1e2lr__nnUNetPlans__3d_fullres_maxnum_512_patch_192/crossval_results_folds_0_1_2/PETCT_3b2a4af482_01262003.nii.gz,/well/papiez/users/hri611/python/nnUnet_raw/Dataset219_PETCT/labelsTr/PETCT_3b2a4af482_01262003.nii.gz,0.0,0.23637939834594726,0.0
115,,0,0,,48480000,0,0,0,/well/papiez/users/hri611/python/nnUNet_results/Dataset219_PETCT/nnUNetTrainer_1500epochs_1e2lr__nnUNetPlans__3d_fullres_maxnum_512_patch_192/crossval_results_folds_0_1_2/PETCT_3bce0eb7aa_06032007.nii.gz,/well/papiez/users/hri611/python/nnUnet_raw/Dataset219_PETCT/labelsTr/PETCT_3bce0eb7aa_06032007.nii.gz,,0.0,0.0
116,0.9310344827586207,16,12,0.8709677419354839,45439783,189,201,205,/well/papiez/users/hri611/python/nnUNet_results/Dataset219_PETCT/nnUNetTrainer_1500epochs_1e2lr__nnUNetPlans__3d_fullres_maxnum_512_patch_192/crossval_results_folds_0_1_2/PETCT_3c3050f75e_09052002.nii.gz,/well/papiez/users/hri611/python/nnUnet_raw/Dataset219_PETCT/labelsTr/PETCT_3c3050f75e_09052002.nii.gz,0.9310344827586207,0.0,0.0
117,0.034623614082863255,180,4783,0.017616785431512273,78874948,89,4872,269,/well/papiez/users/hri611/python/nnUNet_results/Dataset219_PETCT/nnUNetTrainer_1500epochs_1e2lr__nnUNetPlans__3d_fullres_maxnum_512_patch_192/crossval_results_folds_0_1_2/PETCT_3c3ee87fc6_06132003.nii.gz,/well/papiez/users/hri611/python/nnUnet_raw/Dataset219_PETCT/labelsTr/PETCT_3c3ee87fc6_06132003.nii.gz,0.034623614082863255,59.505403278350826,2.027886417388916
118,0.8228973332030869,11104,1587,0.6990871369294606,52117825,29484,31071,40588,/well/papiez/users/hri611/python/nnUNet_results/Dataset219_PETCT/nnUNetTrainer_1500epochs_1e2lr__nnUNetPlans__3d_fullres_maxnum_512_patch_192/crossval_results_folds_0_1_2/PETCT_3c71e8f518_12112000.nii.gz,/well/papiez/users/hri611/python/nnUnet_raw/Dataset219_PETCT/labelsTr/PETCT_3c71e8f518_12112000.nii.gz,0.8228973332030869,2.8614348220825194,13.22480528640747
119,0.0,0,14,0.0,94719986,0,14,0,/well/papiez/users/hri611/python/nnUNet_results/Dataset219_PETCT/nnUNetTrainer_1500epochs_1e2lr__nnUNetPlans__3d_fullres_maxnum_512_patch_192/crossval_results_folds_0_1_2/PETCT_3c94a00f90_05112007.nii.gz,/well/papiez/users/hri611/python/nnUnet_raw/Dataset219_PETCT/labelsTr/PETCT_3c94a00f90_05112007.nii.gz,0.0,0.1741742935180664,0.0
120,,0,0,,45440000,0,0,0,/well/papiez/users/hri611/python/nnUNet_results/Dataset219_PETCT/nnUNetTrainer_1500epochs_1e2lr__nnUNetPlans__3d_fullres_maxnum_512_patch_192/crossval_results_folds_0_1_2/PETCT_3cd49210eb_12292002.nii.gz,/well/papiez/users/hri611/python/nnUnet_raw/Dataset219_PETCT/labelsTr/PETCT_3cd49210eb_12292002.nii.gz,,0.0,0.0
121,0.0,0,101,0.0,52159899,0,101,0,/well/papiez/users/hri611/python/nnUNet_results/Dataset219_PETCT/nnUNetTrainer_1500epochs_1e2lr__nnUNetPlans__3d_fullres_maxnum_512_patch_192/crossval_results_folds_0_1_2/PETCT_3cf68da275_03202003.nii.gz,/well/papiez/users/hri611/python/nnUnet_raw/Dataset219_PETCT/labelsTr/PETCT_3cf68da275_03202003.nii.gz,0.0,1.2565431175231934,0.0
122,0.8493310063990692,981,3681,0.7381193124368048,52142198,13140,16821,14121,/well/papiez/users/hri611/python/nnUNet_results/Dataset219_PETCT/nnUNetTrainer_1500epochs_1e2lr__nnUNetPlans__3d_fullres_maxnum_512_patch_192/crossval_results_folds_0_1_2/PETCT_3d6f425a76_01282002.nii.gz,/well/papiez/users/hri611/python/nnUnet_raw/Dataset219_PETCT/labelsTr/PETCT_3d6f425a76_01282002.nii.gz,0.8493310063990692,4.93908532333374,10.94809844970703
123,0.0,0,57,0.0,52159943,0,57,0,/well/papiez/users/hri611/python/nnUNet_results/Dataset219_PETCT/nnUNetTrainer_1500epochs_1e2lr__nnUNetPlans__3d_fullres_maxnum_512_patch_192/crossval_results_folds_0_1_2/PETCT_3d6f425a76_07222002.nii.gz,/well/papiez/users/hri611/python/nnUnet_raw/Dataset219_PETCT/labelsTr/PETCT_3d6f425a76_07222002.nii.gz,0.0,0.7091381950378418,0.0
124,,0,0,,45440000,0,0,0,/well/papiez/users/hri611/python/nnUNet_results/Dataset219_PETCT/nnUNetTrainer_1500epochs_1e2lr__nnUNetPlans__3d_fullres_maxnum_512_patch_192/crossval_results_folds_0_1_2/PETCT_3d8b79d739_11282004.nii.gz,/well/papiez/users/hri611/python/nnUnet_raw/Dataset219_PETCT/labelsTr/PETCT_3d8b79d739_11282004.nii.gz,,0.0,0.0
125,0.86691776522285,1801,319,0.7650969529085873,45430975,6905,7224,8706,/well/papiez/users/hri611/python/nnUNet_results/Dataset219_PETCT/nnUNetTrainer_1500epochs_1e2lr__nnUNetPlans__3d_fullres_maxnum_512_patch_192/crossval_results_folds_0_1_2/PETCT_3eac8f16d4_09302001.nii.gz,/well/papiez/users/hri611/python/nnUnet_raw/Dataset219_PETCT/labelsTr/PETCT_3eac8f16d4_09302001.nii.gz,0.86691776522285,0.0,9.741319416046142
126,0.0,0,26,0.0,52159974,0,26,0,/well/papiez/users/hri611/python/nnUNet_results/Dataset219_PETCT/nnUNetTrainer_1500epochs_1e2lr__nnUNetPlans__3d_fullres_maxnum_512_patch_192/crossval_results_folds_0_1_2/PETCT_3f2ee0274d_09162002.nii.gz,/well/papiez/users/hri611/python/nnUnet_raw/Dataset219_PETCT/labelsTr/PETCT_3f2ee0274d_09162002.nii.gz,0.0,0.32346654510498046,0.0
127,,0,0,,52160000,0,0,0,/well/papiez/users/hri611/python/nnUNet_results/Dataset219_PETCT/nnUNetTrainer_1500epochs_1e2lr__nnUNetPlans__3d_fullres_maxnum_512_patch_192/crossval_results_folds_0_1_2/PETCT_3f3df20439_05092005.nii.gz,/well/papiez/users/hri611/python/nnUnet_raw/Dataset219_PETCT/labelsTr/PETCT_3f3df20439_05092005.nii.gz,,0.0,0.0
128,0.721502011622709,1947,3037,0.5643356643356643,45588560,6456,9493,8403,/well/papiez/users/hri611/python/nnUNet_results/Dataset219_PETCT/nnUNetTrainer_1500epochs_1e2lr__nnUNetPlans__3d_fullres_maxnum_512_patch_192/crossval_results_folds_0_1_2/PETCT_3f5a9f616f_06032007.nii.gz,/well/papiez/users/hri611/python/nnUnet_raw/Dataset219_PETCT/labelsTr/PETCT_3f5a9f616f_06032007.nii.gz,0.721502011622709,0.5722869644165038,7.713432998657226
129,0.7917817924194119,2851,88,0.6553301278292483,45431473,5588,5676,8439,/well/papiez/users/hri611/python/nnUNet_results/Dataset219_PETCT/nnUNetTrainer_1500epochs_1e2lr__nnUNetPlans__3d_fullres_maxnum_512_patch_192/crossval_results_folds_0_1_2/PETCT_3fd361ec14_10242004.nii.gz,/well/papiez/users/hri611/python/nnUnet_raw/Dataset219_PETCT/labelsTr/PETCT_3fd361ec14_10242004.nii.gz,0.7917817924194119,0.0,1.8412711029052735
130,0.0,0,169,0.0,58879831,0,169,0,/well/papiez/users/hri611/python/nnUNet_results/Dataset219_PETCT/nnUNetTrainer_1500epochs_1e2lr__nnUNetPlans__3d_fullres_maxnum_512_patch_192/crossval_results_folds_0_1_2/PETCT_402c061122_02222003.nii.gz,/well/papiez/users/hri611/python/nnUnet_raw/Dataset219_PETCT/labelsTr/PETCT_402c061122_02222003.nii.gz,0.0,2.102532543182373,0.0
131,,0,0,,45440000,0,0,0,/well/papiez/users/hri611/python/nnUNet_results/Dataset219_PETCT/nnUNetTrainer_1500epochs_1e2lr__nnUNetPlans__3d_fullres_maxnum_512_patch_192/crossval_results_folds_0_1_2/PETCT_402c061122_08252003.nii.gz,/well/papiez/users/hri611/python/nnUnet_raw/Dataset219_PETCT/labelsTr/PETCT_402c061122_08252003.nii.gz,,0.0,0.0
132,,0,0,,45120000,0,0,0,/well/papiez/users/hri611/python/nnUNet_results/Dataset219_PETCT/nnUNetTrainer_1500epochs_1e2lr__nnUNetPlans__3d_fullres_maxnum_512_patch_192/crossval_results_folds_0_1_2/PETCT_404f8c732f_06142007.nii.gz,/well/papiez/users/hri611/python/nnUnet_raw/Dataset219_PETCT/labelsTr/PETCT_404f8c732f_06142007.nii.gz,,0.0,0.0
133,,0,0,,53600000,0,0,0,/well/papiez/users/hri611/python/nnUNet_results/Dataset219_PETCT/nnUNetTrainer_1500epochs_1e2lr__nnUNetPlans__3d_fullres_maxnum_512_patch_192/crossval_results_folds_0_1_2/PETCT_416d3b9b78_08142006.nii.gz,/well/papiez/users/hri611/python/nnUnet_raw/Dataset219_PETCT/labelsTr/PETCT_416d3b9b78_08142006.nii.gz,,0.0,0.0
134,0.0,0,62,0.0,52159938,0,62,0,/well/papiez/users/hri611/python/nnUNet_results/Dataset219_PETCT/nnUNetTrainer_1500epochs_1e2lr__nnUNetPlans__3d_fullres_maxnum_512_patch_192/crossval_results_folds_0_1_2/PETCT_41f4d41517_11132004.nii.gz,/well/papiez/users/hri611/python/nnUnet_raw/Dataset219_PETCT/labelsTr/PETCT_41f4d41517_11132004.nii.gz,0.0,0.7713432998657226,0.0
135,0.0157600406710727,0,3872,0.007942608250064053,45436097,31,3903,31,/well/papiez/users/hri611/python/nnUNet_results/Dataset219_PETCT/nnUNetTrainer_1500epochs_1e2lr__nnUNetPlans__3d_fullres_maxnum_512_patch_192/crossval_results_folds_0_1_2/PETCT_41fadf6520_02272003.nii.gz,/well/papiez/users/hri611/python/nnUnet_raw/Dataset219_PETCT/labelsTr/PETCT_41fadf6520_02272003.nii.gz,0.0157600406710727,47.89793071746826,0.0
136,0.8503499382461919,1009,445,0.7396598030438675,92314415,4131,4576,5140,/well/papiez/users/hri611/python/nnUNet_results/Dataset219_PETCT/nnUNetTrainer_1500epochs_1e2lr__nnUNetPlans__3d_fullres_maxnum_512_patch_192/crossval_results_folds_0_1_2/PETCT_424e9b79c5_05112003.nii.gz,/well/papiez/users/hri611/python/nnUnet_raw/Dataset219_PETCT/labelsTr/PETCT_424e9b79c5_05112003.nii.gz,0.8503499382461919,4.851998176574707,0.012441020965576172
137,0.8427115112731602,7697,2872,0.7281775628825677,45401118,28313,31185,36010,/well/papiez/users/hri611/python/nnUNet_results/Dataset219_PETCT/nnUNetTrainer_1500epochs_1e2lr__nnUNetPlans__3d_fullres_maxnum_512_patch_192/crossval_results_folds_0_1_2/PETCT_43323b7d42_05272001.nii.gz,/well/papiez/users/hri611/python/nnUnet_raw/Dataset219_PETCT/labelsTr/PETCT_43323b7d42_05272001.nii.gz,0.8427115112731602,0.0,13.672682041168212
138,0.8481960517358748,36,410,0.7364066193853428,50878308,1246,1656,1282,/well/papiez/users/hri611/python/nnUNet_results/Dataset219_PETCT/nnUNetTrainer_1500epochs_1e2lr__nnUNetPlans__3d_fullres_maxnum_512_patch_192/crossval_results_folds_0_1_2/PETCT_43647ff727_03022006.nii.gz,/well/papiez/users/hri611/python/nnUnet_raw/Dataset219_PETCT/labelsTr/PETCT_43647ff727_03022006.nii.gz,0.8481960517358748,0.24882041931152343,0.0
139,,0,0,,45440000,0,0,0,/well/papiez/users/hri611/python/nnUNet_results/Dataset219_PETCT/nnUNetTrainer_1500epochs_1e2lr__nnUNetPlans__3d_fullres_maxnum_512_patch_192/crossval_results_folds_0_1_2/PETCT_437d2c96fe_11162003.nii.gz,/well/papiez/users/hri611/python/nnUnet_raw/Dataset219_PETCT/labelsTr/PETCT_437d2c96fe_11162003.nii.gz,,0.0,0.0
140,0.0,0,127,0.0,46399873,0,127,0,/well/papiez/users/hri611/python/nnUNet_results/Dataset219_PETCT/nnUNetTrainer_1500epochs_1e2lr__nnUNetPlans__3d_fullres_maxnum_512_patch_192/crossval_results_folds_0_1_2/PETCT_43c9c71b31_05142007.nii.gz,/well/papiez/users/hri611/python/nnUnet_raw/Dataset219_PETCT/labelsTr/PETCT_43c9c71b31_05142007.nii.gz,0.0,1.5800096626281739,0.0
141,0.0,0,286,0.0,52159714,0,286,0,/well/papiez/users/hri611/python/nnUNet_results/Dataset219_PETCT/nnUNetTrainer_1500epochs_1e2lr__nnUNetPlans__3d_fullres_maxnum_512_patch_192/crossval_results_folds_0_1_2/PETCT_44bf7dc508_07252002.nii.gz,/well/papiez/users/hri611/python/nnUnet_raw/Dataset219_PETCT/labelsTr/PETCT_44bf7dc508_07252002.nii.gz,0.0,3.5581319961547853,0.0
142,0.9444796284568292,12,251,0.8948,52157500,2237,2488,2249,/well/papiez/users/hri611/python/nnUNet_results/Dataset219_PETCT/nnUNetTrainer_1500epochs_1e2lr__nnUNetPlans__3d_fullres_maxnum_512_patch_192/crossval_results_folds_0_1_2/PETCT_456d14846b_09012003.nii.gz,/well/papiez/users/hri611/python/nnUnet_raw/Dataset219_PETCT/labelsTr/PETCT_456d14846b_09012003.nii.gz,0.9444796284568292,0.8957535095214844,0.0
143,0.5954198473282443,82,24,0.42391304347826086,52479816,78,102,160,/well/papiez/users/hri611/python/nnUNet_results/Dataset219_PETCT/nnUNetTrainer_1500epochs_1e2lr__nnUNetPlans__3d_fullres_maxnum_512_patch_192/crossval_results_folds_0_1_2/PETCT_456e6f9dc2_07282005.nii.gz,/well/papiez/users/hri611/python/nnUnet_raw/Dataset219_PETCT/labelsTr/PETCT_456e6f9dc2_07282005.nii.gz,0.5954198473282443,0.2985845031738281,0.0
144,0.9538273165336915,1774,564,0.9117302827802318,103813513,24149,24713,25923,/well/papiez/users/hri611/python/nnUNet_results/Dataset219_PETCT/nnUNetTrainer_1500epochs_1e2lr__nnUNetPlans__3d_fullres_maxnum_512_patch_192/crossval_results_folds_0_1_2/PETCT_4776e75543_04012007.nii.gz,/well/papiez/users/hri611/python/nnUnet_raw/Dataset219_PETCT/labelsTr/PETCT_4776e75543_04012007.nii.gz,0.9538273165336915,0.1368512306213379,0.0
145,0.0,0,1585,0.0,51838415,0,1585,0,/well/papiez/users/hri611/python/nnUNet_results/Dataset219_PETCT/nnUNetTrainer_1500epochs_1e2lr__nnUNetPlans__3d_fullres_maxnum_512_patch_192/crossval_results_folds_0_1_2/PETCT_4785066413_08242006.nii.gz,/well/papiez/users/hri611/python/nnUnet_raw/Dataset219_PETCT/labelsTr/PETCT_4785066413_08242006.nii.gz,0.0,19.71901823043823,0.0
146,0.31546851178609125,10944,730,0.18727373990531884,52145636,2690,3420,13634,/well/papiez/users/hri611/python/nnUNet_results/Dataset219_PETCT/nnUNetTrainer_1500epochs_1e2lr__nnUNetPlans__3d_fullres_maxnum_512_patch_192/crossval_results_folds_0_1_2/PETCT_47cd731006_01252002.nii.gz,/well/papiez/users/hri611/python/nnUnet_raw/Dataset219_PETCT/labelsTr/PETCT_47cd731006_01252002.nii.gz,0.31546851178609125,1.3933943481445312,132.17340673828124
147,,0,0,,50400000,0,0,0,/well/papiez/users/hri611/python/nnUNet_results/Dataset219_PETCT/nnUNetTrainer_1500epochs_1e2lr__nnUNetPlans__3d_fullres_maxnum_512_patch_192/crossval_results_folds_0_1_2/PETCT_47f4460050_08062006.nii.gz,/well/papiez/users/hri611/python/nnUnet_raw/Dataset219_PETCT/labelsTr/PETCT_47f4460050_08062006.nii.gz,,0.0,0.0
148,,0,0,,58400000,0,0,0,/well/papiez/users/hri611/python/nnUNet_results/Dataset219_PETCT/nnUNetTrainer_1500epochs_1e2lr__nnUNetPlans__3d_fullres_maxnum_512_patch_192/crossval_results_folds_0_1_2/PETCT_48c70dc4a3_04132007.nii.gz,/well/papiez/users/hri611/python/nnUnet_raw/Dataset219_PETCT/labelsTr/PETCT_48c70dc4a3_04132007.nii.gz,,0.0,0.0
149,0.6713225665648188,703,50,0.5052562417871223,52158478,769,819,1472,/well/papiez/users/hri611/python/nnUNet_results/Dataset219_PETCT/nnUNetTrainer_1500epochs_1e2lr__nnUNetPlans__3d_fullres_maxnum_512_patch_192/crossval_results_folds_0_1_2/PETCT_49f3d297b0_07242003.nii.gz,/well/papiez/users/hri611/python/nnUnet_raw/Dataset219_PETCT/labelsTr/PETCT_49f3d297b0_07242003.nii.gz,0.6713225665648188,0.0,0.8957535095214844
150,0.33571838331160364,1394,125982,0.2017196969222188,52000437,32187,158169,33581,/well/papiez/users/hri611/python/nnUNet_results/Dataset219_PETCT/nnUNetTrainer_1500epochs_1e2lr__nnUNetPlans__3d_fullres_maxnum_512_patch_192/crossval_results_folds_0_1_2/PETCT_4b688f46b0_02182005.nii.gz,/well/papiez/users/hri611/python/nnUnet_raw/Dataset219_PETCT/labelsTr/PETCT_4b688f46b0_02182005.nii.gz,0.33571838331160364,0.6469330902099609,0.6344920692443847
151,,0,0,,44960000,0,0,0,/well/papiez/users/hri611/python/nnUNet_results/Dataset219_PETCT/nnUNetTrainer_1500epochs_1e2lr__nnUNetPlans__3d_fullres_maxnum_512_patch_192/crossval_results_folds_0_1_2/PETCT_4bab91dccd_01052006.nii.gz,/well/papiez/users/hri611/python/nnUnet_raw/Dataset219_PETCT/labelsTr/PETCT_4bab91dccd_01052006.nii.gz,,0.0,0.0
152,0.745431518002533,1145,262,0.594173637150274,45436533,2060,2322,3205,/well/papiez/users/hri611/python/nnUNet_results/Dataset219_PETCT/nnUNetTrainer_1500epochs_1e2lr__nnUNetPlans__3d_fullres_maxnum_512_patch_192/crossval_results_folds_0_1_2/PETCT_4be28f9cd7_02032002.nii.gz,/well/papiez/users/hri611/python/nnUnet_raw/Dataset219_PETCT/labelsTr/PETCT_4be28f9cd7_02032002.nii.gz,0.745431518002533,2.3762350044250486,0.6966971740722656
153,0.4518855216784249,83003,6110,0.29189412540624726,52034153,36734,42844,119737,/well/papiez/users/hri611/python/nnUNet_results/Dataset219_PETCT/nnUNetTrainer_1500epochs_1e2lr__nnUNetPlans__3d_fullres_maxnum_512_patch_192/crossval_results_folds_0_1_2/PETCT_4c75fa4a5d_04192001.nii.gz,/well/papiez/users/hri611/python/nnUnet_raw/Dataset219_PETCT/labelsTr/PETCT_4c75fa4a5d_04192001.nii.gz,0.4518855216784249,0.0,510.28091592407225
154,0.8797765984453766,6652,3293,0.7853581680443744,52113667,36388,39681,43040,/well/papiez/users/hri611/python/nnUNet_results/Dataset219_PETCT/nnUNetTrainer_1500epochs_1e2lr__nnUNetPlans__3d_fullres_maxnum_512_patch_192/crossval_results_folds_0_1_2/PETCT_4c9e7be363_09172000.nii.gz,/well/papiez/users/hri611/python/nnUnet_raw/Dataset219_PETCT/labelsTr/PETCT_4c9e7be363_09172000.nii.gz,0.8797765984453766,2.189619689941406,0.4478767547607422
155,,0,0,,52160000,0,0,0,/well/papiez/users/hri611/python/nnUNet_results/Dataset219_PETCT/nnUNetTrainer_1500epochs_1e2lr__nnUNetPlans__3d_fullres_maxnum_512_patch_192/crossval_results_folds_0_1_2/PETCT_4ea806706c_10302003.nii.gz,/well/papiez/users/hri611/python/nnUnet_raw/Dataset219_PETCT/labelsTr/PETCT_4ea806706c_10302003.nii.gz,,0.0,0.0
156,0.0,0,40,0.0,42399960,0,40,0,/well/papiez/users/hri611/python/nnUNet_results/Dataset219_PETCT/nnUNetTrainer_1500epochs_1e2lr__nnUNetPlans__3d_fullres_maxnum_512_patch_192/crossval_results_folds_0_1_2/PETCT_4fb1817df3_06062005.nii.gz,/well/papiez/users/hri611/python/nnUnet_raw/Dataset219_PETCT/labelsTr/PETCT_4fb1817df3_06062005.nii.gz,0.0,0.49764083862304687,0.0
157,0.51953125,157,89,0.35092348284960423,52159621,133,222,290,/well/papiez/users/hri611/python/nnUNet_results/Dataset219_PETCT/nnUNetTrainer_1500epochs_1e2lr__nnUNetPlans__3d_fullres_maxnum_512_patch_192/crossval_results_folds_0_1_2/PETCT_5060603ba4_09192003.nii.gz,/well/papiez/users/hri611/python/nnUnet_raw/Dataset219_PETCT/labelsTr/PETCT_5060603ba4_09192003.nii.gz,0.51953125,0.9952816772460937,1.953240291595459
158,0.9570638582649431,2004,1653,0.9176629517055049,45395585,40758,42411,42762,/well/papiez/users/hri611/python/nnUNet_results/Dataset219_PETCT/nnUNetTrainer_1500epochs_1e2lr__nnUNetPlans__3d_fullres_maxnum_512_patch_192/crossval_results_folds_0_1_2/PETCT_510fb36781_02062003.nii.gz,/well/papiez/users/hri611/python/nnUnet_raw/Dataset219_PETCT/labelsTr/PETCT_510fb36781_02062003.nii.gz,0.9570638582649431,0.037323062896728515,0.0
159,,0,0,,48480000,0,0,0,/well/papiez/users/hri611/python/nnUNet_results/Dataset219_PETCT/nnUNetTrainer_1500epochs_1e2lr__nnUNetPlans__3d_fullres_maxnum_512_patch_192/crossval_results_folds_0_1_2/PETCT_53ccb9efbb_12152005.nii.gz,/well/papiez/users/hri611/python/nnUnet_raw/Dataset219_PETCT/labelsTr/PETCT_53ccb9efbb_12152005.nii.gz,,0.0,0.0
160,0.7538504274823297,697,7278,0.6049437756972309,50059813,12212,19490,12909,/well/papiez/users/hri611/python/nnUNet_results/Dataset219_PETCT/nnUNetTrainer_1500epochs_1e2lr__nnUNetPlans__3d_fullres_maxnum_512_patch_192/crossval_results_folds_0_1_2/PETCT_53dad1785b_12112005.nii.gz,/well/papiez/users/hri611/python/nnUnet_raw/Dataset219_PETCT/labelsTr/PETCT_53dad1785b_12112005.nii.gz,0.7538504274823297,30.90349607849121,4.503649589538574
161,,0,0,,46080000,0,0,0,/well/papiez/users/hri611/python/nnUNet_results/Dataset219_PETCT/nnUNetTrainer_1500epochs_1e2lr__nnUNetPlans__3d_fullres_maxnum_512_patch_192/crossval_results_folds_0_1_2/PETCT_5420205a5f_12072006.nii.gz,/well/papiez/users/hri611/python/nnUnet_raw/Dataset219_PETCT/labelsTr/PETCT_5420205a5f_12072006.nii.gz,,0.0,0.0
162,,0,0,,50560000,0,0,0,/well/papiez/users/hri611/python/nnUNet_results/Dataset219_PETCT/nnUNetTrainer_1500epochs_1e2lr__nnUNetPlans__3d_fullres_maxnum_512_patch_192/crossval_results_folds_0_1_2/PETCT_544676de40_12152005.nii.gz,/well/papiez/users/hri611/python/nnUnet_raw/Dataset219_PETCT/labelsTr/PETCT_544676de40_12152005.nii.gz,,0.0,0.0
163,0.9122250842084406,959,370,0.838615664845173,48791765,6906,7276,7865,/well/papiez/users/hri611/python/nnUNet_results/Dataset219_PETCT/nnUNetTrainer_1500epochs_1e2lr__nnUNetPlans__3d_fullres_maxnum_512_patch_192/crossval_results_folds_0_1_2/PETCT_548213edf7_09192005.nii.gz,/well/papiez/users/hri611/python/nnUnet_raw/Dataset219_PETCT/labelsTr/PETCT_548213edf7_09192005.nii.gz,0.9122250842084406,0.0,4.267270191192627
164,,0,0,,45440000,0,0,0,/well/papiez/users/hri611/python/nnUNet_results/Dataset219_PETCT/nnUNetTrainer_1500epochs_1e2lr__nnUNetPlans__3d_fullres_maxnum_512_patch_192/crossval_results_folds_0_1_2/PETCT_54977a7e76_02212003.nii.gz,/well/papiez/users/hri611/python/nnUnet_raw/Dataset219_PETCT/labelsTr/PETCT_54977a7e76_02212003.nii.gz,,0.0,0.0
165,0.9733131746422419,44,715,0.948013698630137,58865400,13841,14556,13885,/well/papiez/users/hri611/python/nnUNet_results/Dataset219_PETCT/nnUNetTrainer_1500epochs_1e2lr__nnUNetPlans__3d_fullres_maxnum_512_patch_192/crossval_results_folds_0_1_2/PETCT_556b56485a_08292003.nii.gz,/well/papiez/users/hri611/python/nnUnet_raw/Dataset219_PETCT/labelsTr/PETCT_556b56485a_08292003.nii.gz,0.9733131746422419,0.0,0.024882041931152343
166,0.0,58,0,0.0,52159942,0,0,58,/well/papiez/users/hri611/python/nnUNet_results/Dataset219_PETCT/nnUNetTrainer_1500epochs_1e2lr__nnUNetPlans__3d_fullres_maxnum_512_patch_192/crossval_results_folds_0_1_2/PETCT_55ae7986e1_05102003.nii.gz,/well/papiez/users/hri611/python/nnUnet_raw/Dataset219_PETCT/labelsTr/PETCT_55ae7986e1_05102003.nii.gz,0.0,0.0,0.721579216003418
167,,0,0,,51520000,0,0,0,/well/papiez/users/hri611/python/nnUNet_results/Dataset219_PETCT/nnUNetTrainer_1500epochs_1e2lr__nnUNetPlans__3d_fullres_maxnum_512_patch_192/crossval_results_folds_0_1_2/PETCT_55e3e62722_03032007.nii.gz,/well/papiez/users/hri611/python/nnUnet_raw/Dataset219_PETCT/labelsTr/PETCT_55e3e62722_03032007.nii.gz,,0.0,0.0
168,0.9305352636472307,500,23,0.8700943864878291,52155974,3503,3526,4003,/well/papiez/users/hri611/python/nnUNet_results/Dataset219_PETCT/nnUNetTrainer_1500epochs_1e2lr__nnUNetPlans__3d_fullres_maxnum_512_patch_192/crossval_results_folds_0_1_2/PETCT_581fa95eb0_03242003.nii.gz,/well/papiez/users/hri611/python/nnUnet_raw/Dataset219_PETCT/labelsTr/PETCT_581fa95eb0_03242003.nii.gz,0.9305352636472307,0.0,0.0
169,,0,0,,52160000,0,0,0,/well/papiez/users/hri611/python/nnUNet_results/Dataset219_PETCT/nnUNetTrainer_1500epochs_1e2lr__nnUNetPlans__3d_fullres_maxnum_512_patch_192/crossval_results_folds_0_1_2/PETCT_591b3025ff_11132004.nii.gz,/well/papiez/users/hri611/python/nnUnet_raw/Dataset219_PETCT/labelsTr/PETCT_591b3025ff_11132004.nii.gz,,0.0,0.0
170,0.0,0,113,0.0,48159887,0,113,0,/well/papiez/users/hri611/python/nnUNet_results/Dataset219_PETCT/nnUNetTrainer_1500epochs_1e2lr__nnUNetPlans__3d_fullres_maxnum_512_patch_192/crossval_results_folds_0_1_2/PETCT_595975bc57_03102006.nii.gz,/well/papiez/users/hri611/python/nnUnet_raw/Dataset219_PETCT/labelsTr/PETCT_595975bc57_03102006.nii.gz,0.0,1.4058353691101073,0.0
171,0.8268388286834217,1203,299,0.7047955974842768,51194912,3586,3885,4789,/well/papiez/users/hri611/python/nnUNet_results/Dataset219_PETCT/nnUNetTrainer_1500epochs_1e2lr__nnUNetPlans__3d_fullres_maxnum_512_patch_192/crossval_results_folds_0_1_2/PETCT_59e6d1de22_08062005.nii.gz,/well/papiez/users/hri611/python/nnUnet_raw/Dataset219_PETCT/labelsTr/PETCT_59e6d1de22_08062005.nii.gz,0.8268388286834217,0.0,0.3110255241394043
172,0.9150739136926982,3855,695,0.8434435536592919,52130937,24513,25208,28368,/well/papiez/users/hri611/python/nnUNet_results/Dataset219_PETCT/nnUNetTrainer_1500epochs_1e2lr__nnUNetPlans__3d_fullres_maxnum_512_patch_192/crossval_results_folds_0_1_2/PETCT_5ac322455f_05262003.nii.gz,/well/papiez/users/hri611/python/nnUnet_raw/Dataset219_PETCT/labelsTr/PETCT_5ac322455f_05262003.nii.gz,0.9150739136926982,0.04976408386230469,1.306307201385498
173,,0,0,,52160000,0,0,0,/well/papiez/users/hri611/python/nnUNet_results/Dataset219_PETCT/nnUNetTrainer_1500epochs_1e2lr__nnUNetPlans__3d_fullres_maxnum_512_patch_192/crossval_results_folds_0_1_2/PETCT_5ac4fd9091_11142004.nii.gz,/well/papiez/users/hri611/python/nnUnet_raw/Dataset219_PETCT/labelsTr/PETCT_5ac4fd9091_11142004.nii.gz,,0.0,0.0
174,,0,0,,47520000,0,0,0,/well/papiez/users/hri611/python/nnUNet_results/Dataset219_PETCT/nnUNetTrainer_1500epochs_1e2lr__nnUNetPlans__3d_fullres_maxnum_512_patch_192/crossval_results_folds_0_1_2/PETCT_5b0aa4e971_09102006.nii.gz,/well/papiez/users/hri611/python/nnUnet_raw/Dataset219_PETCT/labelsTr/PETCT_5b0aa4e971_09102006.nii.gz,,0.0,0.0
175,0.0,611,47,0.0,52159342,0,47,611,/well/papiez/users/hri611/python/nnUNet_results/Dataset219_PETCT/nnUNetTrainer_1500epochs_1e2lr__nnUNetPlans__3d_fullres_maxnum_512_patch_192/crossval_results_folds_0_1_2/PETCT_5c1baad5d8_03062003.nii.gz,/well/papiez/users/hri611/python/nnUnet_raw/Dataset219_PETCT/labelsTr/PETCT_5c1baad5d8_03062003.nii.gz,0.0,0.58472798538208,7.601463809967041
176,0.8147465437788018,188,13,0.687402799377916,45439357,442,455,630,/well/papiez/users/hri611/python/nnUNet_results/Dataset219_PETCT/nnUNetTrainer_1500epochs_1e2lr__nnUNetPlans__3d_fullres_maxnum_512_patch_192/crossval_results_folds_0_1_2/PETCT_5c35fcbe89_08102002.nii.gz,/well/papiez/users/hri611/python/nnUnet_raw/Dataset219_PETCT/labelsTr/PETCT_5c35fcbe89_08102002.nii.gz,0.8147465437788018,0.0,0.0
177,0.8395779679322091,3026,6629,0.7235108820160366,45405080,25265,31894,28291,/well/papiez/users/hri611/python/nnUNet_results/Dataset219_PETCT/nnUNetTrainer_1500epochs_1e2lr__nnUNetPlans__3d_fullres_maxnum_512_patch_192/crossval_results_folds_0_1_2/PETCT_5c55b3087d_12112000.nii.gz,/well/papiez/users/hri611/python/nnUnet_raw/Dataset219_PETCT/labelsTr/PETCT_5c55b3087d_12112000.nii.gz,0.8395779679322091,60.18965943145752,12.217082588195801
178,,0,0,,45440000,0,0,0,/well/papiez/users/hri611/python/nnUNet_results/Dataset219_PETCT/nnUNetTrainer_1500epochs_1e2lr__nnUNetPlans__3d_fullres_maxnum_512_patch_192/crossval_results_folds_0_1_2/PETCT_5c57a98a43_02242005.nii.gz,/well/papiez/users/hri611/python/nnUnet_raw/Dataset219_PETCT/labelsTr/PETCT_5c57a98a43_02242005.nii.gz,,0.0,0.0
179,0.901521966849467,1576,6415,0.8207009513552325,47315432,36577,42992,38153,/well/papiez/users/hri611/python/nnUNet_results/Dataset219_PETCT/nnUNetTrainer_1500epochs_1e2lr__nnUNetPlans__3d_fullres_maxnum_512_patch_192/crossval_results_folds_0_1_2/PETCT_5d10be5b89_05302005.nii.gz,/well/papiez/users/hri611/python/nnUnet_raw/Dataset219_PETCT/labelsTr/PETCT_5d10be5b89_05302005.nii.gz,0.901521966849467,4.914203281402588,1.0077226982116698
180,0.6111111111111112,1,13,0.44,46719975,11,24,12,/well/papiez/users/hri611/python/nnUNet_results/Dataset219_PETCT/nnUNetTrainer_1500epochs_1e2lr__nnUNetPlans__3d_fullres_maxnum_512_patch_192/crossval_results_folds_0_1_2/PETCT_5d994c3f44_03052006.nii.gz,/well/papiez/users/hri611/python/nnUnet_raw/Dataset219_PETCT/labelsTr/PETCT_5d994c3f44_03052006.nii.gz,0.6111111111111112,0.11196918869018554,0.0
181,0.9362012395187751,141,34,0.8800548320767649,47518541,1284,1318,1425,/well/papiez/users/hri611/python/nnUNet_results/Dataset219_PETCT/nnUNetTrainer_1500epochs_1e2lr__nnUNetPlans__3d_fullres_maxnum_512_patch_192/crossval_results_folds_0_1_2/PETCT_5de3ac617a_11132005.nii.gz,/well/papiez/users/hri611/python/nnUnet_raw/Dataset219_PETCT/labelsTr/PETCT_5de3ac617a_11132005.nii.gz,0.9362012395187751,0.0,0.0
182,0.0,0,8,0.0,46399992,0,8,0,/well/papiez/users/hri611/python/nnUNet_results/Dataset219_PETCT/nnUNetTrainer_1500epochs_1e2lr__nnUNetPlans__3d_fullres_maxnum_512_patch_192/crossval_results_folds_0_1_2/PETCT_5e339b2ecf_05272006.nii.gz,/well/papiez/users/hri611/python/nnUnet_raw/Dataset219_PETCT/labelsTr/PETCT_5e339b2ecf_05272006.nii.gz,0.0,0.09952816772460937,0.0
183,0.48754683711703767,2285,40,0.32235499854269895,45436569,1106,1146,3391,/well/papiez/users/hri611/python/nnUNet_results/Dataset219_PETCT/nnUNetTrainer_1500epochs_1e2lr__nnUNetPlans__3d_fullres_maxnum_512_patch_192/crossval_results_folds_0_1_2/PETCT_5e8b013935_12162001.nii.gz,/well/papiez/users/hri611/python/nnUnet_raw/Dataset219_PETCT/labelsTr/PETCT_5e8b013935_12162001.nii.gz,0.48754683711703767,0.0,24.434165176391602
184,0.0,0,17,0.0,45439983,0,17,0,/well/papiez/users/hri611/python/nnUNet_results/Dataset219_PETCT/nnUNetTrainer_1500epochs_1e2lr__nnUNetPlans__3d_fullres_maxnum_512_patch_192/crossval_results_folds_0_1_2/PETCT_5fa9d9a820_03242003.nii.gz,/well/papiez/users/hri611/python/nnUnet_raw/Dataset219_PETCT/labelsTr/PETCT_5fa9d9a820_03242003.nii.gz,0.0,0.21149735641479492,0.0
185,0.0,0,148,0.0,45439852,0,148,0,/well/papiez/users/hri611/python/nnUNet_results/Dataset219_PETCT/nnUNetTrainer_1500epochs_1e2lr__nnUNetPlans__3d_fullres_maxnum_512_patch_192/crossval_results_folds_0_1_2/PETCT_5fa9d9a820_09152002.nii.gz,/well/papiez/users/hri611/python/nnUnet_raw/Dataset219_PETCT/labelsTr/PETCT_5fa9d9a820_09152002.nii.gz,0.0,1.8412711029052735,0.0
186,0.0,0,46,0.0,52159954,0,46,0,/well/papiez/users/hri611/python/nnUNet_results/Dataset219_PETCT/nnUNetTrainer_1500epochs_1e2lr__nnUNetPlans__3d_fullres_maxnum_512_patch_192/crossval_results_folds_0_1_2/PETCT_5fa9d9a820_09272004.nii.gz,/well/papiez/users/hri611/python/nnUnet_raw/Dataset219_PETCT/labelsTr/PETCT_5fa9d9a820_09272004.nii.gz,0.0,0.5722869644165038,0.0
187,0.0,0,80,0.0,52159920,0,80,0,/well/papiez/users/hri611/python/nnUNet_results/Dataset219_PETCT/nnUNetTrainer_1500epochs_1e2lr__nnUNetPlans__3d_fullres_maxnum_512_patch_192/crossval_results_folds_0_1_2/PETCT_6016a6c3af_07012002.nii.gz,/well/papiez/users/hri611/python/nnUnet_raw/Dataset219_PETCT/labelsTr/PETCT_6016a6c3af_07012002.nii.gz,0.0,0.9952816772460937,0.0
188,0.0,0,152,0.0,50879848,0,152,0,/well/papiez/users/hri611/python/nnUNet_results/Dataset219_PETCT/nnUNetTrainer_1500epochs_1e2lr__nnUNetPlans__3d_fullres_maxnum_512_patch_192/crossval_results_folds_0_1_2/PETCT_607c1b38e3_04142007.nii.gz,/well/papiez/users/hri611/python/nnUnet_raw/Dataset219_PETCT/labelsTr/PETCT_607c1b38e3_04142007.nii.gz,0.0,1.891035186767578,0.0
189,0.0,0,3,0.0,48639997,0,3,0,/well/papiez/users/hri611/python/nnUNet_results/Dataset219_PETCT/nnUNetTrainer_1500epochs_1e2lr__nnUNetPlans__3d_fullres_maxnum_512_patch_192/crossval_results_folds_0_1_2/PETCT_607c1b38e3_10162006.nii.gz,/well/papiez/users/hri611/python/nnUnet_raw/Dataset219_PETCT/labelsTr/PETCT_607c1b38e3_10162006.nii.gz,0.0,0.037323062896728515,0.0
190,0.7899179095849231,1529,288,0.6527804318746417,45434767,3416,3704,4945,/well/papiez/users/hri611/python/nnUNet_results/Dataset219_PETCT/nnUNetTrainer_1500epochs_1e2lr__nnUNetPlans__3d_fullres_maxnum_512_patch_192/crossval_results_folds_0_1_2/PETCT_60baa6979c_08162003.nii.gz,/well/papiez/users/hri611/python/nnUnet_raw/Dataset219_PETCT/labelsTr/PETCT_60baa6979c_08162003.nii.gz,0.7899179095849231,0.24882041931152343,0.4727587966918945
191,0.868636402790938,1209,316,0.767778285366225,45433433,5042,5358,6251,/well/papiez/users/hri611/python/nnUNet_results/Dataset219_PETCT/nnUNetTrainer_1500epochs_1e2lr__nnUNetPlans__3d_fullres_maxnum_512_patch_192/crossval_results_folds_0_1_2/PETCT_61663450f8_08162003.nii.gz,/well/papiez/users/hri611/python/nnUnet_raw/Dataset219_PETCT/labelsTr/PETCT_61663450f8_08162003.nii.gz,0.868636402790938,0.4727587966918945,0.0
192,0.8978831299015272,7062,1597,0.8146895799002718,45393273,38068,39665,45130,/well/papiez/users/hri611/python/nnUNet_results/Dataset219_PETCT/nnUNetTrainer_1500epochs_1e2lr__nnUNetPlans__3d_fullres_maxnum_512_patch_192/crossval_results_folds_0_1_2/PETCT_6170317f2e_02182000.nii.gz,/well/papiez/users/hri611/python/nnUnet_raw/Dataset219_PETCT/labelsTr/PETCT_6170317f2e_02182000.nii.gz,0.8978831299015272,7.788079124450683,6.120982315063476
193,0.0,0,305,0.0,58079695,0,305,0,/well/papiez/users/hri611/python/nnUNet_results/Dataset219_PETCT/nnUNetTrainer_1500epochs_1e2lr__nnUNetPlans__3d_fullres_maxnum_512_patch_192/crossval_results_folds_0_1_2/PETCT_61d5bc58fc_06152007.nii.gz,/well/papiez/users/hri611/python/nnUnet_raw/Dataset219_PETCT/labelsTr/PETCT_61d5bc58fc_06152007.nii.gz,0.0,3.7945113945007325,0.0
194,0.0,0,92,0.0,59839908,0,92,0,/well/papiez/users/hri611/python/nnUNet_results/Dataset219_PETCT/nnUNetTrainer_1500epochs_1e2lr__nnUNetPlans__3d_fullres_maxnum_512_patch_192/crossval_results_folds_0_1_2/PETCT_61d5bc58fc_06182005.nii.gz,/well/papiez/users/hri611/python/nnUnet_raw/Dataset219_PETCT/labelsTr/PETCT_61d5bc58fc_06182005.nii.gz,0.0,1.1445739288330077,0.0
195,0.0,0,489,0.0,55999511,0,489,0,/well/papiez/users/hri611/python/nnUNet_results/Dataset219_PETCT/nnUNetTrainer_1500epochs_1e2lr__nnUNetPlans__3d_fullres_maxnum_512_patch_192/crossval_results_folds_0_1_2/PETCT_61d5bc58fc_12152005.nii.gz,/well/papiez/users/hri611/python/nnUnet_raw/Dataset219_PETCT/labelsTr/PETCT_61d5bc58fc_12152005.nii.gz,0.0,6.083659252166748,0.0
196,0.9255295262330664,5995,970,0.8613820005572583,52109754,43281,44251,49276,/well/papiez/users/hri611/python/nnUNet_results/Dataset219_PETCT/nnUNetTrainer_1500epochs_1e2lr__nnUNetPlans__3d_fullres_maxnum_512_patch_192/crossval_results_folds_0_1_2/PETCT_62011ff15b_05052005.nii.gz,/well/papiez/users/hri611/python/nnUnet_raw/Dataset219_PETCT/labelsTr/PETCT_62011ff15b_05052005.nii.gz,0.9255295262330664,0.06220510482788086,11.955821147918702
197,,0,0,,52160000,0,0,0,/well/papiez/users/hri611/python/nnUNet_results/Dataset219_PETCT/nnUNetTrainer_1500epochs_1e2lr__nnUNetPlans__3d_fullres_maxnum_512_patch_192/crossval_results_folds_0_1_2/PETCT_62b114e09b_06092003.nii.gz,/well/papiez/users/hri611/python/nnUnet_raw/Dataset219_PETCT/labelsTr/PETCT_62b114e09b_06092003.nii.gz,,0.0,0.0
198,0.8860915492957746,225,3657,0.7954796902165323,52141019,15099,18756,15324,/well/papiez/users/hri611/python/nnUNet_results/Dataset219_PETCT/nnUNetTrainer_1500epochs_1e2lr__nnUNetPlans__3d_fullres_maxnum_512_patch_192/crossval_results_folds_0_1_2/PETCT_62ced197ca_04142003.nii.gz,/well/papiez/users/hri611/python/nnUnet_raw/Dataset219_PETCT/labelsTr/PETCT_62ced197ca_04142003.nii.gz,0.8860915492957746,0.0,0.0
199,,0,0,,52160000,0,0,0,/well/papiez/users/hri611/python/nnUNet_results/Dataset219_PETCT/nnUNetTrainer_1500epochs_1e2lr__nnUNetPlans__3d_fullres_maxnum_512_patch_192/crossval_results_folds_0_1_2/PETCT_63464433c8_01042003.nii.gz,/well/papiez/users/hri611/python/nnUnet_raw/Dataset219_PETCT/labelsTr/PETCT_63464433c8_01042003.nii.gz,,0.0,0.0
200,0.9276328502415458,494,1004,0.8650328858455717,45428901,9601,10605,10095,/well/papiez/users/hri611/python/nnUNet_results/Dataset219_PETCT/nnUNetTrainer_1500epochs_1e2lr__nnUNetPlans__3d_fullres_maxnum_512_patch_192/crossval_results_folds_0_1_2/PETCT_63508c679d_02172005.nii.gz,/well/papiez/users/hri611/python/nnUnet_raw/Dataset219_PETCT/labelsTr/PETCT_63508c679d_02172005.nii.gz,0.9276328502415458,5.26255186843872,0.0
201,0.0,0,125,0.0,45759875,0,125,0,/well/papiez/users/hri611/python/nnUNet_results/Dataset219_PETCT/nnUNetTrainer_1500epochs_1e2lr__nnUNetPlans__3d_fullres_maxnum_512_patch_192/crossval_results_folds_0_1_2/PETCT_63508c679d_08212005.nii.gz,/well/papiez/users/hri611/python/nnUnet_raw/Dataset219_PETCT/labelsTr/PETCT_63508c679d_08212005.nii.gz,0.0,1.5551276206970215,0.0
202,0.9061965811965812,583,295,0.8284821254151201,52154881,4241,4536,4824,/well/papiez/users/hri611/python/nnUNet_results/Dataset219_PETCT/nnUNetTrainer_1500epochs_1e2lr__nnUNetPlans__3d_fullres_maxnum_512_patch_192/crossval_results_folds_0_1_2/PETCT_64909533c5_04142003.nii.gz,/well/papiez/users/hri611/python/nnUnet_raw/Dataset219_PETCT/labelsTr/PETCT_64909533c5_04142003.nii.gz,0.9061965811965812,0.0,0.0
203,,0,0,,49920000,0,0,0,/well/papiez/users/hri611/python/nnUNet_results/Dataset219_PETCT/nnUNetTrainer_1500epochs_1e2lr__nnUNetPlans__3d_fullres_maxnum_512_patch_192/crossval_results_folds_0_1_2/PETCT_64aff75516_01202006.nii.gz,/well/papiez/users/hri611/python/nnUnet_raw/Dataset219_PETCT/labelsTr/PETCT_64aff75516_01202006.nii.gz,,0.0,0.0
204,,0,0,,47840000,0,0,0,/well/papiez/users/hri611/python/nnUNet_results/Dataset219_PETCT/nnUNetTrainer_1500epochs_1e2lr__nnUNetPlans__3d_fullres_maxnum_512_patch_192/crossval_results_folds_0_1_2/PETCT_64aff75516_10162005.nii.gz,/well/papiez/users/hri611/python/nnUnet_raw/Dataset219_PETCT/labelsTr/PETCT_64aff75516_10162005.nii.gz,,0.0,0.0
205,,0,0,,41920000,0,0,0,/well/papiez/users/hri611/python/nnUNet_results/Dataset219_PETCT/nnUNetTrainer_1500epochs_1e2lr__nnUNetPlans__3d_fullres_maxnum_512_patch_192/crossval_results_folds_0_1_2/PETCT_64c0cba177_08072006.nii.gz,/well/papiez/users/hri611/python/nnUnet_raw/Dataset219_PETCT/labelsTr/PETCT_64c0cba177_08072006.nii.gz,,0.0,0.0
206,0.5208681135225376,285,2,0.35214446952595935,92319557,156,158,441,/well/papiez/users/hri611/python/nnUNet_results/Dataset219_PETCT/nnUNetTrainer_1500epochs_1e2lr__nnUNetPlans__3d_fullres_maxnum_512_patch_192/crossval_results_folds_0_1_2/PETCT_65346b03b8_03142004.nii.gz,/well/papiez/users/hri611/python/nnUnet_raw/Dataset219_PETCT/labelsTr/PETCT_65346b03b8_03142004.nii.gz,0.5208681135225376,0.0,2.6499374656677244
207,0.6916011463002425,3824,373,0.5285858699314838,45431097,4706,5079,8530,/well/papiez/users/hri611/python/nnUNet_results/Dataset219_PETCT/nnUNetTrainer_1500epochs_1e2lr__nnUNetPlans__3d_fullres_maxnum_512_patch_192/crossval_results_folds_0_1_2/PETCT_65a1330e90_06162001.nii.gz,/well/papiez/users/hri611/python/nnUnet_raw/Dataset219_PETCT/labelsTr/PETCT_65a1330e90_06162001.nii.gz,0.6916011463002425,0.0,33.030910663604736
208,0.0,0,4359,0.0,52155641,0,4359,0,/well/papiez/users/hri611/python/nnUNet_results/Dataset219_PETCT/nnUNetTrainer_1500epochs_1e2lr__nnUNetPlans__3d_fullres_maxnum_512_patch_192/crossval_results_folds_0_1_2/PETCT_674c49778c_12222002.nii.gz,/well/papiez/users/hri611/python/nnUnet_raw/Dataset219_PETCT/labelsTr/PETCT_674c49778c_12222002.nii.gz,0.0,54.23041038894653,0.0
209,0.6828822015394186,10518,15479,0.5184670667555753,52106012,27991,43470,38509,/well/papiez/users/hri611/python/nnUNet_results/Dataset219_PETCT/nnUNetTrainer_1500epochs_1e2lr__nnUNetPlans__3d_fullres_maxnum_512_patch_192/crossval_results_folds_0_1_2/PETCT_685d7c09b5_12232000.nii.gz,/well/papiez/users/hri611/python/nnUnet_raw/Dataset219_PETCT/labelsTr/PETCT_685d7c09b5_12232000.nii.gz,0.6828822015394186,0.9579586143493652,2.0030043754577638
210,0.9695840380701202,955,106,0.9409637213443134,45422028,16911,17017,17866,/well/papiez/users/hri611/python/nnUNet_results/Dataset219_PETCT/nnUNetTrainer_1500epochs_1e2lr__nnUNetPlans__3d_fullres_maxnum_512_patch_192/crossval_results_folds_0_1_2/PETCT_68f73c4518_11132004.nii.gz,/well/papiez/users/hri611/python/nnUnet_raw/Dataset219_PETCT/labelsTr/PETCT_68f73c4518_11132004.nii.gz,0.9695840380701202,0.0,0.0
211,,0,0,,50560000,0,0,0,/well/papiez/users/hri611/python/nnUNet_results/Dataset219_PETCT/nnUNetTrainer_1500epochs_1e2lr__nnUNetPlans__3d_fullres_maxnum_512_patch_192/crossval_results_folds_0_1_2/PETCT_69606f6a25_08132006.nii.gz,/well/papiez/users/hri611/python/nnUnet_raw/Dataset219_PETCT/labelsTr/PETCT_69606f6a25_08132006.nii.gz,,0.0,0.0
212,,0,0,,44320000,0,0,0,/well/papiez/users/hri611/python/nnUNet_results/Dataset219_PETCT/nnUNetTrainer_1500epochs_1e2lr__nnUNetPlans__3d_fullres_maxnum_512_patch_192/crossval_results_folds_0_1_2/PETCT_69c90b6820_11212005.nii.gz,/well/papiez/users/hri611/python/nnUnet_raw/Dataset219_PETCT/labelsTr/PETCT_69c90b6820_11212005.nii.gz,,0.0,0.0
213,0.8683761978712927,21752,9523,0.7673718034542777,45305558,103167,112690,124919,/well/papiez/users/hri611/python/nnUNet_results/Dataset219_PETCT/nnUNetTrainer_1500epochs_1e2lr__nnUNetPlans__3d_fullres_maxnum_512_patch_192/crossval_results_folds_0_1_2/PETCT_6a3477cd9a_01152005.nii.gz,/well/papiez/users/hri611/python/nnUnet_raw/Dataset219_PETCT/labelsTr/PETCT_6a3477cd9a_01152005.nii.gz,0.8683761978712927,11.035185596466064,22.841714492797852
214,0.46014856454527203,2615,74,0.29882659713168186,45436165,1146,1220,3761,/well/papiez/users/hri611/python/nnUNet_results/Dataset219_PETCT/nnUNetTrainer_1500epochs_1e2lr__nnUNetPlans__3d_fullres_maxnum_512_patch_192/crossval_results_folds_0_1_2/PETCT_6aea5c3a03_12272001.nii.gz,/well/papiez/users/hri611/python/nnUnet_raw/Dataset219_PETCT/labelsTr/PETCT_6aea5c3a03_12272001.nii.gz,0.46014856454527203,0.2861434822082519,28.62678924179077
215,0.0,0,7,0.0,51839993,0,7,0,/well/papiez/users/hri611/python/nnUNet_results/Dataset219_PETCT/nnUNetTrainer_1500epochs_1e2lr__nnUNetPlans__3d_fullres_maxnum_512_patch_192/crossval_results_folds_0_1_2/PETCT_6b177a3c28_06302005.nii.gz,/well/papiez/users/hri611/python/nnUnet_raw/Dataset219_PETCT/labelsTr/PETCT_6b177a3c28_06302005.nii.gz,0.0,0.0870871467590332,0.0
216,,0,0,,38720000,0,0,0,/well/papiez/users/hri611/python/nnUNet_results/Dataset219_PETCT/nnUNetTrainer_1500epochs_1e2lr__nnUNetPlans__3d_fullres_maxnum_512_patch_192/crossval_results_folds_0_1_2/PETCT_6b20c7eabb_07312003.nii.gz,/well/papiez/users/hri611/python/nnUnet_raw/Dataset219_PETCT/labelsTr/PETCT_6b20c7eabb_07312003.nii.gz,,0.0,0.0
217,0.8876691345417411,1572,1068,0.7980261647922883,51666929,10431,11499,12003,/well/papiez/users/hri611/python/nnUNet_results/Dataset219_PETCT/nnUNetTrainer_1500epochs_1e2lr__nnUNetPlans__3d_fullres_maxnum_512_patch_192/crossval_results_folds_0_1_2/PETCT_6c23f2686d_04212007.nii.gz,/well/papiez/users/hri611/python/nnUnet_raw/Dataset219_PETCT/labelsTr/PETCT_6c23f2686d_04212007.nii.gz,0.8876691345417411,2.314029899597168,0.0
218,0.9540372670807453,18,19,0.9121140142517815,54079579,384,403,402,/well/papiez/users/hri611/python/nnUNet_results/Dataset219_PETCT/nnUNetTrainer_1500epochs_1e2lr__nnUNetPlans__3d_fullres_maxnum_512_patch_192/crossval_results_folds_0_1_2/PETCT_6d62e15c29_02232007.nii.gz,/well/papiez/users/hri611/python/nnUnet_raw/Dataset219_PETCT/labelsTr/PETCT_6d62e15c29_02232007.nii.gz,0.9540372670807453,0.0,0.0
219,0.880122082179393,1404,717,0.7859089532653679,52150093,7786,8503,9190,/well/papiez/users/hri611/python/nnUNet_results/Dataset219_PETCT/nnUNetTrainer_1500epochs_1e2lr__nnUNetPlans__3d_fullres_maxnum_512_patch_192/crossval_results_folds_0_1_2/PETCT_6d6a193655_11172002.nii.gz,/well/papiez/users/hri611/python/nnUnet_raw/Dataset219_PETCT/labelsTr/PETCT_6d6a193655_11172002.nii.gz,0.880122082179393,0.0,0.0
220,,0,0,,45440000,0,0,0,/well/papiez/users/hri611/python/nnUNet_results/Dataset219_PETCT/nnUNetTrainer_1500epochs_1e2lr__nnUNetPlans__3d_fullres_maxnum_512_patch_192/crossval_results_folds_0_1_2/PETCT_6dd36a2c19_11282003.nii.gz,/well/papiez/users/hri611/python/nnUnet_raw/Dataset219_PETCT/labelsTr/PETCT_6dd36a2c19_11282003.nii.gz,,0.0,0.0
221,0.9001828303786027,3349,1510,0.8184840673913856,52133231,21910,23420,25259,/well/papiez/users/hri611/python/nnUNet_results/Dataset219_PETCT/nnUNetTrainer_1500epochs_1e2lr__nnUNetPlans__3d_fullres_maxnum_512_patch_192/crossval_results_folds_0_1_2/PETCT_6e7c7f8087_03232003.nii.gz,/well/papiez/users/hri611/python/nnUnet_raw/Dataset219_PETCT/labelsTr/PETCT_6e7c7f8087_03232003.nii.gz,0.9001828303786027,0.0870871467590332,2.4384401092529298
222,0.7653359298928919,119,122,0.6198738170347003,52159366,393,515,512,/well/papiez/users/hri611/python/nnUNet_results/Dataset219_PETCT/nnUNetTrainer_1500epochs_1e2lr__nnUNetPlans__3d_fullres_maxnum_512_patch_192/crossval_results_folds_0_1_2/PETCT_6efefcb92a_03262005.nii.gz,/well/papiez/users/hri611/python/nnUnet_raw/Dataset219_PETCT/labelsTr/PETCT_6efefcb92a_03262005.nii.gz,0.7653359298928919,1.2689841384887695,0.0
223,,0,0,,94240000,0,0,0,/well/papiez/users/hri611/python/nnUNet_results/Dataset219_PETCT/nnUNetTrainer_1500epochs_1e2lr__nnUNetPlans__3d_fullres_maxnum_512_patch_192/crossval_results_folds_0_1_2/PETCT_6f46454a8d_09032005.nii.gz,/well/papiez/users/hri611/python/nnUnet_raw/Dataset219_PETCT/labelsTr/PETCT_6f46454a8d_09032005.nii.gz,,0.0,0.0
224,,0,0,,99040000,0,0,0,/well/papiez/users/hri611/python/nnUNet_results/Dataset219_PETCT/nnUNetTrainer_1500epochs_1e2lr__nnUNetPlans__3d_fullres_maxnum_512_patch_192/crossval_results_folds_0_1_2/PETCT_6f46454a8d_09122002.nii.gz,/well/papiez/users/hri611/python/nnUnet_raw/Dataset219_PETCT/labelsTr/PETCT_6f46454a8d_09122002.nii.gz,,0.0,0.0
225,0.8522242654250949,3184,593,0.742500681756204,52145332,10891,11484,14075,/well/papiez/users/hri611/python/nnUNet_results/Dataset219_PETCT/nnUNetTrainer_1500epochs_1e2lr__nnUNetPlans__3d_fullres_maxnum_512_patch_192/crossval_results_folds_0_1_2/PETCT_6fe855c937_12292001.nii.gz,/well/papiez/users/hri611/python/nnUnet_raw/Dataset219_PETCT/labelsTr/PETCT_6fe855c937_12292001.nii.gz,0.8522242654250949,0.0,1.2192200546264649
226,0.5490394337714863,869,23,0.378397212543554,52158565,543,566,1412,/well/papiez/users/hri611/python/nnUNet_results/Dataset219_PETCT/nnUNetTrainer_1500epochs_1e2lr__nnUNetPlans__3d_fullres_maxnum_512_patch_192/crossval_results_folds_0_1_2/PETCT_7094acd4c0_08232001.nii.gz,/well/papiez/users/hri611/python/nnUnet_raw/Dataset219_PETCT/labelsTr/PETCT_7094acd4c0_08232001.nii.gz,0.5490394337714863,0.0,9.281001640319824
227,,0,0,,45440000,0,0,0,/well/papiez/users/hri611/python/nnUNet_results/Dataset219_PETCT/nnUNetTrainer_1500epochs_1e2lr__nnUNetPlans__3d_fullres_maxnum_512_patch_192/crossval_results_folds_0_1_2/PETCT_71ae114917_04132003.nii.gz,/well/papiez/users/hri611/python/nnUnet_raw/Dataset219_PETCT/labelsTr/PETCT_71ae114917_04132003.nii.gz,,0.0,0.0
228,,0,0,,50880000,0,0,0,/well/papiez/users/hri611/python/nnUNet_results/Dataset219_PETCT/nnUNetTrainer_1500epochs_1e2lr__nnUNetPlans__3d_fullres_maxnum_512_patch_192/crossval_results_folds_0_1_2/PETCT_72725f2bda_07062007.nii.gz,/well/papiez/users/hri611/python/nnUnet_raw/Dataset219_PETCT/labelsTr/PETCT_72725f2bda_07062007.nii.gz,,0.0,0.0
229,0.0,0,94,0.0,38239906,0,94,0,/well/papiez/users/hri611/python/nnUNet_results/Dataset219_PETCT/nnUNetTrainer_1500epochs_1e2lr__nnUNetPlans__3d_fullres_maxnum_512_patch_192/crossval_results_folds_0_1_2/PETCT_72d2d6de52_08052005.nii.gz,/well/papiez/users/hri611/python/nnUnet_raw/Dataset219_PETCT/labelsTr/PETCT_72d2d6de52_08052005.nii.gz,0.0,1.16945597076416,0.0
230,0.7571523449473792,7456,11558,0.6092076867742267,45071345,29641,41199,37097,/well/papiez/users/hri611/python/nnUNet_results/Dataset219_PETCT/nnUNetTrainer_1500epochs_1e2lr__nnUNetPlans__3d_fullres_maxnum_512_patch_192/crossval_results_folds_0_1_2/PETCT_7323c415d0_02262006.nii.gz,/well/papiez/users/hri611/python/nnUnet_raw/Dataset219_PETCT/labelsTr/PETCT_7323c415d0_02262006.nii.gz,0.7571523449473792,9.330765724182129,7.86272525024414
231,0.8368364636249243,5943,1059,0.7194486737719369,84455042,17956,19015,23899,/well/papiez/users/hri611/python/nnUNet_results/Dataset219_PETCT/nnUNetTrainer_1500epochs_1e2lr__nnUNetPlans__3d_fullres_maxnum_512_patch_192/crossval_results_folds_0_1_2/PETCT_73597f33fe_05172007.nii.gz,/well/papiez/users/hri611/python/nnUnet_raw/Dataset219_PETCT/labelsTr/PETCT_73597f33fe_05172007.nii.gz,0.8368364636249243,2.1274145851135255,3.495926891326904
232,0.0,0,84,0.0,51839916,0,84,0,/well/papiez/users/hri611/python/nnUNet_results/Dataset219_PETCT/nnUNetTrainer_1500epochs_1e2lr__nnUNetPlans__3d_fullres_maxnum_512_patch_192/crossval_results_folds_0_1_2/PETCT_7365362464_03222007.nii.gz,/well/papiez/users/hri611/python/nnUnet_raw/Dataset219_PETCT/labelsTr/PETCT_7365362464_03222007.nii.gz,0.0,1.0450457611083985,0.0
233,0.6410256410256411,0,112,0.4716981132075472,45119788,100,212,100,/well/papiez/users/hri611/python/nnUNet_results/Dataset219_PETCT/nnUNetTrainer_1500epochs_1e2lr__nnUNetPlans__3d_fullres_maxnum_512_patch_192/crossval_results_folds_0_1_2/PETCT_74bbceaeeb_06032005.nii.gz,/well/papiez/users/hri611/python/nnUnet_raw/Dataset219_PETCT/labelsTr/PETCT_74bbceaeeb_06032005.nii.gz,0.6410256410256411,0.09952816772460937,0.0
234,,0,0,,38720000,0,0,0,/well/papiez/users/hri611/python/nnUNet_results/Dataset219_PETCT/nnUNetTrainer_1500epochs_1e2lr__nnUNetPlans__3d_fullres_maxnum_512_patch_192/crossval_results_folds_0_1_2/PETCT_75d5e740f0_07112002.nii.gz,/well/papiez/users/hri611/python/nnUnet_raw/Dataset219_PETCT/labelsTr/PETCT_75d5e740f0_07112002.nii.gz,,0.0,0.0
235,0.0,0,112,0.0,52159888,0,112,0,/well/papiez/users/hri611/python/nnUNet_results/Dataset219_PETCT/nnUNetTrainer_1500epochs_1e2lr__nnUNetPlans__3d_fullres_maxnum_512_patch_192/crossval_results_folds_0_1_2/PETCT_75e42ff05f_09212002.nii.gz,/well/papiez/users/hri611/python/nnUnet_raw/Dataset219_PETCT/labelsTr/PETCT_75e42ff05f_09212002.nii.gz,0.0,1.3933943481445312,0.0
236,0.0,0,79,0.0,45439921,0,79,0,/well/papiez/users/hri611/python/nnUNet_results/Dataset219_PETCT/nnUNetTrainer_1500epochs_1e2lr__nnUNetPlans__3d_fullres_maxnum_512_patch_192/crossval_results_folds_0_1_2/PETCT_777fa0ba88_11042002.nii.gz,/well/papiez/users/hri611/python/nnUnet_raw/Dataset219_PETCT/labelsTr/PETCT_777fa0ba88_11042002.nii.gz,0.0,0.9828406562805175,0.0
237,0.0,338,11,0.0,97279651,0,11,338,/well/papiez/users/hri611/python/nnUNet_results/Dataset219_PETCT/nnUNetTrainer_1500epochs_1e2lr__nnUNetPlans__3d_fullres_maxnum_512_patch_192/crossval_results_folds_0_1_2/PETCT_7785c10e91_12152006.nii.gz,/well/papiez/users/hri611/python/nnUnet_raw/Dataset219_PETCT/labelsTr/PETCT_7785c10e91_12152006.nii.gz,0.0,0.1368512306213379,4.205065086364746
238,0.7099651027530051,0,4488,0.5503456567478209,45430019,5493,9981,5493,/well/papiez/users/hri611/python/nnUNet_results/Dataset219_PETCT/nnUNetTrainer_1500epochs_1e2lr__nnUNetPlans__3d_fullres_maxnum_512_patch_192/crossval_results_folds_0_1_2/PETCT_790246c76c_02072004.nii.gz,/well/papiez/users/hri611/python/nnUnet_raw/Dataset219_PETCT/labelsTr/PETCT_790246c76c_02072004.nii.gz,0.7099651027530051,2.6623784866333007,0.0
239,0.61688368434851,8391,377,0.4460099829405446,45424173,7059,7436,15450,/well/papiez/users/hri611/python/nnUNet_results/Dataset219_PETCT/nnUNetTrainer_1500epochs_1e2lr__nnUNetPlans__3d_fullres_maxnum_512_patch_192/crossval_results_folds_0_1_2/PETCT_7948aa0e26_08102001.nii.gz,/well/papiez/users/hri611/python/nnUnet_raw/Dataset219_PETCT/labelsTr/PETCT_7948aa0e26_08102001.nii.gz,0.61688368434851,0.0,40.097410572052
240,,0,0,,45440000,0,0,0,/well/papiez/users/hri611/python/nnUNet_results/Dataset219_PETCT/nnUNetTrainer_1500epochs_1e2lr__nnUNetPlans__3d_fullres_maxnum_512_patch_192/crossval_results_folds_0_1_2/PETCT_7978e9fe62_03232003.nii.gz,/well/papiez/users/hri611/python/nnUnet_raw/Dataset219_PETCT/labelsTr/PETCT_7978e9fe62_03232003.nii.gz,,0.0,0.0
241,0.0,0,2,0.0,49119998,0,2,0,/well/papiez/users/hri611/python/nnUNet_results/Dataset219_PETCT/nnUNetTrainer_1500epochs_1e2lr__nnUNetPlans__3d_fullres_maxnum_512_patch_192/crossval_results_folds_0_1_2/PETCT_7a262070a9_11252005.nii.gz,/well/papiez/users/hri611/python/nnUnet_raw/Dataset219_PETCT/labelsTr/PETCT_7a262070a9_11252005.nii.gz,0.0,0.024882041931152343,0.0
242,0.6860987977166183,9093,750,0.5221844660194175,45419400,10757,11507,19850,/well/papiez/users/hri611/python/nnUNet_results/Dataset219_PETCT/nnUNetTrainer_1500epochs_1e2lr__nnUNetPlans__3d_fullres_maxnum_512_patch_192/crossval_results_folds_0_1_2/PETCT_7a77b26403_10202000.nii.gz,/well/papiez/users/hri611/python/nnUnet_raw/Dataset219_PETCT/labelsTr/PETCT_7a77b26403_10202000.nii.gz,0.6860987977166183,0.2861434822082519,17.39254730987549
243,0.8306525434811037,5790,685,0.7103556251397898,99017645,15880,16565,21670,/well/papiez/users/hri611/python/nnUNet_results/Dataset219_PETCT/nnUNetTrainer_1500epochs_1e2lr__nnUNetPlans__3d_fullres_maxnum_512_patch_192/crossval_results_folds_0_1_2/PETCT_7b477e7e0d_07262002.nii.gz,/well/papiez/users/hri611/python/nnUnet_raw/Dataset219_PETCT/labelsTr/PETCT_7b477e7e0d_07262002.nii.gz,0.8306525434811037,0.9579586143493652,5.138141658782959
244,0.0,0,11,0.0,52159989,0,11,0,/well/papiez/users/hri611/python/nnUNet_results/Dataset219_PETCT/nnUNetTrainer_1500epochs_1e2lr__nnUNetPlans__3d_fullres_maxnum_512_patch_192/crossval_results_folds_0_1_2/PETCT_7b9d625330_11172002.nii.gz,/well/papiez/users/hri611/python/nnUnet_raw/Dataset219_PETCT/labelsTr/PETCT_7b9d625330_11172002.nii.gz,0.0,0.1368512306213379,0.0
245,0.0,0,6,0.0,99039994,0,6,0,/well/papiez/users/hri611/python/nnUNet_results/Dataset219_PETCT/nnUNetTrainer_1500epochs_1e2lr__nnUNetPlans__3d_fullres_maxnum_512_patch_192/crossval_results_folds_0_1_2/PETCT_7c1e6175e0_01302005.nii.gz,/well/papiez/users/hri611/python/nnUnet_raw/Dataset219_PETCT/labelsTr/PETCT_7c1e6175e0_01302005.nii.gz,0.0,0.07464612579345703,0.0
246,0.0,0,46,0.0,52159954,0,46,0,/well/papiez/users/hri611/python/nnUNet_results/Dataset219_PETCT/nnUNetTrainer_1500epochs_1e2lr__nnUNetPlans__3d_fullres_maxnum_512_patch_192/crossval_results_folds_0_1_2/PETCT_7c96c4626d_06302003.nii.gz,/well/papiez/users/hri611/python/nnUnet_raw/Dataset219_PETCT/labelsTr/PETCT_7c96c4626d_06302003.nii.gz,0.0,0.5722869644165038,0.0
247,0.7012307257037771,347,3877,0.5399193987583052,92150819,4957,8834,5304,/well/papiez/users/hri611/python/nnUNet_results/Dataset219_PETCT/nnUNetTrainer_1500epochs_1e2lr__nnUNetPlans__3d_fullres_maxnum_512_patch_192/crossval_results_folds_0_1_2/PETCT_7cfd708a53_06172005.nii.gz,/well/papiez/users/hri611/python/nnUnet_raw/Dataset219_PETCT/labelsTr/PETCT_7cfd708a53_06172005.nii.gz,0.7012307257037771,34.34965888595581,0.06220510482788086
248,0.12021371326803205,1705,271,0.06395073424917101,52157889,135,406,1840,/well/papiez/users/hri611/python/nnUNet_results/Dataset219_PETCT/nnUNetTrainer_1500epochs_1e2lr__nnUNetPlans__3d_fullres_maxnum_512_patch_192/crossval_results_folds_0_1_2/PETCT_7d01eb835d_03312002.nii.gz,/well/papiez/users/hri611/python/nnUnet_raw/Dataset219_PETCT/labelsTr/PETCT_7d01eb835d_03312002.nii.gz,0.12021371326803205,3.2222244300842284,21.211940746307373
249,,0,0,,52160000,0,0,0,/well/papiez/users/hri611/python/nnUNet_results/Dataset219_PETCT/nnUNetTrainer_1500epochs_1e2lr__nnUNetPlans__3d_fullres_maxnum_512_patch_192/crossval_results_folds_0_1_2/PETCT_7d8aa1e94d_10042002.nii.gz,/well/papiez/users/hri611/python/nnUnet_raw/Dataset219_PETCT/labelsTr/PETCT_7d8aa1e94d_10042002.nii.gz,,0.0,0.0
250,0.8459399648187028,2509,206,0.7330120955846199,52149831,7454,7660,9963,/well/papiez/users/hri611/python/nnUNet_results/Dataset219_PETCT/nnUNetTrainer_1500epochs_1e2lr__nnUNetPlans__3d_fullres_maxnum_512_patch_192/crossval_results_folds_0_1_2/PETCT_7d97f7a102_04212002.nii.gz,/well/papiez/users/hri611/python/nnUnet_raw/Dataset219_PETCT/labelsTr/PETCT_7d97f7a102_04212002.nii.gz,0.8459399648187028,0.0,0.0
251,0.0,0,4,0.0,46239996,0,4,0,/well/papiez/users/hri611/python/nnUNet_results/Dataset219_PETCT/nnUNetTrainer_1500epochs_1e2lr__nnUNetPlans__3d_fullres_maxnum_512_patch_192/crossval_results_folds_0_1_2/PETCT_7e56b0b62c_05272006.nii.gz,/well/papiez/users/hri611/python/nnUnet_raw/Dataset219_PETCT/labelsTr/PETCT_7e56b0b62c_05272006.nii.gz,0.0,0.04976408386230469,0.0
252,0.8276561820553704,571,618,0.7059841740850643,52155956,2855,3473,3426,/well/papiez/users/hri611/python/nnUNet_results/Dataset219_PETCT/nnUNetTrainer_1500epochs_1e2lr__nnUNetPlans__3d_fullres_maxnum_512_patch_192/crossval_results_folds_0_1_2/PETCT_7e5729ea40_02212003.nii.gz,/well/papiez/users/hri611/python/nnUnet_raw/Dataset219_PETCT/labelsTr/PETCT_7e5729ea40_02212003.nii.gz,0.8276561820553704,1.1943380126953125,0.0
253,0.8469852104664392,33,505,0.734583127775037,52157973,1489,1994,1522,/well/papiez/users/hri611/python/nnUNet_results/Dataset219_PETCT/nnUNetTrainer_1500epochs_1e2lr__nnUNetPlans__3d_fullres_maxnum_512_patch_192/crossval_results_folds_0_1_2/PETCT_7ed037687a_01272003.nii.gz,/well/papiez/users/hri611/python/nnUnet_raw/Dataset219_PETCT/labelsTr/PETCT_7ed037687a_01272003.nii.gz,0.8469852104664392,0.0,0.0
254,0.0,0,3513,0.0,52156487,0,3513,0,/well/papiez/users/hri611/python/nnUNet_results/Dataset219_PETCT/nnUNetTrainer_1500epochs_1e2lr__nnUNetPlans__3d_fullres_maxnum_512_patch_192/crossval_results_folds_0_1_2/PETCT_7ef5343426_05122005.nii.gz,/well/papiez/users/hri611/python/nnUnet_raw/Dataset219_PETCT/labelsTr/PETCT_7ef5343426_05122005.nii.gz,0.0,43.70530665206909,0.0
255,0.6084959816303099,550,132,0.4372937293729373,99038788,530,662,1080,/well/papiez/users/hri611/python/nnUNet_results/Dataset219_PETCT/nnUNetTrainer_1500epochs_1e2lr__nnUNetPlans__3d_fullres_maxnum_512_patch_192/crossval_results_folds_0_1_2/PETCT_7f2a604e03_05052002.nii.gz,/well/papiez/users/hri611/python/nnUnet_raw/Dataset219_PETCT/labelsTr/PETCT_7f2a604e03_05052002.nii.gz,0.6084959816303099,0.07464612579345703,2.8738758430480957
256,0.9170445452120566,199,112,0.8467980295566503,45437970,1719,1831,1918,/well/papiez/users/hri611/python/nnUNet_results/Dataset219_PETCT/nnUNetTrainer_1500epochs_1e2lr__nnUNetPlans__3d_fullres_maxnum_512_patch_192/crossval_results_folds_0_1_2/PETCT_7faf36a152_06142002.nii.gz,/well/papiez/users/hri611/python/nnUnet_raw/Dataset219_PETCT/labelsTr/PETCT_7faf36a152_06142002.nii.gz,0.9170445452120566,0.0,0.0
257,,0,0,,45440000,0,0,0,/well/papiez/users/hri611/python/nnUNet_results/Dataset219_PETCT/nnUNetTrainer_1500epochs_1e2lr__nnUNetPlans__3d_fullres_maxnum_512_patch_192/crossval_results_folds_0_1_2/PETCT_7faf36a152_11272005.nii.gz,/well/papiez/users/hri611/python/nnUnet_raw/Dataset219_PETCT/labelsTr/PETCT_7faf36a152_11272005.nii.gz,,0.0,0.0
258,,0,0,,38720000,0,0,0,/well/papiez/users/hri611/python/nnUNet_results/Dataset219_PETCT/nnUNetTrainer_1500epochs_1e2lr__nnUNetPlans__3d_fullres_maxnum_512_patch_192/crossval_results_folds_0_1_2/PETCT_80b8393c44_07222002.nii.gz,/well/papiez/users/hri611/python/nnUnet_raw/Dataset219_PETCT/labelsTr/PETCT_80b8393c44_07222002.nii.gz,,0.0,0.0
259,0.8621521044079878,2686,2574,0.7577041779906951,52138291,16449,19023,19135,/well/papiez/users/hri611/python/nnUNet_results/Dataset219_PETCT/nnUNetTrainer_1500epochs_1e2lr__nnUNetPlans__3d_fullres_maxnum_512_patch_192/crossval_results_folds_0_1_2/PETCT_80d7e682f7_02112005.nii.gz,/well/papiez/users/hri611/python/nnUnet_raw/Dataset219_PETCT/labelsTr/PETCT_80d7e682f7_02112005.nii.gz,0.8621521044079878,0.26126144027709963,0.19905633544921875
260,0.0,0,12,0.0,50559988,0,12,0,/well/papiez/users/hri611/python/nnUNet_results/Dataset219_PETCT/nnUNetTrainer_1500epochs_1e2lr__nnUNetPlans__3d_fullres_maxnum_512_patch_192/crossval_results_folds_0_1_2/PETCT_80f21e1ed0_11122006.nii.gz,/well/papiez/users/hri611/python/nnUnet_raw/Dataset219_PETCT/labelsTr/PETCT_80f21e1ed0_11122006.nii.gz,0.0,0.14929225158691406,0.0
261,0.0,0,265,0.0,92319735,0,265,0,/well/papiez/users/hri611/python/nnUNet_results/Dataset219_PETCT/nnUNetTrainer_1500epochs_1e2lr__nnUNetPlans__3d_fullres_maxnum_512_patch_192/crossval_results_folds_0_1_2/PETCT_80f7760f65_11142005.nii.gz,/well/papiez/users/hri611/python/nnUnet_raw/Dataset219_PETCT/labelsTr/PETCT_80f7760f65_11142005.nii.gz,0.0,3.2968705558776854,0.0
262,,0,0,,49920000,0,0,0,/well/papiez/users/hri611/python/nnUNet_results/Dataset219_PETCT/nnUNetTrainer_1500epochs_1e2lr__nnUNetPlans__3d_fullres_maxnum_512_patch_192/crossval_results_folds_0_1_2/PETCT_81debf13a1_03092006.nii.gz,/well/papiez/users/hri611/python/nnUnet_raw/Dataset219_PETCT/labelsTr/PETCT_81debf13a1_03092006.nii.gz,,0.0,0.0
263,0.7383351517874334,35,4042,0.5852070403906806,52150171,5752,9794,5787,/well/papiez/users/hri611/python/nnUNet_results/Dataset219_PETCT/nnUNetTrainer_1500epochs_1e2lr__nnUNetPlans__3d_fullres_maxnum_512_patch_192/crossval_results_folds_0_1_2/PETCT_82137245b0_01262002.nii.gz,/well/papiez/users/hri611/python/nnUnet_raw/Dataset219_PETCT/labelsTr/PETCT_82137245b0_01262002.nii.gz,0.7383351517874334,2.537968276977539,0.012441020965576172
264,,0,0,,47520000,0,0,0,/well/papiez/users/hri611/python/nnUNet_results/Dataset219_PETCT/nnUNetTrainer_1500epochs_1e2lr__nnUNetPlans__3d_fullres_maxnum_512_patch_192/crossval_results_folds_0_1_2/PETCT_8311aeddb9_12162005.nii.gz,/well/papiez/users/hri611/python/nnUnet_raw/Dataset219_PETCT/labelsTr/PETCT_8311aeddb9_12162005.nii.gz,,0.0,0.0
265,0.7305825242718447,935,4393,0.5755258126195029,51987448,7224,11617,8159,/well/papiez/users/hri611/python/nnUNet_results/Dataset219_PETCT/nnUNetTrainer_1500epochs_1e2lr__nnUNetPlans__3d_fullres_maxnum_512_patch_192/crossval_results_folds_0_1_2/PETCT_84e7715ed9_01042002.nii.gz,/well/papiez/users/hri611/python/nnUnet_raw/Dataset219_PETCT/labelsTr/PETCT_84e7715ed9_01042002.nii.gz,0.7305825242718447,42.66026089096069,0.0
266,,0,0,,47360000,0,0,0,/well/papiez/users/hri611/python/nnUNet_results/Dataset219_PETCT/nnUNetTrainer_1500epochs_1e2lr__nnUNetPlans__3d_fullres_maxnum_512_patch_192/crossval_results_folds_0_1_2/PETCT_855c7fca12_07272006.nii.gz,/well/papiez/users/hri611/python/nnUnet_raw/Dataset219_PETCT/labelsTr/PETCT_855c7fca12_07272006.nii.gz,,0.0,0.0
267,0.0,0,3,0.0,46879997,0,3,0,/well/papiez/users/hri611/python/nnUNet_results/Dataset219_PETCT/nnUNetTrainer_1500epochs_1e2lr__nnUNetPlans__3d_fullres_maxnum_512_patch_192/crossval_results_folds_0_1_2/PETCT_85b69fed1c_01212006.nii.gz,/well/papiez/users/hri611/python/nnUnet_raw/Dataset219_PETCT/labelsTr/PETCT_85b69fed1c_01212006.nii.gz,0.0,0.037323062896728515,0.0
268,0.0,0,394,0.0,53599606,0,394,0,/well/papiez/users/hri611/python/nnUNet_results/Dataset219_PETCT/nnUNetTrainer_1500epochs_1e2lr__nnUNetPlans__3d_fullres_maxnum_512_patch_192/crossval_results_folds_0_1_2/PETCT_86153b2974_03192006.nii.gz,/well/papiez/users/hri611/python/nnUnet_raw/Dataset219_PETCT/labelsTr/PETCT_86153b2974_03192006.nii.gz,0.0,4.901762260437011,0.0
269,,0,0,,53120000,0,0,0,/well/papiez/users/hri611/python/nnUNet_results/Dataset219_PETCT/nnUNetTrainer_1500epochs_1e2lr__nnUNetPlans__3d_fullres_maxnum_512_patch_192/crossval_results_folds_0_1_2/PETCT_86153b2974_10022005.nii.gz,/well/papiez/users/hri611/python/nnUnet_raw/Dataset219_PETCT/labelsTr/PETCT_86153b2974_10022005.nii.gz,,0.0,0.0
270,0.8569036722848532,78,2486,0.7496338248217947,45429759,7677,10163,7755,/well/papiez/users/hri611/python/nnUNet_results/Dataset219_PETCT/nnUNetTrainer_1500epochs_1e2lr__nnUNetPlans__3d_fullres_maxnum_512_patch_192/crossval_results_folds_0_1_2/PETCT_86e54ea60a_03182002.nii.gz,/well/papiez/users/hri611/python/nnUnet_raw/Dataset219_PETCT/labelsTr/PETCT_86e54ea60a_03182002.nii.gz,0.8569036722848532,6.966971740722656,0.24882041931152343
271,0.63625,0,582,0.4665444546287809,45438909,509,1091,509,/well/papiez/users/hri611/python/nnUNet_results/Dataset219_PETCT/nnUNetTrainer_1500epochs_1e2lr__nnUNetPlans__3d_fullres_maxnum_512_patch_192/crossval_results_folds_0_1_2/PETCT_870181d7fd_10312004.nii.gz,/well/papiez/users/hri611/python/nnUnet_raw/Dataset219_PETCT/labelsTr/PETCT_870181d7fd_10312004.nii.gz,0.63625,4.4414444847106935,0.0
272,,0,0,,87200000,0,0,0,/well/papiez/users/hri611/python/nnUNet_results/Dataset219_PETCT/nnUNetTrainer_1500epochs_1e2lr__nnUNetPlans__3d_fullres_maxnum_512_patch_192/crossval_results_folds_0_1_2/PETCT_87afc291ec_01262006.nii.gz,/well/papiez/users/hri611/python/nnUnet_raw/Dataset219_PETCT/labelsTr/PETCT_87afc291ec_01262006.nii.gz,,0.0,0.0
273,0.0,0,94,0.0,85599906,0,94,0,/well/papiez/users/hri611/python/nnUNet_results/Dataset219_PETCT/nnUNetTrainer_1500epochs_1e2lr__nnUNetPlans__3d_fullres_maxnum_512_patch_192/crossval_results_folds_0_1_2/PETCT_87afc291ec_07202003.nii.gz,/well/papiez/users/hri611/python/nnUnet_raw/Dataset219_PETCT/labelsTr/PETCT_87afc291ec_07202003.nii.gz,0.0,1.16945597076416,0.0
274,0.8419067115075304,9482,1330,0.7269765915002147,52120399,28789,30119,38271,/well/papiez/users/hri611/python/nnUNet_results/Dataset219_PETCT/nnUNetTrainer_1500epochs_1e2lr__nnUNetPlans__3d_fullres_maxnum_512_patch_192/crossval_results_folds_0_1_2/PETCT_88bcc970b3_02282002.nii.gz,/well/papiez/users/hri611/python/nnUnet_raw/Dataset219_PETCT/labelsTr/PETCT_88bcc970b3_02282002.nii.gz,0.8419067115075304,0.1741742935180664,20.776505012512207
275,0.5457025920873124,0,333,0.37523452157598497,92319467,200,533,200,/well/papiez/users/hri611/python/nnUNet_results/Dataset219_PETCT/nnUNetTrainer_1500epochs_1e2lr__nnUNetPlans__3d_fullres_maxnum_512_patch_192/crossval_results_folds_0_1_2/PETCT_89065bc4ab_02202004.nii.gz,/well/papiez/users/hri611/python/nnUnet_raw/Dataset219_PETCT/labelsTr/PETCT_89065bc4ab_02202004.nii.gz,0.5457025920873124,1.0201637191772461,0.0
276,0.762070204864023,16050,39558,0.6156005032420401,58735338,89054,128612,105104,/well/papiez/users/hri611/python/nnUNet_results/Dataset219_PETCT/nnUNetTrainer_1500epochs_1e2lr__nnUNetPlans__3d_fullres_maxnum_512_patch_192/crossval_results_folds_0_1_2/PETCT_8a52353a72_02172003.nii.gz,/well/papiez/users/hri611/python/nnUnet_raw/Dataset219_PETCT/labelsTr/PETCT_8a52353a72_02172003.nii.gz,0.762070204864023,10.549985778808594,106.99278030395507
277,0.8751273532668882,2386,433,0.7779790501693313,45427303,9878,10311,12264,/well/papiez/users/hri611/python/nnUNet_results/Dataset219_PETCT/nnUNetTrainer_1500epochs_1e2lr__nnUNetPlans__3d_fullres_maxnum_512_patch_192/crossval_results_folds_0_1_2/PETCT_8aa48809ea_04162001.nii.gz,/well/papiez/users/hri611/python/nnUnet_raw/Dataset219_PETCT/labelsTr/PETCT_8aa48809ea_04162001.nii.gz,0.8751273532668882,1.0326047401428222,0.04976408386230469
278,0.0,0,18,0.0,40639982,0,18,0,/well/papiez/users/hri611/python/nnUNet_results/Dataset219_PETCT/nnUNetTrainer_1500epochs_1e2lr__nnUNetPlans__3d_fullres_maxnum_512_patch_192/crossval_results_folds_0_1_2/PETCT_8af3757198_12032006.nii.gz,/well/papiez/users/hri611/python/nnUnet_raw/Dataset219_PETCT/labelsTr/PETCT_8af3757198_12032006.nii.gz,0.0,0.2239383773803711,0.0
279,0.0,0,42,0.0,92799958,0,42,0,/well/papiez/users/hri611/python/nnUNet_results/Dataset219_PETCT/nnUNetTrainer_1500epochs_1e2lr__nnUNetPlans__3d_fullres_maxnum_512_patch_192/crossval_results_folds_0_1_2/PETCT_8b14e6a819_01292006.nii.gz,/well/papiez/users/hri611/python/nnUnet_raw/Dataset219_PETCT/labelsTr/PETCT_8b14e6a819_01292006.nii.gz,0.0,0.5225228805541993,0.0
280,0.0,0,115,0.0,99039885,0,115,0,/well/papiez/users/hri611/python/nnUNet_results/Dataset219_PETCT/nnUNetTrainer_1500epochs_1e2lr__nnUNetPlans__3d_fullres_maxnum_512_patch_192/crossval_results_folds_0_1_2/PETCT_8b40e356dc_06182007.nii.gz,/well/papiez/users/hri611/python/nnUnet_raw/Dataset219_PETCT/labelsTr/PETCT_8b40e356dc_06182007.nii.gz,0.0,1.4307174110412597,0.0
281,,0,0,,38720000,0,0,0,/well/papiez/users/hri611/python/nnUNet_results/Dataset219_PETCT/nnUNetTrainer_1500epochs_1e2lr__nnUNetPlans__3d_fullres_maxnum_512_patch_192/crossval_results_folds_0_1_2/PETCT_8b73608326_04042003.nii.gz,/well/papiez/users/hri611/python/nnUnet_raw/Dataset219_PETCT/labelsTr/PETCT_8b73608326_04042003.nii.gz,,0.0,0.0
282,0.8573022069954586,408,8547,0.7502440384883559,52124145,26900,35447,27308,/well/papiez/users/hri611/python/nnUNet_results/Dataset219_PETCT/nnUNetTrainer_1500epochs_1e2lr__nnUNetPlans__3d_fullres_maxnum_512_patch_192/crossval_results_folds_0_1_2/PETCT_8b74860ce6_03102005.nii.gz,/well/papiez/users/hri611/python/nnUnet_raw/Dataset219_PETCT/labelsTr/PETCT_8b74860ce6_03102005.nii.gz,0.8573022069954586,2.2891478576660154,0.07464612579345703
283,0.0,0,11848,0.0,49268152,0,11848,0,/well/papiez/users/hri611/python/nnUNet_results/Dataset219_PETCT/nnUNetTrainer_1500epochs_1e2lr__nnUNetPlans__3d_fullres_maxnum_512_patch_192/crossval_results_folds_0_1_2/PETCT_8bf08c9a42_06092006.nii.gz,/well/papiez/users/hri611/python/nnUnet_raw/Dataset219_PETCT/labelsTr/PETCT_8bf08c9a42_06092006.nii.gz,0.0,147.4012164001465,0.0
284,0.0,0,158,0.0,49919842,0,158,0,/well/papiez/users/hri611/python/nnUNet_results/Dataset219_PETCT/nnUNetTrainer_1500epochs_1e2lr__nnUNetPlans__3d_fullres_maxnum_512_patch_192/crossval_results_folds_0_1_2/PETCT_8c5d99b459_05042007.nii.gz,/well/papiez/users/hri611/python/nnUnet_raw/Dataset219_PETCT/labelsTr/PETCT_8c5d99b459_05042007.nii.gz,0.0,1.965681312561035,0.0
285,0.9284591194968553,99,83,0.8664710198092443,52158637,1181,1264,1280,/well/papiez/users/hri611/python/nnUNet_results/Dataset219_PETCT/nnUNetTrainer_1500epochs_1e2lr__nnUNetPlans__3d_fullres_maxnum_512_patch_192/crossval_results_folds_0_1_2/PETCT_8c8cd2699c_01182004.nii.gz,/well/papiez/users/hri611/python/nnUnet_raw/Dataset219_PETCT/labelsTr/PETCT_8c8cd2699c_01182004.nii.gz,0.9284591194968553,0.32346654510498046,0.0
286,0.8219206251285215,1665,8727,0.6976784779193577,52125626,23982,32709,25647,/well/papiez/users/hri611/python/nnUNet_results/Dataset219_PETCT/nnUNetTrainer_1500epochs_1e2lr__nnUNetPlans__3d_fullres_maxnum_512_patch_192/crossval_results_folds_0_1_2/PETCT_8de6953d23_01192001.nii.gz,/well/papiez/users/hri611/python/nnUnet_raw/Dataset219_PETCT/labelsTr/PETCT_8de6953d23_01192001.nii.gz,0.8219206251285215,2.60017338180542,0.024882041931152343
287,0.7837259100642399,0,101,0.6443661971830986,52159716,183,284,183,/well/papiez/users/hri611/python/nnUNet_results/Dataset219_PETCT/nnUNetTrainer_1500epochs_1e2lr__nnUNetPlans__3d_fullres_maxnum_512_patch_192/crossval_results_folds_0_1_2/PETCT_8e905366fe_04272001.nii.gz,/well/papiez/users/hri611/python/nnUnet_raw/Dataset219_PETCT/labelsTr/PETCT_8e905366fe_04272001.nii.gz,0.7837259100642399,0.0,0.0
288,0.7528666960149257,46556,600,0.603677805419216,52041016,71828,72428,118384,/well/papiez/users/hri611/python/nnUNet_results/Dataset219_PETCT/nnUNetTrainer_1500epochs_1e2lr__nnUNetPlans__3d_fullres_maxnum_512_patch_192/crossval_results_folds_0_1_2/PETCT_8ec13728df_10141999.nii.gz,/well/papiez/users/hri611/python/nnUnet_raw/Dataset219_PETCT/labelsTr/PETCT_8ec13728df_10141999.nii.gz,0.7528666960149257,0.7589022789001465,86.97517757034302
289,,0,0,,52160000,0,0,0,/well/papiez/users/hri611/python/nnUNet_results/Dataset219_PETCT/nnUNetTrainer_1500epochs_1e2lr__nnUNetPlans__3d_fullres_maxnum_512_patch_192/crossval_results_folds_0_1_2/PETCT_8f2878df50_02212003.nii.gz,/well/papiez/users/hri611/python/nnUnet_raw/Dataset219_PETCT/labelsTr/PETCT_8f2878df50_02212003.nii.gz,,0.0,0.0
290,,0,0,,37760000,0,0,0,/well/papiez/users/hri611/python/nnUNet_results/Dataset219_PETCT/nnUNetTrainer_1500epochs_1e2lr__nnUNetPlans__3d_fullres_maxnum_512_patch_192/crossval_results_folds_0_1_2/PETCT_8fea5f0537_09262005.nii.gz,/well/papiez/users/hri611/python/nnUnet_raw/Dataset219_PETCT/labelsTr/PETCT_8fea5f0537_09262005.nii.gz,,0.0,0.0
291,0.6897568165070007,4394,4868,0.5264341957255343,52140442,10296,15164,14690,/well/papiez/users/hri611/python/nnUNet_results/Dataset219_PETCT/nnUNetTrainer_1500epochs_1e2lr__nnUNetPlans__3d_fullres_maxnum_512_patch_192/crossval_results_folds_0_1_2/PETCT_901573a747_05132005.nii.gz,/well/papiez/users/hri611/python/nnUnet_raw/Dataset219_PETCT/labelsTr/PETCT_901573a747_05132005.nii.gz,0.6897568165070007,15.227809661865233,15.339778850555419
292,,0,0,,45440000,0,0,0,/well/papiez/users/hri611/python/nnUNet_results/Dataset219_PETCT/nnUNetTrainer_1500epochs_1e2lr__nnUNetPlans__3d_fullres_maxnum_512_patch_192/crossval_results_folds_0_1_2/PETCT_90d668ed29_06072003.nii.gz,/well/papiez/users/hri611/python/nnUnet_raw/Dataset219_PETCT/labelsTr/PETCT_90d668ed29_06072003.nii.gz,,0.0,0.0
293,0.8808622196329741,2840,432,0.7870900572618428,52144632,12096,12528,14936,/well/papiez/users/hri611/python/nnUNet_results/Dataset219_PETCT/nnUNetTrainer_1500epochs_1e2lr__nnUNetPlans__3d_fullres_maxnum_512_patch_192/crossval_results_folds_0_1_2/PETCT_90ea6a6aaf_07272001.nii.gz,/well/papiez/users/hri611/python/nnUnet_raw/Dataset219_PETCT/labelsTr/PETCT_90ea6a6aaf_07272001.nii.gz,0.8808622196329741,2.090091522216797,0.19905633544921875
294,0.8067226890756303,33,174,0.676056338028169,90079361,432,606,465,/well/papiez/users/hri611/python/nnUNet_results/Dataset219_PETCT/nnUNetTrainer_1500epochs_1e2lr__nnUNetPlans__3d_fullres_maxnum_512_patch_192/crossval_results_folds_0_1_2/PETCT_912a25778f_05172007.nii.gz,/well/papiez/users/hri611/python/nnUnet_raw/Dataset219_PETCT/labelsTr/PETCT_912a25778f_05172007.nii.gz,0.8067226890756303,1.5053635368347167,0.0
295,0.8197674418604651,26,36,0.6945812807881774,47999797,141,177,167,/well/papiez/users/hri611/python/nnUNet_results/Dataset219_PETCT/nnUNetTrainer_1500epochs_1e2lr__nnUNetPlans__3d_fullres_maxnum_512_patch_192/crossval_results_folds_0_1_2/PETCT_91cfa804b0_09222006.nii.gz,/well/papiez/users/hri611/python/nnUnet_raw/Dataset219_PETCT/labelsTr/PETCT_91cfa804b0_09222006.nii.gz,0.8197674418604651,0.2737024612426758,0.32346654510498046
296,0.7068916378958913,80025,1222,0.546660789313633,45260781,97972,99194,177997,/well/papiez/users/hri611/python/nnUNet_results/Dataset219_PETCT/nnUNetTrainer_1500epochs_1e2lr__nnUNetPlans__3d_fullres_maxnum_512_patch_192/crossval_results_folds_0_1_2/PETCT_92c5c944a5_07152002.nii.gz,/well/papiez/users/hri611/python/nnUnet_raw/Dataset219_PETCT/labelsTr/PETCT_92c5c944a5_07152002.nii.gz,0.7068916378958913,0.0,16.720732177734376
297,0.8858603066439523,0,134,0.7951070336391437,49759346,520,654,520,/well/papiez/users/hri611/python/nnUNet_results/Dataset219_PETCT/nnUNetTrainer_1500epochs_1e2lr__nnUNetPlans__3d_fullres_maxnum_512_patch_192/crossval_results_folds_0_1_2/PETCT_94962fe878_06012007.nii.gz,/well/papiez/users/hri611/python/nnUnet_raw/Dataset219_PETCT/labelsTr/PETCT_94962fe878_06012007.nii.gz,0.8858603066439523,0.18661531448364257,0.0
298,0.0,84,0,0.0,102719916,0,0,84,/well/papiez/users/hri611/python/nnUNet_results/Dataset219_PETCT/nnUNetTrainer_1500epochs_1e2lr__nnUNetPlans__3d_fullres_maxnum_512_patch_192/crossval_results_folds_0_1_2/PETCT_94cc0dac49_03092007.nii.gz,/well/papiez/users/hri611/python/nnUnet_raw/Dataset219_PETCT/labelsTr/PETCT_94cc0dac49_03092007.nii.gz,0.0,0.0,1.0450457611083985
299,,0,0,,50880000,0,0,0,/well/papiez/users/hri611/python/nnUNet_results/Dataset219_PETCT/nnUNetTrainer_1500epochs_1e2lr__nnUNetPlans__3d_fullres_maxnum_512_patch_192/crossval_results_folds_0_1_2/PETCT_94cc0dac49_03102006.nii.gz,/well/papiez/users/hri611/python/nnUnet_raw/Dataset219_PETCT/labelsTr/PETCT_94cc0dac49_03102006.nii.gz,,0.0,0.0
300,0.0,0,9,0.0,45439991,0,9,0,/well/papiez/users/hri611/python/nnUNet_results/Dataset219_PETCT/nnUNetTrainer_1500epochs_1e2lr__nnUNetPlans__3d_fullres_maxnum_512_patch_192/crossval_results_folds_0_1_2/PETCT_956520090b_11012003.nii.gz,/well/papiez/users/hri611/python/nnUnet_raw/Dataset219_PETCT/labelsTr/PETCT_956520090b_11012003.nii.gz,0.0,0.11196918869018554,0.0
301,0.5327102803738317,73,27,0.3630573248407643,85599843,57,84,130,/well/papiez/users/hri611/python/nnUNet_results/Dataset219_PETCT/nnUNetTrainer_1500epochs_1e2lr__nnUNetPlans__3d_fullres_maxnum_512_patch_192/crossval_results_folds_0_1_2/PETCT_95efdaba3c_10112003.nii.gz,/well/papiez/users/hri611/python/nnUnet_raw/Dataset219_PETCT/labelsTr/PETCT_95efdaba3c_10112003.nii.gz,0.5327102803738317,0.3110255241394043,0.0
302,,0,0,,58880000,0,0,0,/well/papiez/users/hri611/python/nnUNet_results/Dataset219_PETCT/nnUNetTrainer_1500epochs_1e2lr__nnUNetPlans__3d_fullres_maxnum_512_patch_192/crossval_results_folds_0_1_2/PETCT_960c5f4262_01162003.nii.gz,/well/papiez/users/hri611/python/nnUnet_raw/Dataset219_PETCT/labelsTr/PETCT_960c5f4262_01162003.nii.gz,,0.0,0.0
303,,0,0,,52160000,0,0,0,/well/papiez/users/hri611/python/nnUNet_results/Dataset219_PETCT/nnUNetTrainer_1500epochs_1e2lr__nnUNetPlans__3d_fullres_maxnum_512_patch_192/crossval_results_folds_0_1_2/PETCT_960c5f4262_02252005.nii.gz,/well/papiez/users/hri611/python/nnUnet_raw/Dataset219_PETCT/labelsTr/PETCT_960c5f4262_02252005.nii.gz,,0.0,0.0
304,0.9468304668304668,1980,2348,0.8990294886151549,45397136,38536,40884,40516,/well/papiez/users/hri611/python/nnUNet_results/Dataset219_PETCT/nnUNetTrainer_1500epochs_1e2lr__nnUNetPlans__3d_fullres_maxnum_512_patch_192/crossval_results_folds_0_1_2/PETCT_97320b0b58_04172005.nii.gz,/well/papiez/users/hri611/python/nnUnet_raw/Dataset219_PETCT/labelsTr/PETCT_97320b0b58_04172005.nii.gz,0.9468304668304668,4.0060087509155275,0.870871467590332
305,0.0,0,888,0.0,42879112,0,888,0,/well/papiez/users/hri611/python/nnUNet_results/Dataset219_PETCT/nnUNetTrainer_1500epochs_1e2lr__nnUNetPlans__3d_fullres_maxnum_512_patch_192/crossval_results_folds_0_1_2/PETCT_97320b0b58_07282005.nii.gz,/well/papiez/users/hri611/python/nnUnet_raw/Dataset219_PETCT/labelsTr/PETCT_97320b0b58_07282005.nii.gz,0.0,11.047626617431641,0.0
306,0.9042528400815614,2610,3964,0.8252385889358534,45402383,31043,35007,33653,/well/papiez/users/hri611/python/nnUNet_results/Dataset219_PETCT/nnUNetTrainer_1500epochs_1e2lr__nnUNetPlans__3d_fullres_maxnum_512_patch_192/crossval_results_folds_0_1_2/PETCT_9775598501_05042001.nii.gz,/well/papiez/users/hri611/python/nnUnet_raw/Dataset219_PETCT/labelsTr/PETCT_9775598501_05042001.nii.gz,0.9042528400815614,2.6499374656677244,1.9159172286987305
307,0.9148017275225756,154,63,0.8429811866859623,88158618,1165,1228,1319,/well/papiez/users/hri611/python/nnUNet_results/Dataset219_PETCT/nnUNetTrainer_1500epochs_1e2lr__nnUNetPlans__3d_fullres_maxnum_512_patch_192/crossval_results_folds_0_1_2/PETCT_979f9c3dba_06222006.nii.gz,/well/papiez/users/hri611/python/nnUnet_raw/Dataset219_PETCT/labelsTr/PETCT_979f9c3dba_06222006.nii.gz,0.9148017275225756,0.0,0.0
308,0.0,0,158,0.0,52159842,0,158,0,/well/papiez/users/hri611/python/nnUNet_results/Dataset219_PETCT/nnUNetTrainer_1500epochs_1e2lr__nnUNetPlans__3d_fullres_maxnum_512_patch_192/crossval_results_folds_0_1_2/PETCT_9860ffe82d_11192004.nii.gz,/well/papiez/users/hri611/python/nnUnet_raw/Dataset219_PETCT/labelsTr/PETCT_9860ffe82d_11192004.nii.gz,0.0,1.965681312561035,0.0
309,0.9236730840277493,7968,1329,0.8581715000533935,45374449,56254,57583,64222,/well/papiez/users/hri611/python/nnUNet_results/Dataset219_PETCT/nnUNetTrainer_1500epochs_1e2lr__nnUNetPlans__3d_fullres_maxnum_512_patch_192/crossval_results_folds_0_1_2/PETCT_98c6af8b90_05262003.nii.gz,/well/papiez/users/hri611/python/nnUnet_raw/Dataset219_PETCT/labelsTr/PETCT_98c6af8b90_05262003.nii.gz,0.9236730840277493,0.26126144027709963,0.0
310,,0,0,,52160000,0,0,0,/well/papiez/users/hri611/python/nnUNet_results/Dataset219_PETCT/nnUNetTrainer_1500epochs_1e2lr__nnUNetPlans__3d_fullres_maxnum_512_patch_192/crossval_results_folds_0_1_2/PETCT_98cd91d44e_09062003.nii.gz,/well/papiez/users/hri611/python/nnUnet_raw/Dataset219_PETCT/labelsTr/PETCT_98cd91d44e_09062003.nii.gz,,0.0,0.0
311,0.0,0,89,0.0,58879911,0,89,0,/well/papiez/users/hri611/python/nnUNet_results/Dataset219_PETCT/nnUNetTrainer_1500epochs_1e2lr__nnUNetPlans__3d_fullres_maxnum_512_patch_192/crossval_results_folds_0_1_2/PETCT_9902caa7ec_08132006.nii.gz,/well/papiez/users/hri611/python/nnUnet_raw/Dataset219_PETCT/labelsTr/PETCT_9902caa7ec_08132006.nii.gz,0.0,1.1072508659362792,0.0
312,,0,0,,48160000,0,0,0,/well/papiez/users/hri611/python/nnUNet_results/Dataset219_PETCT/nnUNetTrainer_1500epochs_1e2lr__nnUNetPlans__3d_fullres_maxnum_512_patch_192/crossval_results_folds_0_1_2/PETCT_9a2bfe901f_08062005.nii.gz,/well/papiez/users/hri611/python/nnUnet_raw/Dataset219_PETCT/labelsTr/PETCT_9a2bfe901f_08062005.nii.gz,,0.0,0.0
313,0.8521355316110606,303,3114,0.7423659805473874,45426737,9846,12960,10149,/well/papiez/users/hri611/python/nnUNet_results/Dataset219_PETCT/nnUNetTrainer_1500epochs_1e2lr__nnUNetPlans__3d_fullres_maxnum_512_patch_192/crossval_results_folds_0_1_2/PETCT_9a2c6e618a_02142000.nii.gz,/well/papiez/users/hri611/python/nnUnet_raw/Dataset219_PETCT/labelsTr/PETCT_9a2c6e618a_02142000.nii.gz,0.8521355316110606,0.7091381950378418,0.4105536918640137
314,,0,0,,45440000,0,0,0,/well/papiez/users/hri611/python/nnUNet_results/Dataset219_PETCT/nnUNetTrainer_1500epochs_1e2lr__nnUNetPlans__3d_fullres_maxnum_512_patch_192/crossval_results_folds_0_1_2/PETCT_9a418f3b3a_05112003.nii.gz,/well/papiez/users/hri611/python/nnUnet_raw/Dataset219_PETCT/labelsTr/PETCT_9a418f3b3a_05112003.nii.gz,,0.0,0.0
315,0.0,0,77,0.0,51679923,0,77,0,/well/papiez/users/hri611/python/nnUNet_results/Dataset219_PETCT/nnUNetTrainer_1500epochs_1e2lr__nnUNetPlans__3d_fullres_maxnum_512_patch_192/crossval_results_folds_0_1_2/PETCT_9a66a81ad1_05132006.nii.gz,/well/papiez/users/hri611/python/nnUnet_raw/Dataset219_PETCT/labelsTr/PETCT_9a66a81ad1_05132006.nii.gz,0.0,0.9579586143493652,0.0
316,,0,0,,52960000,0,0,0,/well/papiez/users/hri611/python/nnUNet_results/Dataset219_PETCT/nnUNetTrainer_1500epochs_1e2lr__nnUNetPlans__3d_fullres_maxnum_512_patch_192/crossval_results_folds_0_1_2/PETCT_9a66a81ad1_10212005.nii.gz,/well/papiez/users/hri611/python/nnUnet_raw/Dataset219_PETCT/labelsTr/PETCT_9a66a81ad1_10212005.nii.gz,,0.0,0.0
317,0.0,0,87,0.0,105759913,0,87,0,/well/papiez/users/hri611/python/nnUNet_results/Dataset219_PETCT/nnUNetTrainer_1500epochs_1e2lr__nnUNetPlans__3d_fullres_maxnum_512_patch_192/crossval_results_folds_0_1_2/PETCT_9a66a81ad1_10312004.nii.gz,/well/papiez/users/hri611/python/nnUnet_raw/Dataset219_PETCT/labelsTr/PETCT_9a66a81ad1_10312004.nii.gz,0.0,1.082368824005127,0.0
318,0.0,0,257,0.0,52159743,0,257,0,/well/papiez/users/hri611/python/nnUNet_results/Dataset219_PETCT/nnUNetTrainer_1500epochs_1e2lr__nnUNetPlans__3d_fullres_maxnum_512_patch_192/crossval_results_folds_0_1_2/PETCT_9a83943958_08032003.nii.gz,/well/papiez/users/hri611/python/nnUnet_raw/Dataset219_PETCT/labelsTr/PETCT_9a83943958_08032003.nii.gz,0.0,3.1973423881530763,0.0
319,0.8534165598776404,3465,3627,0.7443126509716264,52132263,20645,24272,24110,/well/papiez/users/hri611/python/nnUNet_results/Dataset219_PETCT/nnUNetTrainer_1500epochs_1e2lr__nnUNetPlans__3d_fullres_maxnum_512_patch_192/crossval_results_folds_0_1_2/PETCT_9aa97cf103_07182004.nii.gz,/well/papiez/users/hri611/python/nnUnet_raw/Dataset219_PETCT/labelsTr/PETCT_9aa97cf103_07182004.nii.gz,0.8534165598776404,0.1741742935180664,0.945517593383789
320,0.8180473372781065,64,182,0.6921151439299124,52159201,553,735,617,/well/papiez/users/hri611/python/nnUNet_results/Dataset219_PETCT/nnUNetTrainer_1500epochs_1e2lr__nnUNetPlans__3d_fullres_maxnum_512_patch_192/crossval_results_folds_0_1_2/PETCT_9abb9583ec_05302002.nii.gz,/well/papiez/users/hri611/python/nnUnet_raw/Dataset219_PETCT/labelsTr/PETCT_9abb9583ec_05302002.nii.gz,0.8180473372781065,0.0,0.3483485870361328
321,0.0,0,3,0.0,52159997,0,3,0,/well/papiez/users/hri611/python/nnUNet_results/Dataset219_PETCT/nnUNetTrainer_1500epochs_1e2lr__nnUNetPlans__3d_fullres_maxnum_512_patch_192/crossval_results_folds_0_1_2/PETCT_9ad7dffae6_05222003.nii.gz,/well/papiez/users/hri611/python/nnUnet_raw/Dataset219_PETCT/labelsTr/PETCT_9ad7dffae6_05222003.nii.gz,0.0,0.037323062896728515,0.0
322,,0,0,,52160000,0,0,0,/well/papiez/users/hri611/python/nnUNet_results/Dataset219_PETCT/nnUNetTrainer_1500epochs_1e2lr__nnUNetPlans__3d_fullres_maxnum_512_patch_192/crossval_results_folds_0_1_2/PETCT_9b1bb2165a_10132002.nii.gz,/well/papiez/users/hri611/python/nnUnet_raw/Dataset219_PETCT/labelsTr/PETCT_9b1bb2165a_10132002.nii.gz,,0.0,0.0
323,,0,0,,99040000,0,0,0,/well/papiez/users/hri611/python/nnUNet_results/Dataset219_PETCT/nnUNetTrainer_1500epochs_1e2lr__nnUNetPlans__3d_fullres_maxnum_512_patch_192/crossval_results_folds_0_1_2/PETCT_9c68e484a7_08142003.nii.gz,/well/papiez/users/hri611/python/nnUnet_raw/Dataset219_PETCT/labelsTr/PETCT_9c68e484a7_08142003.nii.gz,,0.0,0.0
324,0.9206728787004206,103,1821,0.8530063412025365,45426911,11165,12986,11268,/well/papiez/users/hri611/python/nnUNet_results/Dataset219_PETCT/nnUNetTrainer_1500epochs_1e2lr__nnUNetPlans__3d_fullres_maxnum_512_patch_192/crossval_results_folds_0_1_2/PETCT_9c8842d12e_01252004.nii.gz,/well/papiez/users/hri611/python/nnUnet_raw/Dataset219_PETCT/labelsTr/PETCT_9c8842d12e_01252004.nii.gz,0.9206728787004206,2.4259990882873534,0.04976408386230469
325,0.6382781456953642,5377,85,0.4687287228868787,52149719,4819,4904,10196,/well/papiez/users/hri611/python/nnUNet_results/Dataset219_PETCT/nnUNetTrainer_1500epochs_1e2lr__nnUNetPlans__3d_fullres_maxnum_512_patch_192/crossval_results_folds_0_1_2/PETCT_9c9a347388_09092000.nii.gz,/well/papiez/users/hri611/python/nnUnet_raw/Dataset219_PETCT/labelsTr/PETCT_9c9a347388_09092000.nii.gz,0.6382781456953642,0.0,11.694559707641602
326,0.3545989847715736,15857,36,0.21550915642430524,52139741,4366,4402,20223,/well/papiez/users/hri611/python/nnUNet_results/Dataset219_PETCT/nnUNetTrainer_1500epochs_1e2lr__nnUNetPlans__3d_fullres_maxnum_512_patch_192/crossval_results_folds_0_1_2/PETCT_9da159b835_03232002.nii.gz,/well/papiez/users/hri611/python/nnUnet_raw/Dataset219_PETCT/labelsTr/PETCT_9da159b835_03232002.nii.gz,0.3545989847715736,0.0,83.46680965805054
327,0.0,0,235,0.0,52159765,0,235,0,/well/papiez/users/hri611/python/nnUNet_results/Dataset219_PETCT/nnUNetTrainer_1500epochs_1e2lr__nnUNetPlans__3d_fullres_maxnum_512_patch_192/crossval_results_folds_0_1_2/PETCT_9e864bb710_09142003.nii.gz,/well/papiez/users/hri611/python/nnUnet_raw/Dataset219_PETCT/labelsTr/PETCT_9e864bb710_09142003.nii.gz,0.0,2.9236399269104005,0.0
328,0.9534102526654009,1479,2987,0.9109684621825286,52109838,45696,48683,47175,/well/papiez/users/hri611/python/nnUNet_results/Dataset219_PETCT/nnUNetTrainer_1500epochs_1e2lr__nnUNetPlans__3d_fullres_maxnum_512_patch_192/crossval_results_folds_0_1_2/PETCT_9f206193d3_04072003.nii.gz,/well/papiez/users/hri611/python/nnUnet_raw/Dataset219_PETCT/labelsTr/PETCT_9f206193d3_04072003.nii.gz,0.9534102526654009,0.48519981765747067,0.9206355514526368
329,,0,0,,48160000,0,0,0,/well/papiez/users/hri611/python/nnUNet_results/Dataset219_PETCT/nnUNetTrainer_1500epochs_1e2lr__nnUNetPlans__3d_fullres_maxnum_512_patch_192/crossval_results_folds_0_1_2/PETCT_9f491f1481_02122006.nii.gz,/well/papiez/users/hri611/python/nnUnet_raw/Dataset219_PETCT/labelsTr/PETCT_9f491f1481_02122006.nii.gz,,0.0,0.0
330,0.0,0,1,0.0,52159999,0,1,0,/well/papiez/users/hri611/python/nnUNet_results/Dataset219_PETCT/nnUNetTrainer_1500epochs_1e2lr__nnUNetPlans__3d_fullres_maxnum_512_patch_192/crossval_results_folds_0_1_2/PETCT_9f6e8b1b43_11162002.nii.gz,/well/papiez/users/hri611/python/nnUnet_raw/Dataset219_PETCT/labelsTr/PETCT_9f6e8b1b43_11162002.nii.gz,0.0,0.012441020965576172,0.0
331,0.8256880733944955,30,46,0.703125,52159744,180,226,210,/well/papiez/users/hri611/python/nnUNet_results/Dataset219_PETCT/nnUNetTrainer_1500epochs_1e2lr__nnUNetPlans__3d_fullres_maxnum_512_patch_192/crossval_results_folds_0_1_2/PETCT_9f7c68f5ca_12212001.nii.gz,/well/papiez/users/hri611/python/nnUnet_raw/Dataset219_PETCT/labelsTr/PETCT_9f7c68f5ca_12212001.nii.gz,0.8256880733944955,0.0,0.0
332,0.8295792605184871,393,8,0.7087872185911401,49758623,976,984,1369,/well/papiez/users/hri611/python/nnUNet_results/Dataset219_PETCT/nnUNetTrainer_1500epochs_1e2lr__nnUNetPlans__3d_fullres_maxnum_512_patch_192/crossval_results_folds_0_1_2/PETCT_9ffd8409b3_07152005.nii.gz,/well/papiez/users/hri611/python/nnUnet_raw/Dataset219_PETCT/labelsTr/PETCT_9ffd8409b3_07152005.nii.gz,0.8295792605184871,0.04976408386230469,1.9283582496643066
333,,0,0,,51040000,0,0,0,/well/papiez/users/hri611/python/nnUNet_results/Dataset219_PETCT/nnUNetTrainer_1500epochs_1e2lr__nnUNetPlans__3d_fullres_maxnum_512_patch_192/crossval_results_folds_0_1_2/PETCT_a09210d96b_12112005.nii.gz,/well/papiez/users/hri611/python/nnUnet_raw/Dataset219_PETCT/labelsTr/PETCT_a09210d96b_12112005.nii.gz,,0.0,0.0
334,0.8504453820909517,735,5326,0.7398042414355628,52136706,17233,22559,17968,/well/papiez/users/hri611/python/nnUNet_results/Dataset219_PETCT/nnUNetTrainer_1500epochs_1e2lr__nnUNetPlans__3d_fullres_maxnum_512_patch_192/crossval_results_folds_0_1_2/PETCT_a0c4dc1ef1_01192003.nii.gz,/well/papiez/users/hri611/python/nnUnet_raw/Dataset219_PETCT/labelsTr/PETCT_a0c4dc1ef1_01192003.nii.gz,0.8504453820909517,14.804814949035645,8.58430446624756
335,,0,0,,47200000,0,0,0,/well/papiez/users/hri611/python/nnUNet_results/Dataset219_PETCT/nnUNetTrainer_1500epochs_1e2lr__nnUNetPlans__3d_fullres_maxnum_512_patch_192/crossval_results_folds_0_1_2/PETCT_a19c2a0c65_03052006.nii.gz,/well/papiez/users/hri611/python/nnUnet_raw/Dataset219_PETCT/labelsTr/PETCT_a19c2a0c65_03052006.nii.gz,,0.0,0.0
336,0.0,126834,42,0.0,52033124,0,42,126834,/well/papiez/users/hri611/python/nnUNet_results/Dataset219_PETCT/nnUNetTrainer_1500epochs_1e2lr__nnUNetPlans__3d_fullres_maxnum_512_patch_192/crossval_results_folds_0_1_2/PETCT_a19ef8e0d2_12261999.nii.gz,/well/papiez/users/hri611/python/nnUnet_raw/Dataset219_PETCT/labelsTr/PETCT_a19ef8e0d2_12261999.nii.gz,0.0,0.5225228805541993,1577.9444531478882
337,0.0,0,16096,0.0,85583904,0,16096,0,/well/papiez/users/hri611/python/nnUNet_results/Dataset219_PETCT/nnUNetTrainer_1500epochs_1e2lr__nnUNetPlans__3d_fullres_maxnum_512_patch_192/crossval_results_folds_0_1_2/PETCT_a1d93ebc74_09012003.nii.gz,/well/papiez/users/hri611/python/nnUnet_raw/Dataset219_PETCT/labelsTr/PETCT_a1d93ebc74_09012003.nii.gz,0.0,200.25067346191406,0.0
338,0.9514335868929198,56,27,0.9073660714285714,52159104,813,840,869,/well/papiez/users/hri611/python/nnUNet_results/Dataset219_PETCT/nnUNetTrainer_1500epochs_1e2lr__nnUNetPlans__3d_fullres_maxnum_512_patch_192/crossval_results_folds_0_1_2/PETCT_a1db71e797_03252005.nii.gz,/well/papiez/users/hri611/python/nnUnet_raw/Dataset219_PETCT/labelsTr/PETCT_a1db71e797_03252005.nii.gz,0.9514335868929198,0.0,0.0
339,,0,0,,91680000,0,0,0,/well/papiez/users/hri611/python/nnUNet_results/Dataset219_PETCT/nnUNetTrainer_1500epochs_1e2lr__nnUNetPlans__3d_fullres_maxnum_512_patch_192/crossval_results_folds_0_1_2/PETCT_a22ec7f62b_06302007.nii.gz,/well/papiez/users/hri611/python/nnUnet_raw/Dataset219_PETCT/labelsTr/PETCT_a22ec7f62b_06302007.nii.gz,,0.0,0.0
340,,0,0,,72160000,0,0,0,/well/papiez/users/hri611/python/nnUNet_results/Dataset219_PETCT/nnUNetTrainer_1500epochs_1e2lr__nnUNetPlans__3d_fullres_maxnum_512_patch_192/crossval_results_folds_0_1_2/PETCT_a2676f03c0_05092003.nii.gz,/well/papiez/users/hri611/python/nnUnet_raw/Dataset219_PETCT/labelsTr/PETCT_a2676f03c0_05092003.nii.gz,,0.0,0.0
341,,0,0,,48480000,0,0,0,/well/papiez/users/hri611/python/nnUNet_results/Dataset219_PETCT/nnUNetTrainer_1500epochs_1e2lr__nnUNetPlans__3d_fullres_maxnum_512_patch_192/crossval_results_folds_0_1_2/PETCT_a29cae0316_06292006.nii.gz,/well/papiez/users/hri611/python/nnUnet_raw/Dataset219_PETCT/labelsTr/PETCT_a29cae0316_06292006.nii.gz,,0.0,0.0
342,0.9618074233458849,20,51,0.9264248704663213,52159035,894,945,914,/well/papiez/users/hri611/python/nnUNet_results/Dataset219_PETCT/nnUNetTrainer_1500epochs_1e2lr__nnUNetPlans__3d_fullres_maxnum_512_patch_192/crossval_results_folds_0_1_2/PETCT_a2a68bbe97_08212003.nii.gz,/well/papiez/users/hri611/python/nnUnet_raw/Dataset219_PETCT/labelsTr/PETCT_a2a68bbe97_08212003.nii.gz,0.9618074233458849,0.0,0.0
343,,0,0,,45440000,0,0,0,/well/papiez/users/hri611/python/nnUNet_results/Dataset219_PETCT/nnUNetTrainer_1500epochs_1e2lr__nnUNetPlans__3d_fullres_maxnum_512_patch_192/crossval_results_folds_0_1_2/PETCT_a37c4e231f_12132002.nii.gz,/well/papiez/users/hri611/python/nnUnet_raw/Dataset219_PETCT/labelsTr/PETCT_a37c4e231f_12132002.nii.gz,,0.0,0.0
344,0.8644668807138344,10157,354,0.7612872456395349,45395968,33521,33875,43678,/well/papiez/users/hri611/python/nnUNet_results/Dataset219_PETCT/nnUNetTrainer_1500epochs_1e2lr__nnUNetPlans__3d_fullres_maxnum_512_patch_192/crossval_results_folds_0_1_2/PETCT_a37da9e85d_03022002.nii.gz,/well/papiez/users/hri611/python/nnUnet_raw/Dataset219_PETCT/labelsTr/PETCT_a37da9e85d_03022002.nii.gz,0.8644668807138344,0.0,6.95453071975708
345,0.8380411883571951,7179,355,0.7212314067934581,52132974,19492,19847,26671,/well/papiez/users/hri611/python/nnUNet_results/Dataset219_PETCT/nnUNetTrainer_1500epochs_1e2lr__nnUNetPlans__3d_fullres_maxnum_512_patch_192/crossval_results_folds_0_1_2/PETCT_a3df01d3a3_10052002.nii.gz,/well/papiez/users/hri611/python/nnUnet_raw/Dataset219_PETCT/labelsTr/PETCT_a3df01d3a3_10052002.nii.gz,0.8380411883571951,0.0,6.170746398925781
346,0.6814268142681427,504,1050,0.5167910447761194,52156784,1662,2712,2166,/well/papiez/users/hri611/python/nnUNet_results/Dataset219_PETCT/nnUNetTrainer_1500epochs_1e2lr__nnUNetPlans__3d_fullres_maxnum_512_patch_192/crossval_results_folds_0_1_2/PETCT_a471649d35_05062002.nii.gz,/well/papiez/users/hri611/python/nnUnet_raw/Dataset219_PETCT/labelsTr/PETCT_a471649d35_05062002.nii.gz,0.6814268142681427,11.769205833435059,0.6469330902099609
347,,0,0,,49120000,0,0,0,/well/papiez/users/hri611/python/nnUNet_results/Dataset219_PETCT/nnUNetTrainer_1500epochs_1e2lr__nnUNetPlans__3d_fullres_maxnum_512_patch_192/crossval_results_folds_0_1_2/PETCT_a4a66c4fa7_07072006.nii.gz,/well/papiez/users/hri611/python/nnUnet_raw/Dataset219_PETCT/labelsTr/PETCT_a4a66c4fa7_07072006.nii.gz,,0.0,0.0
348,0.0,0,38613,0.0,45401387,0,38613,0,/well/papiez/users/hri611/python/nnUNet_results/Dataset219_PETCT/nnUNetTrainer_1500epochs_1e2lr__nnUNetPlans__3d_fullres_maxnum_512_patch_192/crossval_results_folds_0_1_2/PETCT_a4ccc397a9_11302002.nii.gz,/well/papiez/users/hri611/python/nnUnet_raw/Dataset219_PETCT/labelsTr/PETCT_a4ccc397a9_11302002.nii.gz,0.0,480.3851425437927,0.0
349,0.7769164513350559,213,46,0.6352112676056338,58879290,451,497,664,/well/papiez/users/hri611/python/nnUNet_results/Dataset219_PETCT/nnUNetTrainer_1500epochs_1e2lr__nnUNetPlans__3d_fullres_maxnum_512_patch_192/crossval_results_folds_0_1_2/PETCT_a4cd2b10de_12292001.nii.gz,/well/papiez/users/hri611/python/nnUnet_raw/Dataset219_PETCT/labelsTr/PETCT_a4cd2b10de_12292001.nii.gz,0.7769164513350559,0.19905633544921875,0.09952816772460937
350,0.9503105590062112,213,955,0.9053254437869822,92307663,11169,12124,11382,/well/papiez/users/hri611/python/nnUNet_results/Dataset219_PETCT/nnUNetTrainer_1500epochs_1e2lr__nnUNetPlans__3d_fullres_maxnum_512_patch_192/crossval_results_folds_0_1_2/PETCT_a61d8768d0_03262004.nii.gz,/well/papiez/users/hri611/python/nnUnet_raw/Dataset219_PETCT/labelsTr/PETCT_a61d8768d0_03262004.nii.gz,0.9503105590062112,0.3856716499328613,0.2737024612426758
351,0.0,0,119,0.0,52159881,0,119,0,/well/papiez/users/hri611/python/nnUNet_results/Dataset219_PETCT/nnUNetTrainer_1500epochs_1e2lr__nnUNetPlans__3d_fullres_maxnum_512_patch_192/crossval_results_folds_0_1_2/PETCT_a627fc68a1_02142003.nii.gz,/well/papiez/users/hri611/python/nnUnet_raw/Dataset219_PETCT/labelsTr/PETCT_a627fc68a1_02142003.nii.gz,0.0,1.4804814949035645,0.0
352,0.5938009787928222,0,249,0.4222737819025522,99039569,182,431,182,/well/papiez/users/hri611/python/nnUNet_results/Dataset219_PETCT/nnUNetTrainer_1500epochs_1e2lr__nnUNetPlans__3d_fullres_maxnum_512_patch_192/crossval_results_folds_0_1_2/PETCT_a86b2dc6ce_10142002.nii.gz,/well/papiez/users/hri611/python/nnUnet_raw/Dataset219_PETCT/labelsTr/PETCT_a86b2dc6ce_10142002.nii.gz,0.5938009787928222,1.5053635368347167,0.0
353,0.0,0,3,0.0,45439997,0,3,0,/well/papiez/users/hri611/python/nnUNet_results/Dataset219_PETCT/nnUNetTrainer_1500epochs_1e2lr__nnUNetPlans__3d_fullres_maxnum_512_patch_192/crossval_results_folds_0_1_2/PETCT_a87dda9193_01262003.nii.gz,/well/papiez/users/hri611/python/nnUnet_raw/Dataset219_PETCT/labelsTr/PETCT_a87dda9193_01262003.nii.gz,0.0,0.037323062896728515,0.0
354,0.0,0,110,0.0,52159890,0,110,0,/well/papiez/users/hri611/python/nnUNet_results/Dataset219_PETCT/nnUNetTrainer_1500epochs_1e2lr__nnUNetPlans__3d_fullres_maxnum_512_patch_192/crossval_results_folds_0_1_2/PETCT_a8a5e96821_03112005.nii.gz,/well/papiez/users/hri611/python/nnUnet_raw/Dataset219_PETCT/labelsTr/PETCT_a8a5e96821_03112005.nii.gz,0.0,1.3685123062133788,0.0
355,,0,0,,46720000,0,0,0,/well/papiez/users/hri611/python/nnUNet_results/Dataset219_PETCT/nnUNetTrainer_1500epochs_1e2lr__nnUNetPlans__3d_fullres_maxnum_512_patch_192/crossval_results_folds_0_1_2/PETCT_a8a5e96821_09302005.nii.gz,/well/papiez/users/hri611/python/nnUnet_raw/Dataset219_PETCT/labelsTr/PETCT_a8a5e96821_09302005.nii.gz,,0.0,0.0
356,0.0,0,30,0.0,52159970,0,30,0,/well/papiez/users/hri611/python/nnUNet_results/Dataset219_PETCT/nnUNetTrainer_1500epochs_1e2lr__nnUNetPlans__3d_fullres_maxnum_512_patch_192/crossval_results_folds_0_1_2/PETCT_a90955352e_05162003.nii.gz,/well/papiez/users/hri611/python/nnUnet_raw/Dataset219_PETCT/labelsTr/PETCT_a90955352e_05162003.nii.gz,0.0,0.37323062896728515,0.0
357,0.634718826405868,4020,462,0.4648997134670487,45431624,3894,4356,7914,/well/papiez/users/hri611/python/nnUNet_results/Dataset219_PETCT/nnUNetTrainer_1500epochs_1e2lr__nnUNetPlans__3d_fullres_maxnum_512_patch_192/crossval_results_folds_0_1_2/PETCT_ab1fa26e5e_06232001.nii.gz,/well/papiez/users/hri611/python/nnUnet_raw/Dataset219_PETCT/labelsTr/PETCT_ab1fa26e5e_06232001.nii.gz,0.634718826405868,0.0,4.652941841125489
358,0.8861468638088147,1280,1931,0.7955688546507926,105744293,12496,14427,13776,/well/papiez/users/hri611/python/nnUNet_results/Dataset219_PETCT/nnUNetTrainer_1500epochs_1e2lr__nnUNetPlans__3d_fullres_maxnum_512_patch_192/crossval_results_folds_0_1_2/PETCT_ab953a5230_11032003.nii.gz,/well/papiez/users/hri611/python/nnUnet_raw/Dataset219_PETCT/labelsTr/PETCT_ab953a5230_11032003.nii.gz,0.8861468638088147,1.2441020965576173,1.9781223335266114
359,0.5509567563011043,10467,187,0.38022105875509016,45422810,6536,6723,17003,/well/papiez/users/hri611/python/nnUNet_results/Dataset219_PETCT/nnUNetTrainer_1500epochs_1e2lr__nnUNetPlans__3d_fullres_maxnum_512_patch_192/crossval_results_folds_0_1_2/PETCT_ac11b344b6_11032002.nii.gz,/well/papiez/users/hri611/python/nnUnet_raw/Dataset219_PETCT/labelsTr/PETCT_ac11b344b6_11032002.nii.gz,0.5509567563011043,0.0,2.0652094802856444
360,0.578484081804765,15541,453,0.4069487188994772,52133031,10975,11428,26516,/well/papiez/users/hri611/python/nnUNet_results/Dataset219_PETCT/nnUNetTrainer_1500epochs_1e2lr__nnUNetPlans__3d_fullres_maxnum_512_patch_192/crossval_results_folds_0_1_2/PETCT_ad7c6a4a58_03282003.nii.gz,/well/papiez/users/hri611/python/nnUnet_raw/Dataset219_PETCT/labelsTr/PETCT_ad7c6a4a58_03282003.nii.gz,0.578484081804765,0.12441020965576172,35.91722752761841
361,0.0,0,72,0.0,52799928,0,72,0,/well/papiez/users/hri611/python/nnUNet_results/Dataset219_PETCT/nnUNetTrainer_1500epochs_1e2lr__nnUNetPlans__3d_fullres_maxnum_512_patch_192/crossval_results_folds_0_1_2/PETCT_ad99263bec_01292006.nii.gz,/well/papiez/users/hri611/python/nnUnet_raw/Dataset219_PETCT/labelsTr/PETCT_ad99263bec_01292006.nii.gz,0.0,0.8957535095214844,0.0
362,0.0,0,159031,0.0,52000969,0,159031,0,/well/papiez/users/hri611/python/nnUNet_results/Dataset219_PETCT/nnUNetTrainer_1500epochs_1e2lr__nnUNetPlans__3d_fullres_maxnum_512_patch_192/crossval_results_folds_0_1_2/PETCT_adc49adb3d_09222002.nii.gz,/well/papiez/users/hri611/python/nnUnet_raw/Dataset219_PETCT/labelsTr/PETCT_adc49adb3d_09222002.nii.gz,0.0,1978.5080051765442,0.0
363,0.904525153787815,1,2265,0.8256923076923077,45427000,10734,12999,10735,/well/papiez/users/hri611/python/nnUNet_results/Dataset219_PETCT/nnUNetTrainer_1500epochs_1e2lr__nnUNetPlans__3d_fullres_maxnum_512_patch_192/crossval_results_folds_0_1_2/PETCT_ae3074834a_07262003.nii.gz,/well/papiez/users/hri611/python/nnUnet_raw/Dataset219_PETCT/labelsTr/PETCT_ae3074834a_07262003.nii.gz,0.904525153787815,0.0,0.0
364,0.0,0,14,0.0,52159986,0,14,0,/well/papiez/users/hri611/python/nnUNet_results/Dataset219_PETCT/nnUNetTrainer_1500epochs_1e2lr__nnUNetPlans__3d_fullres_maxnum_512_patch_192/crossval_results_folds_0_1_2/PETCT_ae46202abb_02282003.nii.gz,/well/papiez/users/hri611/python/nnUnet_raw/Dataset219_PETCT/labelsTr/PETCT_ae46202abb_02282003.nii.gz,0.0,0.1741742935180664,0.0
365,,0,0,,38720000,0,0,0,/well/papiez/users/hri611/python/nnUNet_results/Dataset219_PETCT/nnUNetTrainer_1500epochs_1e2lr__nnUNetPlans__3d_fullres_maxnum_512_patch_192/crossval_results_folds_0_1_2/PETCT_ae4dcc5dd3_10082004.nii.gz,/well/papiez/users/hri611/python/nnUnet_raw/Dataset219_PETCT/labelsTr/PETCT_ae4dcc5dd3_10082004.nii.gz,,0.0,0.0
366,0.0,0,146,0.0,52159854,0,146,0,/well/papiez/users/hri611/python/nnUNet_results/Dataset219_PETCT/nnUNetTrainer_1500epochs_1e2lr__nnUNetPlans__3d_fullres_maxnum_512_patch_192/crossval_results_folds_0_1_2/PETCT_ae6a37a9d6_02102005.nii.gz,/well/papiez/users/hri611/python/nnUnet_raw/Dataset219_PETCT/labelsTr/PETCT_ae6a37a9d6_02102005.nii.gz,0.0,1.8163890609741211,0.0
367,0.0,0,48,0.0,48159952,0,48,0,/well/papiez/users/hri611/python/nnUNet_results/Dataset219_PETCT/nnUNetTrainer_1500epochs_1e2lr__nnUNetPlans__3d_fullres_maxnum_512_patch_192/crossval_results_folds_0_1_2/PETCT_ae6a37a9d6_08182005.nii.gz,/well/papiez/users/hri611/python/nnUnet_raw/Dataset219_PETCT/labelsTr/PETCT_ae6a37a9d6_08182005.nii.gz,0.0,0.5971690063476562,0.0
368,,0,0,,52160000,0,0,0,/well/papiez/users/hri611/python/nnUNet_results/Dataset219_PETCT/nnUNetTrainer_1500epochs_1e2lr__nnUNetPlans__3d_fullres_maxnum_512_patch_192/crossval_results_folds_0_1_2/PETCT_ae6a37a9d6_09132003.nii.gz,/well/papiez/users/hri611/python/nnUnet_raw/Dataset219_PETCT/labelsTr/PETCT_ae6a37a9d6_09132003.nii.gz,,0.0,0.0
369,0.0,0,80,0.0,52159920,0,80,0,/well/papiez/users/hri611/python/nnUNet_results/Dataset219_PETCT/nnUNetTrainer_1500epochs_1e2lr__nnUNetPlans__3d_fullres_maxnum_512_patch_192/crossval_results_folds_0_1_2/PETCT_ae6a37a9d6_09152002.nii.gz,/well/papiez/users/hri611/python/nnUnet_raw/Dataset219_PETCT/labelsTr/PETCT_ae6a37a9d6_09152002.nii.gz,0.0,0.9952816772460937,0.0
370,,0,0,,52160000,0,0,0,/well/papiez/users/hri611/python/nnUNet_results/Dataset219_PETCT/nnUNetTrainer_1500epochs_1e2lr__nnUNetPlans__3d_fullres_maxnum_512_patch_192/crossval_results_folds_0_1_2/PETCT_ae96f738c0_09112003.nii.gz,/well/papiez/users/hri611/python/nnUnet_raw/Dataset219_PETCT/labelsTr/PETCT_ae96f738c0_09112003.nii.gz,,0.0,0.0
371,,0,0,,99040000,0,0,0,/well/papiez/users/hri611/python/nnUNet_results/Dataset219_PETCT/nnUNetTrainer_1500epochs_1e2lr__nnUNetPlans__3d_fullres_maxnum_512_patch_192/crossval_results_folds_0_1_2/PETCT_af119148fe_02112005.nii.gz,/well/papiez/users/hri611/python/nnUnet_raw/Dataset219_PETCT/labelsTr/PETCT_af119148fe_02112005.nii.gz,,0.0,0.0
372,,0,0,,99040000,0,0,0,/well/papiez/users/hri611/python/nnUNet_results/Dataset219_PETCT/nnUNetTrainer_1500epochs_1e2lr__nnUNetPlans__3d_fullres_maxnum_512_patch_192/crossval_results_folds_0_1_2/PETCT_af119148fe_12052002.nii.gz,/well/papiez/users/hri611/python/nnUnet_raw/Dataset219_PETCT/labelsTr/PETCT_af119148fe_12052002.nii.gz,,0.0,0.0
373,0.0,0,1620,0.0,45438380,0,1620,0,/well/papiez/users/hri611/python/nnUNet_results/Dataset219_PETCT/nnUNetTrainer_1500epochs_1e2lr__nnUNetPlans__3d_fullres_maxnum_512_patch_192/crossval_results_folds_0_1_2/PETCT_af547fa618_03112006.nii.gz,/well/papiez/users/hri611/python/nnUnet_raw/Dataset219_PETCT/labelsTr/PETCT_af547fa618_03112006.nii.gz,0.0,20.154453964233397,0.0
374,0.9482614410323814,357,76,0.9016132697114292,99035599,3968,4044,4325,/well/papiez/users/hri611/python/nnUNet_results/Dataset219_PETCT/nnUNetTrainer_1500epochs_1e2lr__nnUNetPlans__3d_fullres_maxnum_512_patch_192/crossval_results_folds_0_1_2/PETCT_af73b85f2c_06192003.nii.gz,/well/papiez/users/hri611/python/nnUnet_raw/Dataset219_PETCT/labelsTr/PETCT_af73b85f2c_06192003.nii.gz,0.9482614410323814,0.0,0.0
375,,0,0,,49440000,0,0,0,/well/papiez/users/hri611/python/nnUNet_results/Dataset219_PETCT/nnUNetTrainer_1500epochs_1e2lr__nnUNetPlans__3d_fullres_maxnum_512_patch_192/crossval_results_folds_0_1_2/PETCT_b0e002e974_03112007.nii.gz,/well/papiez/users/hri611/python/nnUnet_raw/Dataset219_PETCT/labelsTr/PETCT_b0e002e974_03112007.nii.gz,,0.0,0.0
376,,0,0,,52800000,0,0,0,/well/papiez/users/hri611/python/nnUNet_results/Dataset219_PETCT/nnUNetTrainer_1500epochs_1e2lr__nnUNetPlans__3d_fullres_maxnum_512_patch_192/crossval_results_folds_0_1_2/PETCT_b0e002e974_09232005.nii.gz,/well/papiez/users/hri611/python/nnUnet_raw/Dataset219_PETCT/labelsTr/PETCT_b0e002e974_09232005.nii.gz,,0.0,0.0
377,0.8585723001830384,963,196,0.7521915757964507,52155323,3518,3714,4481,/well/papiez/users/hri611/python/nnUNet_results/Dataset219_PETCT/nnUNetTrainer_1500epochs_1e2lr__nnUNetPlans__3d_fullres_maxnum_512_patch_192/crossval_results_folds_0_1_2/PETCT_b1aa7ce13e_03092003.nii.gz,/well/papiez/users/hri611/python/nnUnet_raw/Dataset219_PETCT/labelsTr/PETCT_b1aa7ce13e_03092003.nii.gz,0.8585723001830384,0.0,2.749465633392334
378,,0,0,,50080000,0,0,0,/well/papiez/users/hri611/python/nnUNet_results/Dataset219_PETCT/nnUNetTrainer_1500epochs_1e2lr__nnUNetPlans__3d_fullres_maxnum_512_patch_192/crossval_results_folds_0_1_2/PETCT_b1d6679284_05282007.nii.gz,/well/papiez/users/hri611/python/nnUnet_raw/Dataset219_PETCT/labelsTr/PETCT_b1d6679284_05282007.nii.gz,,0.0,0.0
379,0.0,0,1,0.0,45439999,0,1,0,/well/papiez/users/hri611/python/nnUNet_results/Dataset219_PETCT/nnUNetTrainer_1500epochs_1e2lr__nnUNetPlans__3d_fullres_maxnum_512_patch_192/crossval_results_folds_0_1_2/PETCT_b2f82ed4b9_04172003.nii.gz,/well/papiez/users/hri611/python/nnUnet_raw/Dataset219_PETCT/labelsTr/PETCT_b2f82ed4b9_04172003.nii.gz,0.0,0.012441020965576172,0.0
380,0.8200439245215365,4622,7423,0.6949783484008205,45400511,27444,34867,32066,/well/papiez/users/hri611/python/nnUNet_results/Dataset219_PETCT/nnUNetTrainer_1500epochs_1e2lr__nnUNetPlans__3d_fullres_maxnum_512_patch_192/crossval_results_folds_0_1_2/PETCT_b327726c24_08272000.nii.gz,/well/papiez/users/hri611/python/nnUnet_raw/Dataset219_PETCT/labelsTr/PETCT_b327726c24_08272000.nii.gz,0.8200439245215365,8.758478759765625,0.012441020965576172
381,0.46485431726462373,11857,210,0.30280795008088746,52142692,5241,5451,17098,/well/papiez/users/hri611/python/nnUNet_results/Dataset219_PETCT/nnUNetTrainer_1500epochs_1e2lr__nnUNetPlans__3d_fullres_maxnum_512_patch_192/crossval_results_folds_0_1_2/PETCT_b3d4773f85_11042000.nii.gz,/well/papiez/users/hri611/python/nnUnet_raw/Dataset219_PETCT/labelsTr/PETCT_b3d4773f85_11042000.nii.gz,0.46485431726462373,0.0,15.377101913452147
382,,0,0,,52160000,0,0,0,/well/papiez/users/hri611/python/nnUNet_results/Dataset219_PETCT/nnUNetTrainer_1500epochs_1e2lr__nnUNetPlans__3d_fullres_maxnum_512_patch_192/crossval_results_folds_0_1_2/PETCT_b3e923029c_11212003.nii.gz,/well/papiez/users/hri611/python/nnUnet_raw/Dataset219_PETCT/labelsTr/PETCT_b3e923029c_11212003.nii.gz,,0.0,0.0
383,0.864406779661017,0,48,0.7611940298507462,58879799,153,201,153,/well/papiez/users/hri611/python/nnUNet_results/Dataset219_PETCT/nnUNetTrainer_1500epochs_1e2lr__nnUNetPlans__3d_fullres_maxnum_512_patch_192/crossval_results_folds_0_1_2/PETCT_b41bc7c1e5_03122005.nii.gz,/well/papiez/users/hri611/python/nnUnet_raw/Dataset219_PETCT/labelsTr/PETCT_b41bc7c1e5_03122005.nii.gz,0.864406779661017,0.0,0.0
384,0.0,0,256,0.0,45119744,0,256,0,/well/papiez/users/hri611/python/nnUNet_results/Dataset219_PETCT/nnUNetTrainer_1500epochs_1e2lr__nnUNetPlans__3d_fullres_maxnum_512_patch_192/crossval_results_folds_0_1_2/PETCT_b4247b8ecd_10202006.nii.gz,/well/papiez/users/hri611/python/nnUnet_raw/Dataset219_PETCT/labelsTr/PETCT_b4247b8ecd_10202006.nii.gz,0.0,3.1849013671875,0.0
385,0.0,0,24,0.0,52159976,0,24,0,/well/papiez/users/hri611/python/nnUNet_results/Dataset219_PETCT/nnUNetTrainer_1500epochs_1e2lr__nnUNetPlans__3d_fullres_maxnum_512_patch_192/crossval_results_folds_0_1_2/PETCT_b42adab18e_09052003.nii.gz,/well/papiez/users/hri611/python/nnUnet_raw/Dataset219_PETCT/labelsTr/PETCT_b42adab18e_09052003.nii.gz,0.0,0.2985845031738281,0.0
386,0.0,0,5,0.0,52159995,0,5,0,/well/papiez/users/hri611/python/nnUNet_results/Dataset219_PETCT/nnUNetTrainer_1500epochs_1e2lr__nnUNetPlans__3d_fullres_maxnum_512_patch_192/crossval_results_folds_0_1_2/PETCT_b4e5c1047c_10102004.nii.gz,/well/papiez/users/hri611/python/nnUnet_raw/Dataset219_PETCT/labelsTr/PETCT_b4e5c1047c_10102004.nii.gz,0.0,0.06220510482788086,0.0
387,0.8218722422103047,67,5181,0.6976087582829156,52142645,12107,17288,12174,/well/papiez/users/hri611/python/nnUNet_results/Dataset219_PETCT/nnUNetTrainer_1500epochs_1e2lr__nnUNetPlans__3d_fullres_maxnum_512_patch_192/crossval_results_folds_0_1_2/PETCT_b509ace2a2_05272002.nii.gz,/well/papiez/users/hri611/python/nnUnet_raw/Dataset219_PETCT/labelsTr/PETCT_b509ace2a2_05272002.nii.gz,0.8218722422103047,0.2239383773803711,0.5349639015197754
388,0.45849802371541504,4,544,0.29743589743589743,52159220,232,776,236,/well/papiez/users/hri611/python/nnUNet_results/Dataset219_PETCT/nnUNetTrainer_1500epochs_1e2lr__nnUNetPlans__3d_fullres_maxnum_512_patch_192/crossval_results_folds_0_1_2/PETCT_b510436d83_11102002.nii.gz,/well/papiez/users/hri611/python/nnUnet_raw/Dataset219_PETCT/labelsTr/PETCT_b510436d83_11102002.nii.gz,0.45849802371541504,6.332479671478271,0.0
389,0.0,137,0,0.0,45439863,0,0,137,/well/papiez/users/hri611/python/nnUNet_results/Dataset219_PETCT/nnUNetTrainer_1500epochs_1e2lr__nnUNetPlans__3d_fullres_maxnum_512_patch_192/crossval_results_folds_0_1_2/PETCT_b510436d83_11142003.nii.gz,/well/papiez/users/hri611/python/nnUnet_raw/Dataset219_PETCT/labelsTr/PETCT_b510436d83_11142003.nii.gz,0.0,0.0,1.7044198722839354
390,,0,0,,55520000,0,0,0,/well/papiez/users/hri611/python/nnUNet_results/Dataset219_PETCT/nnUNetTrainer_1500epochs_1e2lr__nnUNetPlans__3d_fullres_maxnum_512_patch_192/crossval_results_folds_0_1_2/PETCT_b57e1c1f5f_06252006.nii.gz,/well/papiez/users/hri611/python/nnUnet_raw/Dataset219_PETCT/labelsTr/PETCT_b57e1c1f5f_06252006.nii.gz,,0.0,0.0
391,0.9273743016759777,5,125,0.8645833333333334,52799040,830,955,835,/well/papiez/users/hri611/python/nnUNet_results/Dataset219_PETCT/nnUNetTrainer_1500epochs_1e2lr__nnUNetPlans__3d_fullres_maxnum_512_patch_192/crossval_results_folds_0_1_2/PETCT_b5923963ac_02172007.nii.gz,/well/papiez/users/hri611/python/nnUnet_raw/Dataset219_PETCT/labelsTr/PETCT_b5923963ac_02172007.nii.gz,0.9273743016759777,0.0,0.0
392,,0,0,,52160000,0,0,0,/well/papiez/users/hri611/python/nnUNet_results/Dataset219_PETCT/nnUNetTrainer_1500epochs_1e2lr__nnUNetPlans__3d_fullres_maxnum_512_patch_192/crossval_results_folds_0_1_2/PETCT_b62864161e_07282002.nii.gz,/well/papiez/users/hri611/python/nnUnet_raw/Dataset219_PETCT/labelsTr/PETCT_b62864161e_07282002.nii.gz,,0.0,0.0
393,0.0,0,20,0.0,52159980,0,20,0,/well/papiez/users/hri611/python/nnUNet_results/Dataset219_PETCT/nnUNetTrainer_1500epochs_1e2lr__nnUNetPlans__3d_fullres_maxnum_512_patch_192/crossval_results_folds_0_1_2/PETCT_b66ba83594_03132003.nii.gz,/well/papiez/users/hri611/python/nnUnet_raw/Dataset219_PETCT/labelsTr/PETCT_b66ba83594_03132003.nii.gz,0.0,0.24882041931152343,0.0
394,0.44086021505376344,722,6,0.2827586206896552,52158985,287,293,1009,/well/papiez/users/hri611/python/nnUNet_results/Dataset219_PETCT/nnUNetTrainer_1500epochs_1e2lr__nnUNetPlans__3d_fullres_maxnum_512_patch_192/crossval_results_folds_0_1_2/PETCT_b6a3c72db6_07132002.nii.gz,/well/papiez/users/hri611/python/nnUnet_raw/Dataset219_PETCT/labelsTr/PETCT_b6a3c72db6_07132002.nii.gz,0.44086021505376344,0.0,7.825402187347412
395,0.8821106900411827,10211,1268,0.7890858980248048,45385575,42946,44214,53157,/well/papiez/users/hri611/python/nnUNet_results/Dataset219_PETCT/nnUNetTrainer_1500epochs_1e2lr__nnUNetPlans__3d_fullres_maxnum_512_patch_192/crossval_results_folds_0_1_2/PETCT_b6fc20942c_12282001.nii.gz,/well/papiez/users/hri611/python/nnUnet_raw/Dataset219_PETCT/labelsTr/PETCT_b6fc20942c_12282001.nii.gz,0.8821106900411827,0.04976408386230469,0.58472798538208
396,0.806146572104019,2580,1356,0.6752475247524753,38707880,8184,9540,10764,/well/papiez/users/hri611/python/nnUNet_results/Dataset219_PETCT/nnUNetTrainer_1500epochs_1e2lr__nnUNetPlans__3d_fullres_maxnum_512_patch_192/crossval_results_folds_0_1_2/PETCT_b899150306_08112002.nii.gz,/well/papiez/users/hri611/python/nnUnet_raw/Dataset219_PETCT/labelsTr/PETCT_b899150306_08112002.nii.gz,0.806146572104019,0.0,11.806528896331788
397,0.0,0,53,0.0,52159947,0,53,0,/well/papiez/users/hri611/python/nnUNet_results/Dataset219_PETCT/nnUNetTrainer_1500epochs_1e2lr__nnUNetPlans__3d_fullres_maxnum_512_patch_192/crossval_results_folds_0_1_2/PETCT_b926177c87_10102004.nii.gz,/well/papiez/users/hri611/python/nnUnet_raw/Dataset219_PETCT/labelsTr/PETCT_b926177c87_10102004.nii.gz,0.0,0.6593741111755371,0.0
398,,0,0,,51520000,0,0,0,/well/papiez/users/hri611/python/nnUNet_results/Dataset219_PETCT/nnUNetTrainer_1500epochs_1e2lr__nnUNetPlans__3d_fullres_maxnum_512_patch_192/crossval_results_folds_0_1_2/PETCT_ba81e4b04b_12022005.nii.gz,/well/papiez/users/hri611/python/nnUnet_raw/Dataset219_PETCT/labelsTr/PETCT_ba81e4b04b_12022005.nii.gz,,0.0,0.0
399,0.8515194457565738,0,943,0.7414313134082807,92316353,2704,3647,2704,/well/papiez/users/hri611/python/nnUNet_results/Dataset219_PETCT/nnUNetTrainer_1500epochs_1e2lr__nnUNetPlans__3d_fullres_maxnum_512_patch_192/crossval_results_folds_0_1_2/PETCT_bc80d06f97_02182002.nii.gz,/well/papiez/users/hri611/python/nnUnet_raw/Dataset219_PETCT/labelsTr/PETCT_bc80d06f97_02182002.nii.gz,0.8515194457565738,2.164737648010254,0.0
400,0.9297768589469899,1861,1264,0.8687691597026834,45416187,20688,21952,22549,/well/papiez/users/hri611/python/nnUNet_results/Dataset219_PETCT/nnUNetTrainer_1500epochs_1e2lr__nnUNetPlans__3d_fullres_maxnum_512_patch_192/crossval_results_folds_0_1_2/PETCT_bca97006e4_05062001.nii.gz,/well/papiez/users/hri611/python/nnUnet_raw/Dataset219_PETCT/labelsTr/PETCT_bca97006e4_05062001.nii.gz,0.9297768589469899,0.0,0.0
401,0.6424759871931697,580,90,0.47327044025157233,45438728,602,692,1182,/well/papiez/users/hri611/python/nnUNet_results/Dataset219_PETCT/nnUNetTrainer_1500epochs_1e2lr__nnUNetPlans__3d_fullres_maxnum_512_patch_192/crossval_results_folds_0_1_2/PETCT_bd52fdf529_12032000.nii.gz,/well/papiez/users/hri611/python/nnUnet_raw/Dataset219_PETCT/labelsTr/PETCT_bd52fdf529_12032000.nii.gz,0.6424759871931697,0.0,6.979412761688232
402,0.0,0,2688,0.0,45437312,0,2688,0,/well/papiez/users/hri611/python/nnUNet_results/Dataset219_PETCT/nnUNetTrainer_1500epochs_1e2lr__nnUNetPlans__3d_fullres_maxnum_512_patch_192/crossval_results_folds_0_1_2/PETCT_bd76c8d299_10252002.nii.gz,/well/papiez/users/hri611/python/nnUnet_raw/Dataset219_PETCT/labelsTr/PETCT_bd76c8d299_10252002.nii.gz,0.0,33.44146435546875,0.0
403,0.8350456072971676,2240,1196,0.7168054067419435,45427867,8697,9893,10937,/well/papiez/users/hri611/python/nnUNet_results/Dataset219_PETCT/nnUNetTrainer_1500epochs_1e2lr__nnUNetPlans__3d_fullres_maxnum_512_patch_192/crossval_results_folds_0_1_2/PETCT_bd7c02faa9_05042002.nii.gz,/well/papiez/users/hri611/python/nnUnet_raw/Dataset219_PETCT/labelsTr/PETCT_bd7c02faa9_05042002.nii.gz,0.8350456072971676,0.4478767547607422,3.3839577026367187
404,,0,0,,50400000,0,0,0,/well/papiez/users/hri611/python/nnUNet_results/Dataset219_PETCT/nnUNetTrainer_1500epochs_1e2lr__nnUNetPlans__3d_fullres_maxnum_512_patch_192/crossval_results_folds_0_1_2/PETCT_be0d3c767e_05292006.nii.gz,/well/papiez/users/hri611/python/nnUnet_raw/Dataset219_PETCT/labelsTr/PETCT_be0d3c767e_05292006.nii.gz,,0.0,0.0
405,0.8578083148946082,991,230,0.7510195758564437,45435096,3683,3913,4674,/well/papiez/users/hri611/python/nnUNet_results/Dataset219_PETCT/nnUNetTrainer_1500epochs_1e2lr__nnUNetPlans__3d_fullres_maxnum_512_patch_192/crossval_results_folds_0_1_2/PETCT_be3e55a32f_04052001.nii.gz,/well/papiez/users/hri611/python/nnUnet_raw/Dataset219_PETCT/labelsTr/PETCT_be3e55a32f_04052001.nii.gz,0.8578083148946082,0.32346654510498046,0.012441020965576172
406,0.0,0,533,0.0,51679467,0,533,0,/well/papiez/users/hri611/python/nnUNet_results/Dataset219_PETCT/nnUNetTrainer_1500epochs_1e2lr__nnUNetPlans__3d_fullres_maxnum_512_patch_192/crossval_results_folds_0_1_2/PETCT_bef465b4ad_05042007.nii.gz,/well/papiez/users/hri611/python/nnUnet_raw/Dataset219_PETCT/labelsTr/PETCT_bef465b4ad_05042007.nii.gz,0.0,6.631064174652099,0.0
407,0.32905125117088185,19865,191,0.19692480179386562,45415026,4918,5109,24783,/well/papiez/users/hri611/python/nnUNet_results/Dataset219_PETCT/nnUNetTrainer_1500epochs_1e2lr__nnUNetPlans__3d_fullres_maxnum_512_patch_192/crossval_results_folds_0_1_2/PETCT_bf178a41b2_06082002.nii.gz,/well/papiez/users/hri611/python/nnUnet_raw/Dataset219_PETCT/labelsTr/PETCT_bf178a41b2_06082002.nii.gz,0.32905125117088185,0.0,65.22827292251587
408,,0,0,,47360000,0,0,0,/well/papiez/users/hri611/python/nnUNet_results/Dataset219_PETCT/nnUNetTrainer_1500epochs_1e2lr__nnUNetPlans__3d_fullres_maxnum_512_patch_192/crossval_results_folds_0_1_2/PETCT_bfd89440db_03112007.nii.gz,/well/papiez/users/hri611/python/nnUnet_raw/Dataset219_PETCT/labelsTr/PETCT_bfd89440db_03112007.nii.gz,,0.0,0.0
409,0.0,0,50,0.0,48159950,0,50,0,/well/papiez/users/hri611/python/nnUNet_results/Dataset219_PETCT/nnUNetTrainer_1500epochs_1e2lr__nnUNetPlans__3d_fullres_maxnum_512_patch_192/crossval_results_folds_0_1_2/PETCT_c018b45a49_11262006.nii.gz,/well/papiez/users/hri611/python/nnUnet_raw/Dataset219_PETCT/labelsTr/PETCT_c018b45a49_11262006.nii.gz,0.0,0.6220510482788086,0.0
410,0.0,0,125,0.0,52799875,0,125,0,/well/papiez/users/hri611/python/nnUNet_results/Dataset219_PETCT/nnUNetTrainer_1500epochs_1e2lr__nnUNetPlans__3d_fullres_maxnum_512_patch_192/crossval_results_folds_0_1_2/PETCT_c08293f2b2_07132006.nii.gz,/well/papiez/users/hri611/python/nnUnet_raw/Dataset219_PETCT/labelsTr/PETCT_c08293f2b2_07132006.nii.gz,0.0,1.5551276206970215,0.0
411,,0,0,,50400000,0,0,0,/well/papiez/users/hri611/python/nnUNet_results/Dataset219_PETCT/nnUNetTrainer_1500epochs_1e2lr__nnUNetPlans__3d_fullres_maxnum_512_patch_192/crossval_results_folds_0_1_2/PETCT_c094a24c03_01292006.nii.gz,/well/papiez/users/hri611/python/nnUnet_raw/Dataset219_PETCT/labelsTr/PETCT_c094a24c03_01292006.nii.gz,,0.0,0.0
412,0.0,0,19,0.0,52159981,0,19,0,/well/papiez/users/hri611/python/nnUNet_results/Dataset219_PETCT/nnUNetTrainer_1500epochs_1e2lr__nnUNetPlans__3d_fullres_maxnum_512_patch_192/crossval_results_folds_0_1_2/PETCT_c094a24c03_03042007.nii.gz,/well/papiez/users/hri611/python/nnUnet_raw/Dataset219_PETCT/labelsTr/PETCT_c094a24c03_03042007.nii.gz,0.0,0.23637939834594726,0.0
413,0.0,0,504,0.0,52159496,0,504,0,/well/papiez/users/hri611/python/nnUNet_results/Dataset219_PETCT/nnUNetTrainer_1500epochs_1e2lr__nnUNetPlans__3d_fullres_maxnum_512_patch_192/crossval_results_folds_0_1_2/PETCT_c10f48b173_11272004.nii.gz,/well/papiez/users/hri611/python/nnUnet_raw/Dataset219_PETCT/labelsTr/PETCT_c10f48b173_11272004.nii.gz,0.0,6.27027456665039,0.0
414,0.7675411836485662,183,198,0.6227722772277228,45438990,629,827,812,/well/papiez/users/hri611/python/nnUNet_results/Dataset219_PETCT/nnUNetTrainer_1500epochs_1e2lr__nnUNetPlans__3d_fullres_maxnum_512_patch_192/crossval_results_folds_0_1_2/PETCT_c16c13211c_10262003.nii.gz,/well/papiez/users/hri611/python/nnUnet_raw/Dataset219_PETCT/labelsTr/PETCT_c16c13211c_10262003.nii.gz,0.7675411836485662,0.012441020965576172,0.6096100273132324
415,0.9084119654687813,536,1745,0.8321930405355698,72146407,11312,13057,11848,/well/papiez/users/hri611/python/nnUNet_results/Dataset219_PETCT/nnUNetTrainer_1500epochs_1e2lr__nnUNetPlans__3d_fullres_maxnum_512_patch_192/crossval_results_folds_0_1_2/PETCT_c16d325d12_02152003.nii.gz,/well/papiez/users/hri611/python/nnUnet_raw/Dataset219_PETCT/labelsTr/PETCT_c16d325d12_02152003.nii.gz,0.9084119654687813,0.24882041931152343,0.024882041931152343
416,,0,0,,51040000,0,0,0,/well/papiez/users/hri611/python/nnUNet_results/Dataset219_PETCT/nnUNetTrainer_1500epochs_1e2lr__nnUNetPlans__3d_fullres_maxnum_512_patch_192/crossval_results_folds_0_1_2/PETCT_c1c9e78e0e_05142007.nii.gz,/well/papiez/users/hri611/python/nnUnet_raw/Dataset219_PETCT/labelsTr/PETCT_c1c9e78e0e_05142007.nii.gz,,0.0,0.0
417,0.720954356846473,10851,447,0.5636658556366586,52134107,14595,15042,25446,/well/papiez/users/hri611/python/nnUNet_results/Dataset219_PETCT/nnUNetTrainer_1500epochs_1e2lr__nnUNetPlans__3d_fullres_maxnum_512_patch_192/crossval_results_folds_0_1_2/PETCT_c29aba73da_08232002.nii.gz,/well/papiez/users/hri611/python/nnUnet_raw/Dataset219_PETCT/labelsTr/PETCT_c29aba73da_08232002.nii.gz,0.720954356846473,0.0,4.553413673400879
418,0.0,0,209,0.0,72159791,0,209,0,/well/papiez/users/hri611/python/nnUNet_results/Dataset219_PETCT/nnUNetTrainer_1500epochs_1e2lr__nnUNetPlans__3d_fullres_maxnum_512_patch_192/crossval_results_folds_0_1_2/PETCT_c2b776974a_05092005.nii.gz,/well/papiez/users/hri611/python/nnUnet_raw/Dataset219_PETCT/labelsTr/PETCT_c2b776974a_05092005.nii.gz,0.0,2.60017338180542,0.0
419,,0,0,,38720000,0,0,0,/well/papiez/users/hri611/python/nnUNet_results/Dataset219_PETCT/nnUNetTrainer_1500epochs_1e2lr__nnUNetPlans__3d_fullres_maxnum_512_patch_192/crossval_results_folds_0_1_2/PETCT_c2ffda4725_04112003.nii.gz,/well/papiez/users/hri611/python/nnUnet_raw/Dataset219_PETCT/labelsTr/PETCT_c2ffda4725_04112003.nii.gz,,0.0,0.0
420,,0,0,,38720000,0,0,0,/well/papiez/users/hri611/python/nnUNet_results/Dataset219_PETCT/nnUNetTrainer_1500epochs_1e2lr__nnUNetPlans__3d_fullres_maxnum_512_patch_192/crossval_results_folds_0_1_2/PETCT_c2ffda4725_09192003.nii.gz,/well/papiez/users/hri611/python/nnUnet_raw/Dataset219_PETCT/labelsTr/PETCT_c2ffda4725_09192003.nii.gz,,0.0,0.0
421,0.0,0,43,0.0,58879957,0,43,0,/well/papiez/users/hri611/python/nnUNet_results/Dataset219_PETCT/nnUNetTrainer_1500epochs_1e2lr__nnUNetPlans__3d_fullres_maxnum_512_patch_192/crossval_results_folds_0_1_2/PETCT_c395306306_08242002.nii.gz,/well/papiez/users/hri611/python/nnUnet_raw/Dataset219_PETCT/labelsTr/PETCT_c395306306_08242002.nii.gz,0.0,0.5349639015197754,0.0
422,0.9089557304714648,3513,2120,0.8331061863000712,52126248,28119,30239,31632,/well/papiez/users/hri611/python/nnUNet_results/Dataset219_PETCT/nnUNetTrainer_1500epochs_1e2lr__nnUNetPlans__3d_fullres_maxnum_512_patch_192/crossval_results_folds_0_1_2/PETCT_c517c47bed_02062003.nii.gz,/well/papiez/users/hri611/python/nnUnet_raw/Dataset219_PETCT/labelsTr/PETCT_c517c47bed_02062003.nii.gz,0.9089557304714648,0.9703996353149413,0.9703996353149413
423,0.28308823529411764,1946,4,0.16488222698072805,45437665,385,389,2331,/well/papiez/users/hri611/python/nnUNet_results/Dataset219_PETCT/nnUNetTrainer_1500epochs_1e2lr__nnUNetPlans__3d_fullres_maxnum_512_patch_192/crossval_results_folds_0_1_2/PETCT_c58477f3b4_12072002.nii.gz,/well/papiez/users/hri611/python/nnUnet_raw/Dataset219_PETCT/labelsTr/PETCT_c58477f3b4_12072002.nii.gz,0.28308823529411764,0.0,20.017602733612062
424,,0,0,,43680000,0,0,0,/well/papiez/users/hri611/python/nnUNet_results/Dataset219_PETCT/nnUNetTrainer_1500epochs_1e2lr__nnUNetPlans__3d_fullres_maxnum_512_patch_192/crossval_results_folds_0_1_2/PETCT_c5a143a604_08122006.nii.gz,/well/papiez/users/hri611/python/nnUnet_raw/Dataset219_PETCT/labelsTr/PETCT_c5a143a604_08122006.nii.gz,,0.0,0.0
425,0.6143966125617502,4583,881,0.4434144850769074,52150183,4353,5234,8936,/well/papiez/users/hri611/python/nnUNet_results/Dataset219_PETCT/nnUNetTrainer_1500epochs_1e2lr__nnUNetPlans__3d_fullres_maxnum_512_patch_192/crossval_results_folds_0_1_2/PETCT_c73c2685c0_02012001.nii.gz,/well/papiez/users/hri611/python/nnUnet_raw/Dataset219_PETCT/labelsTr/PETCT_c73c2685c0_02012001.nii.gz,0.6143966125617502,0.435435733795166,52.37669826507568
426,0.9121528621164278,857,228,0.8384935992855016,45433282,5633,5861,6490,/well/papiez/users/hri611/python/nnUNet_results/Dataset219_PETCT/nnUNetTrainer_1500epochs_1e2lr__nnUNetPlans__3d_fullres_maxnum_512_patch_192/crossval_results_folds_0_1_2/PETCT_c799ccc2f6_08262002.nii.gz,/well/papiez/users/hri611/python/nnUnet_raw/Dataset219_PETCT/labelsTr/PETCT_c799ccc2f6_08262002.nii.gz,0.9121528621164278,0.14929225158691406,0.0
427,0.0,0,64,0.0,45439936,0,64,0,/well/papiez/users/hri611/python/nnUNet_results/Dataset219_PETCT/nnUNetTrainer_1500epochs_1e2lr__nnUNetPlans__3d_fullres_maxnum_512_patch_192/crossval_results_folds_0_1_2/PETCT_c7fd7e3e30_11132003.nii.gz,/well/papiez/users/hri611/python/nnUnet_raw/Dataset219_PETCT/labelsTr/PETCT_c7fd7e3e30_11132003.nii.gz,0.0,0.796225341796875,0.0
428,0.0,0,34,0.0,45439966,0,34,0,/well/papiez/users/hri611/python/nnUNet_results/Dataset219_PETCT/nnUNetTrainer_1500epochs_1e2lr__nnUNetPlans__3d_fullres_maxnum_512_patch_192/crossval_results_folds_0_1_2/PETCT_ca16242e89_09132002.nii.gz,/well/papiez/users/hri611/python/nnUnet_raw/Dataset219_PETCT/labelsTr/PETCT_ca16242e89_09132002.nii.gz,0.0,0.42299471282958984,0.0
429,,0,0,,45440000,0,0,0,/well/papiez/users/hri611/python/nnUNet_results/Dataset219_PETCT/nnUNetTrainer_1500epochs_1e2lr__nnUNetPlans__3d_fullres_maxnum_512_patch_192/crossval_results_folds_0_1_2/PETCT_ca16242e89_09182003.nii.gz,/well/papiez/users/hri611/python/nnUnet_raw/Dataset219_PETCT/labelsTr/PETCT_ca16242e89_09182003.nii.gz,,0.0,0.0
430,0.0,0,2659,0.0,45437341,0,2659,0,/well/papiez/users/hri611/python/nnUNet_results/Dataset219_PETCT/nnUNetTrainer_1500epochs_1e2lr__nnUNetPlans__3d_fullres_maxnum_512_patch_192/crossval_results_folds_0_1_2/PETCT_ca29501275_11042004.nii.gz,/well/papiez/users/hri611/python/nnUnet_raw/Dataset219_PETCT/labelsTr/PETCT_ca29501275_11042004.nii.gz,0.0,33.08067474746704,0.0
431,0.6889352818371608,0,149,0.5254777070063694,101439686,165,314,165,/well/papiez/users/hri611/python/nnUNet_results/Dataset219_PETCT/nnUNetTrainer_1500epochs_1e2lr__nnUNetPlans__3d_fullres_maxnum_512_patch_192/crossval_results_folds_0_1_2/PETCT_cab58c1fee_03192007.nii.gz,/well/papiez/users/hri611/python/nnUnet_raw/Dataset219_PETCT/labelsTr/PETCT_cab58c1fee_03192007.nii.gz,0.6889352818371608,0.9206355514526368,0.0
432,,0,0,,91040000,0,0,0,/well/papiez/users/hri611/python/nnUNet_results/Dataset219_PETCT/nnUNetTrainer_1500epochs_1e2lr__nnUNetPlans__3d_fullres_maxnum_512_patch_192/crossval_results_folds_0_1_2/PETCT_cb240e6f0f_04192007.nii.gz,/well/papiez/users/hri611/python/nnUnet_raw/Dataset219_PETCT/labelsTr/PETCT_cb240e6f0f_04192007.nii.gz,,0.0,0.0
433,0.8165743340669348,7170,2498,0.690008977811979,48128812,21520,24018,28690,/well/papiez/users/hri611/python/nnUNet_results/Dataset219_PETCT/nnUNetTrainer_1500epochs_1e2lr__nnUNetPlans__3d_fullres_maxnum_512_patch_192/crossval_results_folds_0_1_2/PETCT_cbbc9e2879_01162006.nii.gz,/well/papiez/users/hri611/python/nnUnet_raw/Dataset219_PETCT/labelsTr/PETCT_cbbc9e2879_01162006.nii.gz,0.8165743340669348,0.8584304466247559,1.3560712852478027
434,,0,0,,47200000,0,0,0,/well/papiez/users/hri611/python/nnUNet_results/Dataset219_PETCT/nnUNetTrainer_1500epochs_1e2lr__nnUNetPlans__3d_fullres_maxnum_512_patch_192/crossval_results_folds_0_1_2/PETCT_cbbc9e2879_03312006.nii.gz,/well/papiez/users/hri611/python/nnUnet_raw/Dataset219_PETCT/labelsTr/PETCT_cbbc9e2879_03312006.nii.gz,,0.0,0.0
435,,0,0,,46880000,0,0,0,/well/papiez/users/hri611/python/nnUNet_results/Dataset219_PETCT/nnUNetTrainer_1500epochs_1e2lr__nnUNetPlans__3d_fullres_maxnum_512_patch_192/crossval_results_folds_0_1_2/PETCT_cbbc9e2879_06282007.nii.gz,/well/papiez/users/hri611/python/nnUnet_raw/Dataset219_PETCT/labelsTr/PETCT_cbbc9e2879_06282007.nii.gz,,0.0,0.0
436,0.0,0,571,0.0,45439429,0,571,0,/well/papiez/users/hri611/python/nnUNet_results/Dataset219_PETCT/nnUNetTrainer_1500epochs_1e2lr__nnUNetPlans__3d_fullres_maxnum_512_patch_192/crossval_results_folds_0_1_2/PETCT_cc7cb73213_12182004.nii.gz,/well/papiez/users/hri611/python/nnUnet_raw/Dataset219_PETCT/labelsTr/PETCT_cc7cb73213_12182004.nii.gz,0.0,7.103822971343994,0.0
437,0.0,0,130,0.0,44159870,0,130,0,/well/papiez/users/hri611/python/nnUNet_results/Dataset219_PETCT/nnUNetTrainer_1500epochs_1e2lr__nnUNetPlans__3d_fullres_maxnum_512_patch_192/crossval_results_folds_0_1_2/PETCT_ccb9c375b2_10012005.nii.gz,/well/papiez/users/hri611/python/nnUnet_raw/Dataset219_PETCT/labelsTr/PETCT_ccb9c375b2_10012005.nii.gz,0.0,1.6173327255249024,0.0
438,0.0,0,3965,0.0,50876035,0,3965,0,/well/papiez/users/hri611/python/nnUNet_results/Dataset219_PETCT/nnUNetTrainer_1500epochs_1e2lr__nnUNetPlans__3d_fullres_maxnum_512_patch_192/crossval_results_folds_0_1_2/PETCT_ccd8f5ff71_10292006.nii.gz,/well/papiez/users/hri611/python/nnUnet_raw/Dataset219_PETCT/labelsTr/PETCT_ccd8f5ff71_10292006.nii.gz,0.0,49.32864812850952,0.0
439,,0,0,,52160000,0,0,0,/well/papiez/users/hri611/python/nnUNet_results/Dataset219_PETCT/nnUNetTrainer_1500epochs_1e2lr__nnUNetPlans__3d_fullres_maxnum_512_patch_192/crossval_results_folds_0_1_2/PETCT_cd50f3fec4_12012002.nii.gz,/well/papiez/users/hri611/python/nnUnet_raw/Dataset219_PETCT/labelsTr/PETCT_cd50f3fec4_12012002.nii.gz,,0.0,0.0
440,,0,0,,54400000,0,0,0,/well/papiez/users/hri611/python/nnUNet_results/Dataset219_PETCT/nnUNetTrainer_1500epochs_1e2lr__nnUNetPlans__3d_fullres_maxnum_512_patch_192/crossval_results_folds_0_1_2/PETCT_cd9bdca46b_10052006.nii.gz,/well/papiez/users/hri611/python/nnUnet_raw/Dataset219_PETCT/labelsTr/PETCT_cd9bdca46b_10052006.nii.gz,,0.0,0.0
441,0.820831342570473,2158,1592,0.6961102106969206,72147660,8590,10182,10748,/well/papiez/users/hri611/python/nnUNet_results/Dataset219_PETCT/nnUNetTrainer_1500epochs_1e2lr__nnUNetPlans__3d_fullres_maxnum_512_patch_192/crossval_results_folds_0_1_2/PETCT_cf20ad1656_02182005.nii.gz,/well/papiez/users/hri611/python/nnUnet_raw/Dataset219_PETCT/labelsTr/PETCT_cf20ad1656_02182005.nii.gz,0.820831342570473,0.07464612579345703,4.055772834777832
442,0.0,0,40,0.0,89759960,0,40,0,/well/papiez/users/hri611/python/nnUNet_results/Dataset219_PETCT/nnUNetTrainer_1500epochs_1e2lr__nnUNetPlans__3d_fullres_maxnum_512_patch_192/crossval_results_folds_0_1_2/PETCT_cf3725edf0_10072005.nii.gz,/well/papiez/users/hri611/python/nnUnet_raw/Dataset219_PETCT/labelsTr/PETCT_cf3725edf0_10072005.nii.gz,0.0,0.49764083862304687,0.0
443,0.0,0,24,0.0,45439976,0,24,0,/well/papiez/users/hri611/python/nnUNet_results/Dataset219_PETCT/nnUNetTrainer_1500epochs_1e2lr__nnUNetPlans__3d_fullres_maxnum_512_patch_192/crossval_results_folds_0_1_2/PETCT_d098458d29_08012003.nii.gz,/well/papiez/users/hri611/python/nnUnet_raw/Dataset219_PETCT/labelsTr/PETCT_d098458d29_08012003.nii.gz,0.0,0.2985845031738281,0.0
444,0.0,0,715,0.0,52159285,0,715,0,/well/papiez/users/hri611/python/nnUNet_results/Dataset219_PETCT/nnUNetTrainer_1500epochs_1e2lr__nnUNetPlans__3d_fullres_maxnum_512_patch_192/crossval_results_folds_0_1_2/PETCT_d103e57f0e_12122002.nii.gz,/well/papiez/users/hri611/python/nnUnet_raw/Dataset219_PETCT/labelsTr/PETCT_d103e57f0e_12122002.nii.gz,0.0,8.895329990386962,0.0
445,0.8230889403652427,656,19048,0.6993637570375796,52094459,45837,64885,46493,/well/papiez/users/hri611/python/nnUNet_results/Dataset219_PETCT/nnUNetTrainer_1500epochs_1e2lr__nnUNetPlans__3d_fullres_maxnum_512_patch_192/crossval_results_folds_0_1_2/PETCT_d31c9ebd93_07212003.nii.gz,/well/papiez/users/hri611/python/nnUnet_raw/Dataset219_PETCT/labelsTr/PETCT_d31c9ebd93_07212003.nii.gz,0.8230889403652427,0.0,0.32346654510498046
446,0.7765892420537898,1232,230,0.6347739195603298,45435997,2541,2771,3773,/well/papiez/users/hri611/python/nnUNet_results/Dataset219_PETCT/nnUNetTrainer_1500epochs_1e2lr__nnUNetPlans__3d_fullres_maxnum_512_patch_192/crossval_results_folds_0_1_2/PETCT_d393ab6c7b_09222002.nii.gz,/well/papiez/users/hri611/python/nnUnet_raw/Dataset219_PETCT/labelsTr/PETCT_d393ab6c7b_09222002.nii.gz,0.7765892420537898,1.4307174110412597,0.0
447,,0,0,,48480000,0,0,0,/well/papiez/users/hri611/python/nnUNet_results/Dataset219_PETCT/nnUNetTrainer_1500epochs_1e2lr__nnUNetPlans__3d_fullres_maxnum_512_patch_192/crossval_results_folds_0_1_2/PETCT_d3d3b7d4ff_08312006.nii.gz,/well/papiez/users/hri611/python/nnUnet_raw/Dataset219_PETCT/labelsTr/PETCT_d3d3b7d4ff_08312006.nii.gz,,0.0,0.0
448,0.875352166298637,2801,2110,0.778334461746784,52137845,17244,19354,20045,/well/papiez/users/hri611/python/nnUNet_results/Dataset219_PETCT/nnUNetTrainer_1500epochs_1e2lr__nnUNetPlans__3d_fullres_maxnum_512_patch_192/crossval_results_folds_0_1_2/PETCT_d3d61785e6_10192001.nii.gz,/well/papiez/users/hri611/python/nnUnet_raw/Dataset219_PETCT/labelsTr/PETCT_d3d61785e6_10192001.nii.gz,0.875352166298637,1.3560712852478027,19.880751502990723
449,,0,0,,45440000,0,0,0,/well/papiez/users/hri611/python/nnUNet_results/Dataset219_PETCT/nnUNetTrainer_1500epochs_1e2lr__nnUNetPlans__3d_fullres_maxnum_512_patch_192/crossval_results_folds_0_1_2/PETCT_d3f13dff4b_08242003.nii.gz,/well/papiez/users/hri611/python/nnUnet_raw/Dataset219_PETCT/labelsTr/PETCT_d3f13dff4b_08242003.nii.gz,,0.0,0.0
450,0.3364066782955395,6805,1184,0.20221689634511683,52149986,2025,3209,8830,/well/papiez/users/hri611/python/nnUNet_results/Dataset219_PETCT/nnUNetTrainer_1500epochs_1e2lr__nnUNetPlans__3d_fullres_maxnum_512_patch_192/crossval_results_folds_0_1_2/PETCT_d40a16781a_09132003.nii.gz,/well/papiez/users/hri611/python/nnUnet_raw/Dataset219_PETCT/labelsTr/PETCT_d40a16781a_09132003.nii.gz,0.3364066782955395,13.573153873443603,0.2985845031738281
451,0.7102477130229211,5374,264,0.5506853681861651,52147452,6910,7174,12284,/well/papiez/users/hri611/python/nnUNet_results/Dataset219_PETCT/nnUNetTrainer_1500epochs_1e2lr__nnUNetPlans__3d_fullres_maxnum_512_patch_192/crossval_results_folds_0_1_2/PETCT_d46f0109f8_09092000.nii.gz,/well/papiez/users/hri611/python/nnUnet_raw/Dataset219_PETCT/labelsTr/PETCT_d46f0109f8_09092000.nii.gz,0.7102477130229211,0.1368512306213379,52.165200908660886
452,0.0,0,96,0.0,45439904,0,96,0,/well/papiez/users/hri611/python/nnUNet_results/Dataset219_PETCT/nnUNetTrainer_1500epochs_1e2lr__nnUNetPlans__3d_fullres_maxnum_512_patch_192/crossval_results_folds_0_1_2/PETCT_d472033d3b_09282002.nii.gz,/well/papiez/users/hri611/python/nnUnet_raw/Dataset219_PETCT/labelsTr/PETCT_d472033d3b_09282002.nii.gz,0.0,1.1943380126953125,0.0
453,,0,0,,50080000,0,0,0,/well/papiez/users/hri611/python/nnUNet_results/Dataset219_PETCT/nnUNetTrainer_1500epochs_1e2lr__nnUNetPlans__3d_fullres_maxnum_512_patch_192/crossval_results_folds_0_1_2/PETCT_d4a08e4bde_03162006.nii.gz,/well/papiez/users/hri611/python/nnUnet_raw/Dataset219_PETCT/labelsTr/PETCT_d4a08e4bde_03162006.nii.gz,,0.0,0.0
454,0.4672153386994664,2583,3308,0.3048147274014633,91831526,2583,5891,5166,/well/papiez/users/hri611/python/nnUNet_results/Dataset219_PETCT/nnUNetTrainer_1500epochs_1e2lr__nnUNetPlans__3d_fullres_maxnum_512_patch_192/crossval_results_folds_0_1_2/PETCT_d4f3375362_05272005.nii.gz,/well/papiez/users/hri611/python/nnUnet_raw/Dataset219_PETCT/labelsTr/PETCT_d4f3375362_05272005.nii.gz,0.4672153386994664,38.36810865783691,8.12398669052124
455,0.9151418969380134,567,1251,0.8435590740900095,75188379,9803,11054,10370,/well/papiez/users/hri611/python/nnUNet_results/Dataset219_PETCT/nnUNetTrainer_1500epochs_1e2lr__nnUNetPlans__3d_fullres_maxnum_512_patch_192/crossval_results_folds_0_1_2/PETCT_d5103c8fbf_04142006.nii.gz,/well/papiez/users/hri611/python/nnUnet_raw/Dataset219_PETCT/labelsTr/PETCT_d5103c8fbf_04142006.nii.gz,0.9151418969380134,0.3110255241394043,0.0
456,0.0,0,78,0.0,85599922,0,78,0,/well/papiez/users/hri611/python/nnUNet_results/Dataset219_PETCT/nnUNetTrainer_1500epochs_1e2lr__nnUNetPlans__3d_fullres_maxnum_512_patch_192/crossval_results_folds_0_1_2/PETCT_d539f5a88b_06232003.nii.gz,/well/papiez/users/hri611/python/nnUnet_raw/Dataset219_PETCT/labelsTr/PETCT_d539f5a88b_06232003.nii.gz,0.0,0.9703996353149413,0.0
457,0.0,0,279,0.0,72159721,0,279,0,/well/papiez/users/hri611/python/nnUNet_results/Dataset219_PETCT/nnUNetTrainer_1500epochs_1e2lr__nnUNetPlans__3d_fullres_maxnum_512_patch_192/crossval_results_folds_0_1_2/PETCT_d5e2aa7feb_04172003.nii.gz,/well/papiez/users/hri611/python/nnUnet_raw/Dataset219_PETCT/labelsTr/PETCT_d5e2aa7feb_04172003.nii.gz,0.0,3.471044849395752,0.0
458,,0,0,,58880000,0,0,0,/well/papiez/users/hri611/python/nnUNet_results/Dataset219_PETCT/nnUNetTrainer_1500epochs_1e2lr__nnUNetPlans__3d_fullres_maxnum_512_patch_192/crossval_results_folds_0_1_2/PETCT_d626611daf_04032003.nii.gz,/well/papiez/users/hri611/python/nnUnet_raw/Dataset219_PETCT/labelsTr/PETCT_d626611daf_04032003.nii.gz,,0.0,0.0
459,,0,0,,55360000,0,0,0,/well/papiez/users/hri611/python/nnUNet_results/Dataset219_PETCT/nnUNetTrainer_1500epochs_1e2lr__nnUNetPlans__3d_fullres_maxnum_512_patch_192/crossval_results_folds_0_1_2/PETCT_d626611daf_06192005.nii.gz,/well/papiez/users/hri611/python/nnUnet_raw/Dataset219_PETCT/labelsTr/PETCT_d626611daf_06192005.nii.gz,,0.0,0.0
460,0.0,0,104,0.0,58879896,0,104,0,/well/papiez/users/hri611/python/nnUNet_results/Dataset219_PETCT/nnUNetTrainer_1500epochs_1e2lr__nnUNetPlans__3d_fullres_maxnum_512_patch_192/crossval_results_folds_0_1_2/PETCT_d626611daf_11122004.nii.gz,/well/papiez/users/hri611/python/nnUnet_raw/Dataset219_PETCT/labelsTr/PETCT_d626611daf_11122004.nii.gz,0.0,1.2938661804199219,0.0
461,0.8130081300813008,0,46,0.684931506849315,52479854,100,146,100,/well/papiez/users/hri611/python/nnUNet_results/Dataset219_PETCT/nnUNetTrainer_1500epochs_1e2lr__nnUNetPlans__3d_fullres_maxnum_512_patch_192/crossval_results_folds_0_1_2/PETCT_d65cf203be_04282007.nii.gz,/well/papiez/users/hri611/python/nnUnet_raw/Dataset219_PETCT/labelsTr/PETCT_d65cf203be_04282007.nii.gz,0.8130081300813008,0.0,0.0
462,,0,0,,58880000,0,0,0,/well/papiez/users/hri611/python/nnUNet_results/Dataset219_PETCT/nnUNetTrainer_1500epochs_1e2lr__nnUNetPlans__3d_fullres_maxnum_512_patch_192/crossval_results_folds_0_1_2/PETCT_d6a48a629d_03062003.nii.gz,/well/papiez/users/hri611/python/nnUnet_raw/Dataset219_PETCT/labelsTr/PETCT_d6a48a629d_03062003.nii.gz,,0.0,0.0
463,,0,0,,52160000,0,0,0,/well/papiez/users/hri611/python/nnUNet_results/Dataset219_PETCT/nnUNetTrainer_1500epochs_1e2lr__nnUNetPlans__3d_fullres_maxnum_512_patch_192/crossval_results_folds_0_1_2/PETCT_d6a48a629d_07272002.nii.gz,/well/papiez/users/hri611/python/nnUnet_raw/Dataset219_PETCT/labelsTr/PETCT_d6a48a629d_07272002.nii.gz,,0.0,0.0
464,0.0,0,830,0.0,99039170,0,830,0,/well/papiez/users/hri611/python/nnUNet_results/Dataset219_PETCT/nnUNetTrainer_1500epochs_1e2lr__nnUNetPlans__3d_fullres_maxnum_512_patch_192/crossval_results_folds_0_1_2/PETCT_d6a491e16d_05302003.nii.gz,/well/papiez/users/hri611/python/nnUnet_raw/Dataset219_PETCT/labelsTr/PETCT_d6a491e16d_05302003.nii.gz,0.0,10.326047401428223,0.0
465,,0,0,,45440000,0,0,0,/well/papiez/users/hri611/python/nnUNet_results/Dataset219_PETCT/nnUNetTrainer_1500epochs_1e2lr__nnUNetPlans__3d_fullres_maxnum_512_patch_192/crossval_results_folds_0_1_2/PETCT_d6b2218bf3_12182004.nii.gz,/well/papiez/users/hri611/python/nnUnet_raw/Dataset219_PETCT/labelsTr/PETCT_d6b2218bf3_12182004.nii.gz,,0.0,0.0
466,0.6352175681171208,678,219,0.465435041716329,47838322,781,1000,1459,/well/papiez/users/hri611/python/nnUNet_results/Dataset219_PETCT/nnUNetTrainer_1500epochs_1e2lr__nnUNetPlans__3d_fullres_maxnum_512_patch_192/crossval_results_folds_0_1_2/PETCT_d8a92bafe3_03182007.nii.gz,/well/papiez/users/hri611/python/nnUnet_raw/Dataset219_PETCT/labelsTr/PETCT_d8a92bafe3_03182007.nii.gz,0.6352175681171208,0.5225228805541993,7.613904830932617
467,0.7691376701966717,30,733,0.6248770894788593,92317966,1271,2004,1301,/well/papiez/users/hri611/python/nnUNet_results/Dataset219_PETCT/nnUNetTrainer_1500epochs_1e2lr__nnUNetPlans__3d_fullres_maxnum_512_patch_192/crossval_results_folds_0_1_2/PETCT_d8d9e52cd5_03132005.nii.gz,/well/papiez/users/hri611/python/nnUnet_raw/Dataset219_PETCT/labelsTr/PETCT_d8d9e52cd5_03132005.nii.gz,0.7691376701966717,1.3187482223510743,0.012441020965576172
468,0.8155750075460307,292,319,0.6885830784913354,92318038,1351,1670,1643,/well/papiez/users/hri611/python/nnUNet_results/Dataset219_PETCT/nnUNetTrainer_1500epochs_1e2lr__nnUNetPlans__3d_fullres_maxnum_512_patch_192/crossval_results_folds_0_1_2/PETCT_d8d9e52cd5_07042004.nii.gz,/well/papiez/users/hri611/python/nnUnet_raw/Dataset219_PETCT/labelsTr/PETCT_d8d9e52cd5_07042004.nii.gz,0.8155750075460307,1.7915070190429687,1.3685123062133788
469,0.32492336713039377,7982,607,0.19397522522522523,94069344,2067,2674,10049,/well/papiez/users/hri611/python/nnUNet_results/Dataset219_PETCT/nnUNetTrainer_1500epochs_1e2lr__nnUNetPlans__3d_fullres_maxnum_512_patch_192/crossval_results_folds_0_1_2/PETCT_d8d9e52cd5_10072005.nii.gz,/well/papiez/users/hri611/python/nnUnet_raw/Dataset219_PETCT/labelsTr/PETCT_d8d9e52cd5_10072005.nii.gz,0.32492336713039377,1.4058353691101073,98.60753217315674
470,0.0,0,81,0.0,52159919,0,81,0,/well/papiez/users/hri611/python/nnUNet_results/Dataset219_PETCT/nnUNetTrainer_1500epochs_1e2lr__nnUNetPlans__3d_fullres_maxnum_512_patch_192/crossval_results_folds_0_1_2/PETCT_d8e3aa97a0_05192005.nii.gz,/well/papiez/users/hri611/python/nnUnet_raw/Dataset219_PETCT/labelsTr/PETCT_d8e3aa97a0_05192005.nii.gz,0.0,1.0077226982116698,0.0
471,0.8378063010501751,225,609,0.7208835341365462,45437012,2154,2763,2379,/well/papiez/users/hri611/python/nnUNet_results/Dataset219_PETCT/nnUNetTrainer_1500epochs_1e2lr__nnUNetPlans__3d_fullres_maxnum_512_patch_192/crossval_results_folds_0_1_2/PETCT_da6161d7eb_06202003.nii.gz,/well/papiez/users/hri611/python/nnUnet_raw/Dataset219_PETCT/labelsTr/PETCT_da6161d7eb_06202003.nii.gz,0.8378063010501751,0.19905633544921875,1.4680404739379882
472,0.0,0,1107,0.0,52158893,0,1107,0,/well/papiez/users/hri611/python/nnUNet_results/Dataset219_PETCT/nnUNetTrainer_1500epochs_1e2lr__nnUNetPlans__3d_fullres_maxnum_512_patch_192/crossval_results_folds_0_1_2/PETCT_dae86b88e2_06212003.nii.gz,/well/papiez/users/hri611/python/nnUnet_raw/Dataset219_PETCT/labelsTr/PETCT_dae86b88e2_06212003.nii.gz,0.0,13.772210208892822,0.0
473,0.0,0,196,0.0,51039804,0,196,0,/well/papiez/users/hri611/python/nnUNet_results/Dataset219_PETCT/nnUNetTrainer_1500epochs_1e2lr__nnUNetPlans__3d_fullres_maxnum_512_patch_192/crossval_results_folds_0_1_2/PETCT_db3bac356a_08212005.nii.gz,/well/papiez/users/hri611/python/nnUnet_raw/Dataset219_PETCT/labelsTr/PETCT_db3bac356a_08212005.nii.gz,0.0,2.4384401092529298,0.0
474,0.9205880284166843,707,422,0.852860680307572,52152327,6544,6966,7251,/well/papiez/users/hri611/python/nnUNet_results/Dataset219_PETCT/nnUNetTrainer_1500epochs_1e2lr__nnUNetPlans__3d_fullres_maxnum_512_patch_192/crossval_results_folds_0_1_2/PETCT_db3daf78d2_10302000.nii.gz,/well/papiez/users/hri611/python/nnUnet_raw/Dataset219_PETCT/labelsTr/PETCT_db3daf78d2_10302000.nii.gz,0.9205880284166843,0.5971690063476562,0.0
475,0.0,0,8,0.0,47999992,0,8,0,/well/papiez/users/hri611/python/nnUNet_results/Dataset219_PETCT/nnUNetTrainer_1500epochs_1e2lr__nnUNetPlans__3d_fullres_maxnum_512_patch_192/crossval_results_folds_0_1_2/PETCT_dc15c1d9bb_06032005.nii.gz,/well/papiez/users/hri611/python/nnUnet_raw/Dataset219_PETCT/labelsTr/PETCT_dc15c1d9bb_06032005.nii.gz,0.0,0.09952816772460937,0.0
476,0.8569349188335719,912,10686,0.7496816523859884,45393667,34735,45421,35647,/well/papiez/users/hri611/python/nnUNet_results/Dataset219_PETCT/nnUNetTrainer_1500epochs_1e2lr__nnUNetPlans__3d_fullres_maxnum_512_patch_192/crossval_results_folds_0_1_2/PETCT_dc6174cb5d_03292003.nii.gz,/well/papiez/users/hri611/python/nnUnet_raw/Dataset219_PETCT/labelsTr/PETCT_dc6174cb5d_03292003.nii.gz,0.8569349188335719,2.7867886962890625,10.164314128875732
477,0.7563996696944674,289,6,0.6082337317397079,45439247,458,464,747,/well/papiez/users/hri611/python/nnUNet_results/Dataset219_PETCT/nnUNetTrainer_1500epochs_1e2lr__nnUNetPlans__3d_fullres_maxnum_512_patch_192/crossval_results_folds_0_1_2/PETCT_dd68a71e0a_11202004.nii.gz,/well/papiez/users/hri611/python/nnUnet_raw/Dataset219_PETCT/labelsTr/PETCT_dd68a71e0a_11202004.nii.gz,0.7563996696944674,0.0,0.4105536918640137
478,0.0,0,170,0.0,47999830,0,170,0,/well/papiez/users/hri611/python/nnUNet_results/Dataset219_PETCT/nnUNetTrainer_1500epochs_1e2lr__nnUNetPlans__3d_fullres_maxnum_512_patch_192/crossval_results_folds_0_1_2/PETCT_dd887591a9_05062006.nii.gz,/well/papiez/users/hri611/python/nnUnet_raw/Dataset219_PETCT/labelsTr/PETCT_dd887591a9_05062006.nii.gz,0.0,2.1149735641479492,0.0
479,0.8600439713029391,3369,1469,0.7544536365020555,45420297,14865,16334,18234,/well/papiez/users/hri611/python/nnUNet_results/Dataset219_PETCT/nnUNetTrainer_1500epochs_1e2lr__nnUNetPlans__3d_fullres_maxnum_512_patch_192/crossval_results_folds_0_1_2/PETCT_dd975744e7_09232001.nii.gz,/well/papiez/users/hri611/python/nnUnet_raw/Dataset219_PETCT/labelsTr/PETCT_dd975744e7_09232001.nii.gz,0.8600439713029391,0.0,6.892325614929199
480,0.7632501668127641,2762,69620,0.6171419201616444,51970943,116675,186295,119437,/well/papiez/users/hri611/python/nnUNet_results/Dataset219_PETCT/nnUNetTrainer_1500epochs_1e2lr__nnUNetPlans__3d_fullres_maxnum_512_patch_192/crossval_results_folds_0_1_2/PETCT_ddbb3c69f0_08112003.nii.gz,/well/papiez/users/hri611/python/nnUnet_raw/Dataset219_PETCT/labelsTr/PETCT_ddbb3c69f0_08112003.nii.gz,0.7632501668127641,94.80057975769043,1.2814251594543458
481,0.0,1769,0,0.0,45438231,0,0,1769,/well/papiez/users/hri611/python/nnUNet_results/Dataset219_PETCT/nnUNetTrainer_1500epochs_1e2lr__nnUNetPlans__3d_fullres_maxnum_512_patch_192/crossval_results_folds_0_1_2/PETCT_de118d7ab9_06022001.nii.gz,/well/papiez/users/hri611/python/nnUnet_raw/Dataset219_PETCT/labelsTr/PETCT_de118d7ab9_06022001.nii.gz,0.0,0.0,22.008166088104247
482,,0,0,,52160000,0,0,0,/well/papiez/users/hri611/python/nnUNet_results/Dataset219_PETCT/nnUNetTrainer_1500epochs_1e2lr__nnUNetPlans__3d_fullres_maxnum_512_patch_192/crossval_results_folds_0_1_2/PETCT_dec9ff6a91_03032003.nii.gz,/well/papiez/users/hri611/python/nnUnet_raw/Dataset219_PETCT/labelsTr/PETCT_dec9ff6a91_03032003.nii.gz,,0.0,0.0
483,,0,0,,52160000,0,0,0,/well/papiez/users/hri611/python/nnUNet_results/Dataset219_PETCT/nnUNetTrainer_1500epochs_1e2lr__nnUNetPlans__3d_fullres_maxnum_512_patch_192/crossval_results_folds_0_1_2/PETCT_df2e16771a_11142003.nii.gz,/well/papiez/users/hri611/python/nnUnet_raw/Dataset219_PETCT/labelsTr/PETCT_df2e16771a_11142003.nii.gz,,0.0,0.0
484,0.8050896375180906,20617,2682,0.6737657173261643,38648582,48119,50801,68736,/well/papiez/users/hri611/python/nnUNet_results/Dataset219_PETCT/nnUNetTrainer_1500epochs_1e2lr__nnUNetPlans__3d_fullres_maxnum_512_patch_192/crossval_results_folds_0_1_2/PETCT_e03b96666f_05172001.nii.gz,/well/papiez/users/hri611/python/nnUnet_raw/Dataset219_PETCT/labelsTr/PETCT_e03b96666f_05172001.nii.gz,0.8050896375180906,0.012441020965576172,32.471064720153805
485,0.7859220477021525,709,27,0.6473406804024916,52157913,1351,1378,2060,/well/papiez/users/hri611/python/nnUNet_results/Dataset219_PETCT/nnUNetTrainer_1500epochs_1e2lr__nnUNetPlans__3d_fullres_maxnum_512_patch_192/crossval_results_folds_0_1_2/PETCT_e04b7fa860_06012002.nii.gz,/well/papiez/users/hri611/python/nnUnet_raw/Dataset219_PETCT/labelsTr/PETCT_e04b7fa860_06012002.nii.gz,0.7859220477021525,0.0,4.988849407196045
486,,0,0,,47360000,0,0,0,/well/papiez/users/hri611/python/nnUNet_results/Dataset219_PETCT/nnUNetTrainer_1500epochs_1e2lr__nnUNetPlans__3d_fullres_maxnum_512_patch_192/crossval_results_folds_0_1_2/PETCT_e09a20d8fc_03162006.nii.gz,/well/papiez/users/hri611/python/nnUnet_raw/Dataset219_PETCT/labelsTr/PETCT_e09a20d8fc_03162006.nii.gz,,0.0,0.0
487,0.0,0,4,0.0,45439996,0,4,0,/well/papiez/users/hri611/python/nnUNet_results/Dataset219_PETCT/nnUNetTrainer_1500epochs_1e2lr__nnUNetPlans__3d_fullres_maxnum_512_patch_192/crossval_results_folds_0_1_2/PETCT_e0fdc6212a_05292003.nii.gz,/well/papiez/users/hri611/python/nnUnet_raw/Dataset219_PETCT/labelsTr/PETCT_e0fdc6212a_05292003.nii.gz,0.0,0.04976408386230469,0.0
488,0.8802395209580839,0,280,0.786096256684492,51678691,1029,1309,1029,/well/papiez/users/hri611/python/nnUNet_results/Dataset219_PETCT/nnUNetTrainer_1500epochs_1e2lr__nnUNetPlans__3d_fullres_maxnum_512_patch_192/crossval_results_folds_0_1_2/PETCT_e1a4145b63_03052006.nii.gz,/well/papiez/users/hri611/python/nnUnet_raw/Dataset219_PETCT/labelsTr/PETCT_e1a4145b63_03052006.nii.gz,0.8802395209580839,1.8661531448364257,0.0
489,0.0,0,895,0.0,45439105,0,895,0,/well/papiez/users/hri611/python/nnUNet_results/Dataset219_PETCT/nnUNetTrainer_1500epochs_1e2lr__nnUNetPlans__3d_fullres_maxnum_512_patch_192/crossval_results_folds_0_1_2/PETCT_e1a5b05186_02272005.nii.gz,/well/papiez/users/hri611/python/nnUnet_raw/Dataset219_PETCT/labelsTr/PETCT_e1a5b05186_02272005.nii.gz,0.0,11.134713764190673,0.0
490,,0,0,,38720000,0,0,0,/well/papiez/users/hri611/python/nnUNet_results/Dataset219_PETCT/nnUNetTrainer_1500epochs_1e2lr__nnUNetPlans__3d_fullres_maxnum_512_patch_192/crossval_results_folds_0_1_2/PETCT_e207c7a1a4_12232005.nii.gz,/well/papiez/users/hri611/python/nnUnet_raw/Dataset219_PETCT/labelsTr/PETCT_e207c7a1a4_12232005.nii.gz,,0.0,0.0
491,0.7743737142637418,925,46017,0.6318187878930485,52032503,80555,126572,81480,/well/papiez/users/hri611/python/nnUNet_results/Dataset219_PETCT/nnUNetTrainer_1500epochs_1e2lr__nnUNetPlans__3d_fullres_maxnum_512_patch_192/crossval_results_folds_0_1_2/PETCT_e252be4334_07092004.nii.gz,/well/papiez/users/hri611/python/nnUnet_raw/Dataset219_PETCT/labelsTr/PETCT_e252be4334_07092004.nii.gz,0.7743737142637418,13.548271831512452,5.374521057128906
492,0.0,0,218,0.0,49919782,0,218,0,/well/papiez/users/hri611/python/nnUNet_results/Dataset219_PETCT/nnUNetTrainer_1500epochs_1e2lr__nnUNetPlans__3d_fullres_maxnum_512_patch_192/crossval_results_folds_0_1_2/PETCT_e344879c2e_11172006.nii.gz,/well/papiez/users/hri611/python/nnUnet_raw/Dataset219_PETCT/labelsTr/PETCT_e344879c2e_11172006.nii.gz,0.0,2.7121425704956055,0.0
493,0.7903405072244114,1846,229,0.6533578349482125,52154014,3911,4140,5757,/well/papiez/users/hri611/python/nnUNet_results/Dataset219_PETCT/nnUNetTrainer_1500epochs_1e2lr__nnUNetPlans__3d_fullres_maxnum_512_patch_192/crossval_results_folds_0_1_2/PETCT_e4712dc58c_02121999.nii.gz,/well/papiez/users/hri611/python/nnUnet_raw/Dataset219_PETCT/labelsTr/PETCT_e4712dc58c_02121999.nii.gz,0.7903405072244114,0.0,3.421280765533447
494,0.0,0,22,0.0,52159978,0,22,0,/well/papiez/users/hri611/python/nnUNet_results/Dataset219_PETCT/nnUNetTrainer_1500epochs_1e2lr__nnUNetPlans__3d_fullres_maxnum_512_patch_192/crossval_results_folds_0_1_2/PETCT_e4e5baf901_02142005.nii.gz,/well/papiez/users/hri611/python/nnUnet_raw/Dataset219_PETCT/labelsTr/PETCT_e4e5baf901_02142005.nii.gz,0.0,0.2737024612426758,0.0
495,0.0,0,532,0.0,47359468,0,532,0,/well/papiez/users/hri611/python/nnUNet_results/Dataset219_PETCT/nnUNetTrainer_1500epochs_1e2lr__nnUNetPlans__3d_fullres_maxnum_512_patch_192/crossval_results_folds_0_1_2/PETCT_e52eca67d7_03132006.nii.gz,/well/papiez/users/hri611/python/nnUnet_raw/Dataset219_PETCT/labelsTr/PETCT_e52eca67d7_03132006.nii.gz,0.0,6.618623153686523,0.0
496,,0,0,,45440000,0,0,0,/well/papiez/users/hri611/python/nnUNet_results/Dataset219_PETCT/nnUNetTrainer_1500epochs_1e2lr__nnUNetPlans__3d_fullres_maxnum_512_patch_192/crossval_results_folds_0_1_2/PETCT_e5b1d6b4bd_10232004.nii.gz,/well/papiez/users/hri611/python/nnUnet_raw/Dataset219_PETCT/labelsTr/PETCT_e5b1d6b4bd_10232004.nii.gz,,0.0,0.0
497,,0,0,,92320000,0,0,0,/well/papiez/users/hri611/python/nnUNet_results/Dataset219_PETCT/nnUNetTrainer_1500epochs_1e2lr__nnUNetPlans__3d_fullres_maxnum_512_patch_192/crossval_results_folds_0_1_2/PETCT_e5c7be07a8_04082005.nii.gz,/well/papiez/users/hri611/python/nnUnet_raw/Dataset219_PETCT/labelsTr/PETCT_e5c7be07a8_04082005.nii.gz,,0.0,0.0
498,,0,0,,45440000,0,0,0,/well/papiez/users/hri611/python/nnUNet_results/Dataset219_PETCT/nnUNetTrainer_1500epochs_1e2lr__nnUNetPlans__3d_fullres_maxnum_512_patch_192/crossval_results_folds_0_1_2/PETCT_e5e1918765_07242003.nii.gz,/well/papiez/users/hri611/python/nnUnet_raw/Dataset219_PETCT/labelsTr/PETCT_e5e1918765_07242003.nii.gz,,0.0,0.0
499,0.9430316212146562,1008,354,0.8922041946972695,52147365,11273,11627,12281,/well/papiez/users/hri611/python/nnUNet_results/Dataset219_PETCT/nnUNetTrainer_1500epochs_1e2lr__nnUNetPlans__3d_fullres_maxnum_512_patch_192/crossval_results_folds_0_1_2/PETCT_e61c9da258_12132002.nii.gz,/well/papiez/users/hri611/python/nnUnet_raw/Dataset219_PETCT/labelsTr/PETCT_e61c9da258_12132002.nii.gz,0.9430316212146562,0.9330765724182128,0.024882041931152343
500,0.0,0,195,0.0,51839805,0,195,0,/well/papiez/users/hri611/python/nnUNet_results/Dataset219_PETCT/nnUNetTrainer_1500epochs_1e2lr__nnUNetPlans__3d_fullres_maxnum_512_patch_192/crossval_results_folds_0_1_2/PETCT_e664932bbc_06092007.nii.gz,/well/papiez/users/hri611/python/nnUnet_raw/Dataset219_PETCT/labelsTr/PETCT_e664932bbc_06092007.nii.gz,0.0,2.4259990882873534,0.0
501,,0,0,,51200000,0,0,0,/well/papiez/users/hri611/python/nnUNet_results/Dataset219_PETCT/nnUNetTrainer_1500epochs_1e2lr__nnUNetPlans__3d_fullres_maxnum_512_patch_192/crossval_results_folds_0_1_2/PETCT_e68c4577d8_05252007.nii.gz,/well/papiez/users/hri611/python/nnUnet_raw/Dataset219_PETCT/labelsTr/PETCT_e68c4577d8_05252007.nii.gz,,0.0,0.0
502,0.0,0,783,0.0,48159217,0,783,0,/well/papiez/users/hri611/python/nnUNet_results/Dataset219_PETCT/nnUNetTrainer_1500epochs_1e2lr__nnUNetPlans__3d_fullres_maxnum_512_patch_192/crossval_results_folds_0_1_2/PETCT_e6a91fef70_03022006.nii.gz,/well/papiez/users/hri611/python/nnUnet_raw/Dataset219_PETCT/labelsTr/PETCT_e6a91fef70_03022006.nii.gz,0.0,9.741319416046142,0.0
503,0.6764705882352942,88,0,0.5111111111111111,89759820,92,92,180,/well/papiez/users/hri611/python/nnUNet_results/Dataset219_PETCT/nnUNetTrainer_1500epochs_1e2lr__nnUNetPlans__3d_fullres_maxnum_512_patch_192/crossval_results_folds_0_1_2/PETCT_e79291780d_05142007.nii.gz,/well/papiez/users/hri611/python/nnUnet_raw/Dataset219_PETCT/labelsTr/PETCT_e79291780d_05142007.nii.gz,0.6764705882352942,0.0,0.0
504,0.0,0,297,0.0,92319703,0,297,0,/well/papiez/users/hri611/python/nnUNet_results/Dataset219_PETCT/nnUNetTrainer_1500epochs_1e2lr__nnUNetPlans__3d_fullres_maxnum_512_patch_192/crossval_results_folds_0_1_2/PETCT_e90a287d09_08222002.nii.gz,/well/papiez/users/hri611/python/nnUnet_raw/Dataset219_PETCT/labelsTr/PETCT_e90a287d09_08222002.nii.gz,0.0,3.694983226776123,0.0
505,0.808422362825433,1431,416,0.6784470752089137,45434256,3897,4313,5328,/well/papiez/users/hri611/python/nnUNet_results/Dataset219_PETCT/nnUNetTrainer_1500epochs_1e2lr__nnUNetPlans__3d_fullres_maxnum_512_patch_192/crossval_results_folds_0_1_2/PETCT_e9e1a391b5_10112001.nii.gz,/well/papiez/users/hri611/python/nnUnet_raw/Dataset219_PETCT/labelsTr/PETCT_e9e1a391b5_10112001.nii.gz,0.808422362825433,0.0,0.0
506,0.8896273196666837,7600,1036,0.8011970534069982,52116560,34804,35840,42404,/well/papiez/users/hri611/python/nnUNet_results/Dataset219_PETCT/nnUNetTrainer_1500epochs_1e2lr__nnUNetPlans__3d_fullres_maxnum_512_patch_192/crossval_results_folds_0_1_2/PETCT_ea0fd89f0f_10252003.nii.gz,/well/papiez/users/hri611/python/nnUnet_raw/Dataset219_PETCT/labelsTr/PETCT_ea0fd89f0f_10252003.nii.gz,0.8896273196666837,0.09952816772460937,3.2968705558776854
507,0.8926903748943803,12150,2328,0.8061795496532705,47125302,60220,62548,72370,/well/papiez/users/hri611/python/nnUNet_results/Dataset219_PETCT/nnUNetTrainer_1500epochs_1e2lr__nnUNetPlans__3d_fullres_maxnum_512_patch_192/crossval_results_folds_0_1_2/PETCT_ea42c88cc7_02262006.nii.gz,/well/papiez/users/hri611/python/nnUnet_raw/Dataset219_PETCT/labelsTr/PETCT_ea42c88cc7_02262006.nii.gz,0.8926903748943803,7.1909101181030275,2.5752913398742674
508,0.6944198405668733,5,2065,0.5318860244233379,51515578,2352,4417,2357,/well/papiez/users/hri611/python/nnUNet_results/Dataset219_PETCT/nnUNetTrainer_1500epochs_1e2lr__nnUNetPlans__3d_fullres_maxnum_512_patch_192/crossval_results_folds_0_1_2/PETCT_ea6c621616_08082005.nii.gz,/well/papiez/users/hri611/python/nnUnet_raw/Dataset219_PETCT/labelsTr/PETCT_ea6c621616_08082005.nii.gz,0.6944198405668733,3.8069524154663084,0.0
509,0.9208914375081454,766,448,0.8533816425120773,45431720,7066,7514,7832,/well/papiez/users/hri611/python/nnUNet_results/Dataset219_PETCT/nnUNetTrainer_1500epochs_1e2lr__nnUNetPlans__3d_fullres_maxnum_512_patch_192/crossval_results_folds_0_1_2/PETCT_ec6b934720_10252002.nii.gz,/well/papiez/users/hri611/python/nnUnet_raw/Dataset219_PETCT/labelsTr/PETCT_ec6b934720_10252002.nii.gz,0.9208914375081454,0.0,0.0
510,,0,0,,56480000,0,0,0,/well/papiez/users/hri611/python/nnUNet_results/Dataset219_PETCT/nnUNetTrainer_1500epochs_1e2lr__nnUNetPlans__3d_fullres_maxnum_512_patch_192/crossval_results_folds_0_1_2/PETCT_eda00de6b0_06242006.nii.gz,/well/papiez/users/hri611/python/nnUnet_raw/Dataset219_PETCT/labelsTr/PETCT_eda00de6b0_06242006.nii.gz,,0.0,0.0
511,0.6587936755807144,3386,110,0.4911948770193567,52153129,3375,3485,6761,/well/papiez/users/hri611/python/nnUNet_results/Dataset219_PETCT/nnUNetTrainer_1500epochs_1e2lr__nnUNetPlans__3d_fullres_maxnum_512_patch_192/crossval_results_folds_0_1_2/PETCT_ee97822c60_03032003.nii.gz,/well/papiez/users/hri611/python/nnUnet_raw/Dataset219_PETCT/labelsTr/PETCT_ee97822c60_03032003.nii.gz,0.6587936755807144,0.8833124885559082,5.586018413543701
512,,0,0,,48160000,0,0,0,/well/papiez/users/hri611/python/nnUNet_results/Dataset219_PETCT/nnUNetTrainer_1500epochs_1e2lr__nnUNetPlans__3d_fullres_maxnum_512_patch_192/crossval_results_folds_0_1_2/PETCT_eee2ede9ad_11242006.nii.gz,/well/papiez/users/hri611/python/nnUnet_raw/Dataset219_PETCT/labelsTr/PETCT_eee2ede9ad_11242006.nii.gz,,0.0,0.0
513,0.8952915362756735,1984,927,0.8104324042719458,45424644,12445,13372,14429,/well/papiez/users/hri611/python/nnUNet_results/Dataset219_PETCT/nnUNetTrainer_1500epochs_1e2lr__nnUNetPlans__3d_fullres_maxnum_512_patch_192/crossval_results_folds_0_1_2/PETCT_eeeda112bb_06072003.nii.gz,/well/papiez/users/hri611/python/nnUnet_raw/Dataset219_PETCT/labelsTr/PETCT_eeeda112bb_06072003.nii.gz,0.8952915362756735,0.0,0.0
514,0.0,0,4251,0.0,92475749,0,4251,0,/well/papiez/users/hri611/python/nnUNet_results/Dataset219_PETCT/nnUNetTrainer_1500epochs_1e2lr__nnUNetPlans__3d_fullres_maxnum_512_patch_192/crossval_results_folds_0_1_2/PETCT_f068e22258_05142007.nii.gz,/well/papiez/users/hri611/python/nnUnet_raw/Dataset219_PETCT/labelsTr/PETCT_f068e22258_05142007.nii.gz,0.0,52.886780124664305,0.0
515,0.7226890756302521,2035,3146,0.5657894736842105,52148068,6751,9897,8786,/well/papiez/users/hri611/python/nnUNet_results/Dataset219_PETCT/nnUNetTrainer_1500epochs_1e2lr__nnUNetPlans__3d_fullres_maxnum_512_patch_192/crossval_results_folds_0_1_2/PETCT_f11f3d3692_10242003.nii.gz,/well/papiez/users/hri611/python/nnUnet_raw/Dataset219_PETCT/labelsTr/PETCT_f11f3d3692_10242003.nii.gz,0.7226890756302521,1.6173327255249024,9.007299179077147
516,0.8890024595138467,2532,943,0.8001840032200563,45422609,13916,14859,16448,/well/papiez/users/hri611/python/nnUNet_results/Dataset219_PETCT/nnUNetTrainer_1500epochs_1e2lr__nnUNetPlans__3d_fullres_maxnum_512_patch_192/crossval_results_folds_0_1_2/PETCT_f1501b1f45_03202005.nii.gz,/well/papiez/users/hri611/python/nnUnet_raw/Dataset219_PETCT/labelsTr/PETCT_f1501b1f45_03202005.nii.gz,0.8890024595138467,1.7541839561462402,1.443158432006836
517,0.0,0,862,0.0,72159138,0,862,0,/well/papiez/users/hri611/python/nnUNet_results/Dataset219_PETCT/nnUNetTrainer_1500epochs_1e2lr__nnUNetPlans__3d_fullres_maxnum_512_patch_192/crossval_results_folds_0_1_2/PETCT_f1594a7d8a_04252003.nii.gz,/well/papiez/users/hri611/python/nnUnet_raw/Dataset219_PETCT/labelsTr/PETCT_f1594a7d8a_04252003.nii.gz,0.0,10.72416007232666,0.0
518,,0,0,,47520000,0,0,0,/well/papiez/users/hri611/python/nnUNet_results/Dataset219_PETCT/nnUNetTrainer_1500epochs_1e2lr__nnUNetPlans__3d_fullres_maxnum_512_patch_192/crossval_results_folds_0_1_2/PETCT_f15b868db6_02032006.nii.gz,/well/papiez/users/hri611/python/nnUnet_raw/Dataset219_PETCT/labelsTr/PETCT_f15b868db6_02032006.nii.gz,,0.0,0.0
519,0.7430093209054593,791,174,0.5911016949152542,99037640,1395,1569,2186,/well/papiez/users/hri611/python/nnUNet_results/Dataset219_PETCT/nnUNetTrainer_1500epochs_1e2lr__nnUNetPlans__3d_fullres_maxnum_512_patch_192/crossval_results_folds_0_1_2/PETCT_f1ca0f7c4c_12222001.nii.gz,/well/papiez/users/hri611/python/nnUnet_raw/Dataset219_PETCT/labelsTr/PETCT_f1ca0f7c4c_12222001.nii.gz,0.7430093209054593,0.5474049224853516,1.530245578765869
520,0.909937254659537,3714,10855,0.8347567684054125,45351833,73598,84453,77312,/well/papiez/users/hri611/python/nnUNet_results/Dataset219_PETCT/nnUNetTrainer_1500epochs_1e2lr__nnUNetPlans__3d_fullres_maxnum_512_patch_192/crossval_results_folds_0_1_2/PETCT_f21755a99b_05052005.nii.gz,/well/papiez/users/hri611/python/nnUnet_raw/Dataset219_PETCT/labelsTr/PETCT_f21755a99b_05052005.nii.gz,0.909937254659537,0.3359075660705566,0.435435733795166
521,0.7605749486652977,1618,131,0.6136514247846255,52155473,2778,2909,4396,/well/papiez/users/hri611/python/nnUNet_results/Dataset219_PETCT/nnUNetTrainer_1500epochs_1e2lr__nnUNetPlans__3d_fullres_maxnum_512_patch_192/crossval_results_folds_0_1_2/PETCT_f2f28337ba_05032001.nii.gz,/well/papiez/users/hri611/python/nnUnet_raw/Dataset219_PETCT/labelsTr/PETCT_f2f28337ba_05032001.nii.gz,0.7605749486652977,0.0,0.7837843208312988
522,0.0,0,328,0.0,99039672,0,328,0,/well/papiez/users/hri611/python/nnUNet_results/Dataset219_PETCT/nnUNetTrainer_1500epochs_1e2lr__nnUNetPlans__3d_fullres_maxnum_512_patch_192/crossval_results_folds_0_1_2/PETCT_f4a5ebd915_10032003.nii.gz,/well/papiez/users/hri611/python/nnUnet_raw/Dataset219_PETCT/labelsTr/PETCT_f4a5ebd915_10032003.nii.gz,0.0,4.0806548767089845,0.0
523,0.897297943567671,2671,765,0.8137265531822617,52141554,15010,15775,17681,/well/papiez/users/hri611/python/nnUNet_results/Dataset219_PETCT/nnUNetTrainer_1500epochs_1e2lr__nnUNetPlans__3d_fullres_maxnum_512_patch_192/crossval_results_folds_0_1_2/PETCT_f5c2c09846_10282002.nii.gz,/well/papiez/users/hri611/python/nnUnet_raw/Dataset219_PETCT/labelsTr/PETCT_f5c2c09846_10282002.nii.gz,0.897297943567671,0.0,7.4024074745178225
524,0.7941245237866014,9721,5248,0.6585460434772691,92276161,28870,34118,38591,/well/papiez/users/hri611/python/nnUNet_results/Dataset219_PETCT/nnUNetTrainer_1500epochs_1e2lr__nnUNetPlans__3d_fullres_maxnum_512_patch_192/crossval_results_folds_0_1_2/PETCT_f5c9b0de6c_04022004.nii.gz,/well/papiez/users/hri611/python/nnUnet_raw/Dataset219_PETCT/labelsTr/PETCT_f5c9b0de6c_04022004.nii.gz,0.7941245237866014,38.46763682556152,9.281001640319824
525,0.0,0,24,0.0,65279976,0,24,0,/well/papiez/users/hri611/python/nnUNet_results/Dataset219_PETCT/nnUNetTrainer_1500epochs_1e2lr__nnUNetPlans__3d_fullres_maxnum_512_patch_192/crossval_results_folds_0_1_2/PETCT_f5cff2e59d_05102007.nii.gz,/well/papiez/users/hri611/python/nnUnet_raw/Dataset219_PETCT/labelsTr/PETCT_f5cff2e59d_05102007.nii.gz,0.0,0.2985845031738281,0.0
526,,0,0,,52160000,0,0,0,/well/papiez/users/hri611/python/nnUNet_results/Dataset219_PETCT/nnUNetTrainer_1500epochs_1e2lr__nnUNetPlans__3d_fullres_maxnum_512_patch_192/crossval_results_folds_0_1_2/PETCT_f603eeceba_03172003.nii.gz,/well/papiez/users/hri611/python/nnUnet_raw/Dataset219_PETCT/labelsTr/PETCT_f603eeceba_03172003.nii.gz,,0.0,0.0
527,0.8743980550750385,9087,1659,0.7768270648584661,52111849,37405,39064,46492,/well/papiez/users/hri611/python/nnUNet_results/Dataset219_PETCT/nnUNetTrainer_1500epochs_1e2lr__nnUNetPlans__3d_fullres_maxnum_512_patch_192/crossval_results_folds_0_1_2/PETCT_f60ea3abc5_05032003.nii.gz,/well/papiez/users/hri611/python/nnUnet_raw/Dataset219_PETCT/labelsTr/PETCT_f60ea3abc5_05032003.nii.gz,0.8743980550750385,0.0,1.6297737464904785
528,0.0,0,9789,0.0,47190211,0,9789,0,/well/papiez/users/hri611/python/nnUNet_results/Dataset219_PETCT/nnUNetTrainer_1500epochs_1e2lr__nnUNetPlans__3d_fullres_maxnum_512_patch_192/crossval_results_folds_0_1_2/PETCT_f6295a93a6_10092006.nii.gz,/well/papiez/users/hri611/python/nnUnet_raw/Dataset219_PETCT/labelsTr/PETCT_f6295a93a6_10092006.nii.gz,0.0,121.78515423202515,0.0
529,,0,0,,47520000,0,0,0,/well/papiez/users/hri611/python/nnUNet_results/Dataset219_PETCT/nnUNetTrainer_1500epochs_1e2lr__nnUNetPlans__3d_fullres_maxnum_512_patch_192/crossval_results_folds_0_1_2/PETCT_f650c87621_12082005.nii.gz,/well/papiez/users/hri611/python/nnUnet_raw/Dataset219_PETCT/labelsTr/PETCT_f650c87621_12082005.nii.gz,,0.0,0.0
530,0.8631685507001856,754,868,0.759275749480558,52313262,5116,5984,5870,/well/papiez/users/hri611/python/nnUNet_results/Dataset219_PETCT/nnUNetTrainer_1500epochs_1e2lr__nnUNetPlans__3d_fullres_maxnum_512_patch_192/crossval_results_folds_0_1_2/PETCT_f65602d938_03252007.nii.gz,/well/papiez/users/hri611/python/nnUnet_raw/Dataset219_PETCT/labelsTr/PETCT_f65602d938_03252007.nii.gz,0.8631685507001856,2.4882041931152346,3.620337100982666
531,0.7313703820650458,5825,981,0.5765042623358845,52143929,9265,10246,15090,/well/papiez/users/hri611/python/nnUNet_results/Dataset219_PETCT/nnUNetTrainer_1500epochs_1e2lr__nnUNetPlans__3d_fullres_maxnum_512_patch_192/crossval_results_folds_0_1_2/PETCT_f7067b7bbb_05262001.nii.gz,/well/papiez/users/hri611/python/nnUnet_raw/Dataset219_PETCT/labelsTr/PETCT_f7067b7bbb_05262001.nii.gz,0.7313703820650458,0.0,21.099971557617188
532,0.0,0,363,0.0,52159637,0,363,0,/well/papiez/users/hri611/python/nnUNet_results/Dataset219_PETCT/nnUNetTrainer_1500epochs_1e2lr__nnUNetPlans__3d_fullres_maxnum_512_patch_192/crossval_results_folds_0_1_2/PETCT_f7a9267a69_02012003.nii.gz,/well/papiez/users/hri611/python/nnUnet_raw/Dataset219_PETCT/labelsTr/PETCT_f7a9267a69_02012003.nii.gz,0.0,4.5160906105041505,0.0
533,0.0,0,227,0.0,52159773,0,227,0,/well/papiez/users/hri611/python/nnUNet_results/Dataset219_PETCT/nnUNetTrainer_1500epochs_1e2lr__nnUNetPlans__3d_fullres_maxnum_512_patch_192/crossval_results_folds_0_1_2/PETCT_f7a9267a69_11012002.nii.gz,/well/papiez/users/hri611/python/nnUnet_raw/Dataset219_PETCT/labelsTr/PETCT_f7a9267a69_11012002.nii.gz,0.0,2.824111759185791,0.0
534,,0,0,,45440000,0,0,0,/well/papiez/users/hri611/python/nnUNet_results/Dataset219_PETCT/nnUNetTrainer_1500epochs_1e2lr__nnUNetPlans__3d_fullres_maxnum_512_patch_192/crossval_results_folds_0_1_2/PETCT_f8314eb3f7_03142003.nii.gz,/well/papiez/users/hri611/python/nnUnet_raw/Dataset219_PETCT/labelsTr/PETCT_f8314eb3f7_03142003.nii.gz,,0.0,0.0
535,0.0,0,5243,0.0,45434757,0,5243,0,/well/papiez/users/hri611/python/nnUNet_results/Dataset219_PETCT/nnUNetTrainer_1500epochs_1e2lr__nnUNetPlans__3d_fullres_maxnum_512_patch_192/crossval_results_folds_0_1_2/PETCT_f8314eb3f7_09202003.nii.gz,/well/papiez/users/hri611/python/nnUnet_raw/Dataset219_PETCT/labelsTr/PETCT_f8314eb3f7_09202003.nii.gz,0.0,65.22827292251587,0.0
536,,0,0,,52320000,0,0,0,/well/papiez/users/hri611/python/nnUNet_results/Dataset219_PETCT/nnUNetTrainer_1500epochs_1e2lr__nnUNetPlans__3d_fullres_maxnum_512_patch_192/crossval_results_folds_0_1_2/PETCT_f8aac0e202_02262006.nii.gz,/well/papiez/users/hri611/python/nnUnet_raw/Dataset219_PETCT/labelsTr/PETCT_f8aac0e202_02262006.nii.gz,,0.0,0.0
537,,0,0,,50880000,0,0,0,/well/papiez/users/hri611/python/nnUNet_results/Dataset219_PETCT/nnUNetTrainer_1500epochs_1e2lr__nnUNetPlans__3d_fullres_maxnum_512_patch_192/crossval_results_folds_0_1_2/PETCT_f8aac0e202_07302006.nii.gz,/well/papiez/users/hri611/python/nnUnet_raw/Dataset219_PETCT/labelsTr/PETCT_f8aac0e202_07302006.nii.gz,,0.0,0.0
538,,0,0,,53440000,0,0,0,/well/papiez/users/hri611/python/nnUNet_results/Dataset219_PETCT/nnUNetTrainer_1500epochs_1e2lr__nnUNetPlans__3d_fullres_maxnum_512_patch_192/crossval_results_folds_0_1_2/PETCT_f8de0cde56_12052005.nii.gz,/well/papiez/users/hri611/python/nnUnet_raw/Dataset219_PETCT/labelsTr/PETCT_f8de0cde56_12052005.nii.gz,,0.0,0.0
539,0.7403138889981513,45,13159,0.5876971116315378,63487975,18821,31980,18866,/well/papiez/users/hri611/python/nnUNet_results/Dataset219_PETCT/nnUNetTrainer_1500epochs_1e2lr__nnUNetPlans__3d_fullres_maxnum_512_patch_192/crossval_results_folds_0_1_2/PETCT_f9c4d4f9ab_03222007.nii.gz,/well/papiez/users/hri611/python/nnUnet_raw/Dataset219_PETCT/labelsTr/PETCT_f9c4d4f9ab_03222007.nii.gz,0.7403138889981513,6.369802734375,0.0
540,0.9651053127947187,51,60,0.9325637910085055,52158354,1535,1595,1586,/well/papiez/users/hri611/python/nnUNet_results/Dataset219_PETCT/nnUNetTrainer_1500epochs_1e2lr__nnUNetPlans__3d_fullres_maxnum_512_patch_192/crossval_results_folds_0_1_2/PETCT_f9e0c504af_06292003.nii.gz,/well/papiez/users/hri611/python/nnUnet_raw/Dataset219_PETCT/labelsTr/PETCT_f9e0c504af_06292003.nii.gz,0.9651053127947187,0.0,0.012441020965576172
541,,0,0,,45440000,0,0,0,/well/papiez/users/hri611/python/nnUNet_results/Dataset219_PETCT/nnUNetTrainer_1500epochs_1e2lr__nnUNetPlans__3d_fullres_maxnum_512_patch_192/crossval_results_folds_0_1_2/PETCT_fa45f610c4_10072004.nii.gz,/well/papiez/users/hri611/python/nnUnet_raw/Dataset219_PETCT/labelsTr/PETCT_fa45f610c4_10072004.nii.gz,,0.0,0.0
542,0.631424375917768,3010,2,0.4613733905579399,52154408,2580,2582,5590,/well/papiez/users/hri611/python/nnUNet_results/Dataset219_PETCT/nnUNetTrainer_1500epochs_1e2lr__nnUNetPlans__3d_fullres_maxnum_512_patch_192/crossval_results_folds_0_1_2/PETCT_faf4a6dbaa_01102003.nii.gz,/well/papiez/users/hri611/python/nnUnet_raw/Dataset219_PETCT/labelsTr/PETCT_faf4a6dbaa_01102003.nii.gz,0.631424375917768,0.0,5.013731449127198
543,0.3955781296683597,0,2023,0.24655493482309124,47997315,662,2685,662,/well/papiez/users/hri611/python/nnUNet_results/Dataset219_PETCT/nnUNetTrainer_1500epochs_1e2lr__nnUNetPlans__3d_fullres_maxnum_512_patch_192/crossval_results_folds_0_1_2/PETCT_fb014a1ea0_12012005.nii.gz,/well/papiez/users/hri611/python/nnUnet_raw/Dataset219_PETCT/labelsTr/PETCT_fb014a1ea0_12012005.nii.gz,0.3955781296683597,0.0,0.0
544,0.0,0,80,0.0,95519920,0,80,0,/well/papiez/users/hri611/python/nnUNet_results/Dataset219_PETCT/nnUNetTrainer_1500epochs_1e2lr__nnUNetPlans__3d_fullres_maxnum_512_patch_192/crossval_results_folds_0_1_2/PETCT_fc0389a486_05302005.nii.gz,/well/papiez/users/hri611/python/nnUnet_raw/Dataset219_PETCT/labelsTr/PETCT_fc0389a486_05302005.nii.gz,0.0,0.9952816772460937,0.0
545,0.885167067407346,910,475,0.793990777926521,99033277,5338,5813,6248,/well/papiez/users/hri611/python/nnUNet_results/Dataset219_PETCT/nnUNetTrainer_1500epochs_1e2lr__nnUNetPlans__3d_fullres_maxnum_512_patch_192/crossval_results_folds_0_1_2/PETCT_fcdbe15200_12142003.nii.gz,/well/papiez/users/hri611/python/nnUnet_raw/Dataset219_PETCT/labelsTr/PETCT_fcdbe15200_12142003.nii.gz,0.885167067407346,0.0,0.06220510482788086
546,0.5961783439490446,257,60,0.4246823956442831,47839449,234,294,491,/well/papiez/users/hri611/python/nnUNet_results/Dataset219_PETCT/nnUNetTrainer_1500epochs_1e2lr__nnUNetPlans__3d_fullres_maxnum_512_patch_192/crossval_results_folds_0_1_2/PETCT_fde66dd53a_12222005.nii.gz,/well/papiez/users/hri611/python/nnUnet_raw/Dataset219_PETCT/labelsTr/PETCT_fde66dd53a_12222005.nii.gz,0.5961783439490446,0.0,3.0107270736694334
547,,0,0,,92320000,0,0,0,/well/papiez/users/hri611/python/nnUNet_results/Dataset219_PETCT/nnUNetTrainer_1500epochs_1e2lr__nnUNetPlans__3d_fullres_maxnum_512_patch_192/crossval_results_folds_0_1_2/PETCT_fde79b6aa9_02232003.nii.gz,/well/papiez/users/hri611/python/nnUnet_raw/Dataset219_PETCT/labelsTr/PETCT_fde79b6aa9_02232003.nii.gz,,0.0,0.0
548,,0,0,,92320000,0,0,0,/well/papiez/users/hri611/python/nnUNet_results/Dataset219_PETCT/nnUNetTrainer_1500epochs_1e2lr__nnUNetPlans__3d_fullres_maxnum_512_patch_192/crossval_results_folds_0_1_2/PETCT_fde79b6aa9_08162003.nii.gz,/well/papiez/users/hri611/python/nnUnet_raw/Dataset219_PETCT/labelsTr/PETCT_fde79b6aa9_08162003.nii.gz,,0.0,0.0
549,0.0,0,299,0.0,45439701,0,299,0,/well/papiez/users/hri611/python/nnUNet_results/Dataset219_PETCT/nnUNetTrainer_1500epochs_1e2lr__nnUNetPlans__3d_fullres_maxnum_512_patch_192/crossval_results_folds_0_1_2/PETCT_fe705ea1cc_04272003.nii.gz,/well/papiez/users/hri611/python/nnUnet_raw/Dataset219_PETCT/labelsTr/PETCT_fe705ea1cc_04272003.nii.gz,0.0,3.7198652687072755,0.0
550,0.7627927905407095,5809,3680,0.6165440879334034,45415254,15257,18937,21066,/well/papiez/users/hri611/python/nnUNet_results/Dataset219_PETCT/nnUNetTrainer_1500epochs_1e2lr__nnUNetPlans__3d_fullres_maxnum_512_patch_192/crossval_results_folds_0_1_2/PETCT_fe705ea1cc_12292002.nii.gz,/well/papiez/users/hri611/python/nnUnet_raw/Dataset219_PETCT/labelsTr/PETCT_fe705ea1cc_12292002.nii.gz,0.7627927905407095,2.724583591461182,31.16475751876831
551,,0,0,,52160000,0,0,0,/well/papiez/users/hri611/python/nnUNet_results/Dataset219_PETCT/nnUNetTrainer_1500epochs_1e2lr__nnUNetPlans__3d_fullres_maxnum_512_patch_192/crossval_results_folds_0_1_2/PETCT_ff1451316e_03312003.nii.gz,/well/papiez/users/hri611/python/nnUnet_raw/Dataset219_PETCT/labelsTr/PETCT_ff1451316e_03312003.nii.gz,,0.0,0.0
