,DICE,FN,FP,IoU,TN,TP,n_pred,n_ref,prediction_file,reference_file,challenge_DICE,challenge_FP,challenge_FN
0,0.6161772282328697,701,44,0.44527177959791514,52158657,598,642,1299,/well/papiez/users/hri611/python/nnUNet_results/Dataset219_PETCT/nnUNetTrainer_1500epochs_1e2lr__nnUNetPlans__3d_fullres_maxnum_512_patch_192/crossval_results_folds_0_1_2_3_4/PETCT_0011f3deaf_03232003.nii.gz,/well/papiez/users/hri611/python/nnUnet_raw/Dataset219_PETCT/labelsTr/PETCT_0011f3deaf_03232003.nii.gz,0.6161772282328697,0.3981126708984375,0.0
1,0.9364942881709863,135,1933,0.8805728805728805,48782684,15248,17181,15383,/well/papiez/users/hri611/python/nnUNet_results/Dataset219_PETCT/nnUNetTrainer_1500epochs_1e2lr__nnUNetPlans__3d_fullres_maxnum_512_patch_192/crossval_results_folds_0_1_2_3_4/PETCT_01140d52d8_08132005.nii.gz,/well/papiez/users/hri611/python/nnUnet_raw/Dataset219_PETCT/labelsTr/PETCT_01140d52d8_08132005.nii.gz,0.9364942881709863,0.0,0.6096100273132324
2,0.7328086164043082,5608,842,0.5782935599869238,45424705,8845,9687,14453,/well/papiez/users/hri611/python/nnUNet_results/Dataset219_PETCT/nnUNetTrainer_1500epochs_1e2lr__nnUNetPlans__3d_fullres_maxnum_512_patch_192/crossval_results_folds_0_1_2_3_4/PETCT_0117d7f11f_09132001.nii.gz,/well/papiez/users/hri611/python/nnUnet_raw/Dataset219_PETCT/labelsTr/PETCT_0117d7f11f_09132001.nii.gz,0.7328086164043082,0.0,0.09952816772460937
3,0.0,0,134,0.0,46079866,0,134,0,/well/papiez/users/hri611/python/nnUNet_results/Dataset219_PETCT/nnUNetTrainer_1500epochs_1e2lr__nnUNetPlans__3d_fullres_maxnum_512_patch_192/crossval_results_folds_0_1_2_3_4/PETCT_0143bab87a_07172005.nii.gz,/well/papiez/users/hri611/python/nnUnet_raw/Dataset219_PETCT/labelsTr/PETCT_0143bab87a_07172005.nii.gz,0.0,1.667096809387207,0.0
4,0.6601115837154062,5818,335,0.49266160949868076,52147872,5975,6310,11793,/well/papiez/users/hri611/python/nnUNet_results/Dataset219_PETCT/nnUNetTrainer_1500epochs_1e2lr__nnUNetPlans__3d_fullres_maxnum_512_patch_192/crossval_results_folds_0_1_2_3_4/PETCT_01682f60c3_03112002.nii.gz,/well/papiez/users/hri611/python/nnUnet_raw/Dataset219_PETCT/labelsTr/PETCT_01682f60c3_03112002.nii.gz,0.6601115837154062,0.0,46.765797809600826
5,0.42405816259087903,2620,1737,0.26908236873007885,52154039,1604,3341,4224,/well/papiez/users/hri611/python/nnUNet_results/Dataset219_PETCT/nnUNetTrainer_1500epochs_1e2lr__nnUNetPlans__3d_fullres_maxnum_512_patch_192/crossval_results_folds_0_1_2_3_4/PETCT_0168f65af8_04042003.nii.gz,/well/papiez/users/hri611/python/nnUnet_raw/Dataset219_PETCT/labelsTr/PETCT_0168f65af8_04042003.nii.gz,0.42405816259087903,0.0,11.79408787536621
6,0.7,1,5,0.5384615384615384,99039987,7,12,8,/well/papiez/users/hri611/python/nnUNet_results/Dataset219_PETCT/nnUNetTrainer_1500epochs_1e2lr__nnUNetPlans__3d_fullres_maxnum_512_patch_192/crossval_results_folds_0_1_2_3_4/PETCT_0223010e46_09042003.nii.gz,/well/papiez/users/hri611/python/nnUnet_raw/Dataset219_PETCT/labelsTr/PETCT_0223010e46_09042003.nii.gz,0.7,0.0,0.012441020965576172
7,,0,0,,37120000,0,0,0,/well/papiez/users/hri611/python/nnUNet_results/Dataset219_PETCT/nnUNetTrainer_1500epochs_1e2lr__nnUNetPlans__3d_fullres_maxnum_512_patch_192/crossval_results_folds_0_1_2_3_4/PETCT_0225325b91_08222005.nii.gz,/well/papiez/users/hri611/python/nnUnet_raw/Dataset219_PETCT/labelsTr/PETCT_0225325b91_08222005.nii.gz,,0.0,0.0
8,0.0,0,571,0.0,45439429,0,571,0,/well/papiez/users/hri611/python/nnUNet_results/Dataset219_PETCT/nnUNetTrainer_1500epochs_1e2lr__nnUNetPlans__3d_fullres_maxnum_512_patch_192/crossval_results_folds_0_1_2_3_4/PETCT_0410759456_08222003.nii.gz,/well/papiez/users/hri611/python/nnUnet_raw/Dataset219_PETCT/labelsTr/PETCT_0410759456_08222003.nii.gz,0.0,7.103822971343994,0.0
9,,0,0,,45440000,0,0,0,/well/papiez/users/hri611/python/nnUNet_results/Dataset219_PETCT/nnUNetTrainer_1500epochs_1e2lr__nnUNetPlans__3d_fullres_maxnum_512_patch_192/crossval_results_folds_0_1_2_3_4/PETCT_0410759456_11072002.nii.gz,/well/papiez/users/hri611/python/nnUnet_raw/Dataset219_PETCT/labelsTr/PETCT_0410759456_11072002.nii.gz,,0.0,0.0
10,0.8285871761896013,498,3234,0.7073400250941029,45427248,9020,12254,9518,/well/papiez/users/hri611/python/nnUNet_results/Dataset219_PETCT/nnUNetTrainer_1500epochs_1e2lr__nnUNetPlans__3d_fullres_maxnum_512_patch_192/crossval_results_folds_0_1_2_3_4/PETCT_04606080a0_02202003.nii.gz,/well/papiez/users/hri611/python/nnUnet_raw/Dataset219_PETCT/labelsTr/PETCT_04606080a0_02202003.nii.gz,0.8285871761896013,4.466326526641845,0.0
11,0.9289542929539031,436,1022,0.8673339399454049,45429010,9532,10554,9968,/well/papiez/users/hri611/python/nnUNet_results/Dataset219_PETCT/nnUNetTrainer_1500epochs_1e2lr__nnUNetPlans__3d_fullres_maxnum_512_patch_192/crossval_results_folds_0_1_2_3_4/PETCT_04a4e1c874_11182001.nii.gz,/well/papiez/users/hri611/python/nnUnet_raw/Dataset219_PETCT/labelsTr/PETCT_04a4e1c874_11182001.nii.gz,0.9289542929539031,2.6623784866333007,0.0
12,0.8169656430525996,1051,153,0.690567977383706,45436109,2687,2840,3738,/well/papiez/users/hri611/python/nnUNet_results/Dataset219_PETCT/nnUNetTrainer_1500epochs_1e2lr__nnUNetPlans__3d_fullres_maxnum_512_patch_192/crossval_results_folds_0_1_2_3_4/PETCT_04ab5c61c9_11222002.nii.gz,/well/papiez/users/hri611/python/nnUnet_raw/Dataset219_PETCT/labelsTr/PETCT_04ab5c61c9_11222002.nii.gz,0.8169656430525996,0.0,0.0
13,,0,0,,51840000,0,0,0,/well/papiez/users/hri611/python/nnUNet_results/Dataset219_PETCT/nnUNetTrainer_1500epochs_1e2lr__nnUNetPlans__3d_fullres_maxnum_512_patch_192/crossval_results_folds_0_1_2_3_4/PETCT_05808cf24e_03182006.nii.gz,/well/papiez/users/hri611/python/nnUnet_raw/Dataset219_PETCT/labelsTr/PETCT_05808cf24e_03182006.nii.gz,,0.0,0.0
14,0.13465073529411764,17582,1248,0.07218526730721853,65579705,1465,2713,19047,/well/papiez/users/hri611/python/nnUNet_results/Dataset219_PETCT/nnUNetTrainer_1500epochs_1e2lr__nnUNetPlans__3d_fullres_maxnum_512_patch_192/crossval_results_folds_0_1_2_3_4/PETCT_05808cf24e_07291999.nii.gz,/well/papiez/users/hri611/python/nnUnet_raw/Dataset219_PETCT/labelsTr/PETCT_05808cf24e_07291999.nii.gz,0.13465073529411764,15.003871284484863,124.79588130569458
15,,0,0,,52160000,0,0,0,/well/papiez/users/hri611/python/nnUNet_results/Dataset219_PETCT/nnUNetTrainer_1500epochs_1e2lr__nnUNetPlans__3d_fullres_maxnum_512_patch_192/crossval_results_folds_0_1_2_3_4/PETCT_05bed31780_11242003.nii.gz,/well/papiez/users/hri611/python/nnUnet_raw/Dataset219_PETCT/labelsTr/PETCT_05bed31780_11242003.nii.gz,,0.0,0.0
16,,0,0,,92320000,0,0,0,/well/papiez/users/hri611/python/nnUNet_results/Dataset219_PETCT/nnUNetTrainer_1500epochs_1e2lr__nnUNetPlans__3d_fullres_maxnum_512_patch_192/crossval_results_folds_0_1_2_3_4/PETCT_05d8640f52_02242005.nii.gz,/well/papiez/users/hri611/python/nnUnet_raw/Dataset219_PETCT/labelsTr/PETCT_05d8640f52_02242005.nii.gz,,0.0,0.0
17,0.8518859245630175,0,161,0.7419871794871795,40639376,463,624,463,/well/papiez/users/hri611/python/nnUNet_results/Dataset219_PETCT/nnUNetTrainer_1500epochs_1e2lr__nnUNetPlans__3d_fullres_maxnum_512_patch_192/crossval_results_folds_0_1_2_3_4/PETCT_06a46414eb_03122006.nii.gz,/well/papiez/users/hri611/python/nnUnet_raw/Dataset219_PETCT/labelsTr/PETCT_06a46414eb_03122006.nii.gz,0.8518859245630175,0.360789608001709,0.0
18,,0,0,,38720000,0,0,0,/well/papiez/users/hri611/python/nnUNet_results/Dataset219_PETCT/nnUNetTrainer_1500epochs_1e2lr__nnUNetPlans__3d_fullres_maxnum_512_patch_192/crossval_results_folds_0_1_2_3_4/PETCT_06d55e8295_04172003.nii.gz,/well/papiez/users/hri611/python/nnUnet_raw/Dataset219_PETCT/labelsTr/PETCT_06d55e8295_04172003.nii.gz,,0.0,0.0
19,0.5821525757717931,7686,1220,0.4105890138980807,45424890,6204,7424,13890,/well/papiez/users/hri611/python/nnUNet_results/Dataset219_PETCT/nnUNetTrainer_1500epochs_1e2lr__nnUNetPlans__3d_fullres_maxnum_512_patch_192/crossval_results_folds_0_1_2_3_4/PETCT_06e7c24059_04222005.nii.gz,/well/papiez/users/hri611/python/nnUnet_raw/Dataset219_PETCT/labelsTr/PETCT_06e7c24059_04222005.nii.gz,0.5821525757717931,4.628059799194336,66.54702114486695
20,0.0,0,2472,0.0,38877528,0,2472,0,/well/papiez/users/hri611/python/nnUNet_results/Dataset219_PETCT/nnUNetTrainer_1500epochs_1e2lr__nnUNetPlans__3d_fullres_maxnum_512_patch_192/crossval_results_folds_0_1_2_3_4/PETCT_072833774e_07232006.nii.gz,/well/papiez/users/hri611/python/nnUnet_raw/Dataset219_PETCT/labelsTr/PETCT_072833774e_07232006.nii.gz,0.0,30.754203826904295,0.0
21,0.9213333993758978,4127,3814,0.8541410282313613,45385557,46502,50316,50629,/well/papiez/users/hri611/python/nnUNet_results/Dataset219_PETCT/nnUNetTrainer_1500epochs_1e2lr__nnUNetPlans__3d_fullres_maxnum_512_patch_192/crossval_results_folds_0_1_2_3_4/PETCT_07574bfa00_04202003.nii.gz,/well/papiez/users/hri611/python/nnUnet_raw/Dataset219_PETCT/labelsTr/PETCT_07574bfa00_04202003.nii.gz,0.9213333993758978,0.796225341796875,0.3359075660705566
22,,0,0,,45440000,0,0,0,/well/papiez/users/hri611/python/nnUNet_results/Dataset219_PETCT/nnUNetTrainer_1500epochs_1e2lr__nnUNetPlans__3d_fullres_maxnum_512_patch_192/crossval_results_folds_0_1_2_3_4/PETCT_07b7e9abfc_02102003.nii.gz,/well/papiez/users/hri611/python/nnUnet_raw/Dataset219_PETCT/labelsTr/PETCT_07b7e9abfc_02102003.nii.gz,,0.0,0.0
23,0.0,0,34,0.0,94079966,0,34,0,/well/papiez/users/hri611/python/nnUNet_results/Dataset219_PETCT/nnUNetTrainer_1500epochs_1e2lr__nnUNetPlans__3d_fullres_maxnum_512_patch_192/crossval_results_folds_0_1_2_3_4/PETCT_07fec0d985_05042006.nii.gz,/well/papiez/users/hri611/python/nnUnet_raw/Dataset219_PETCT/labelsTr/PETCT_07fec0d985_05042006.nii.gz,0.0,0.42299471282958984,0.0
24,0.0,0,163,0.0,41439837,0,163,0,/well/papiez/users/hri611/python/nnUNet_results/Dataset219_PETCT/nnUNetTrainer_1500epochs_1e2lr__nnUNetPlans__3d_fullres_maxnum_512_patch_192/crossval_results_folds_0_1_2_3_4/PETCT_080922db5a_01282006.nii.gz,/well/papiez/users/hri611/python/nnUnet_raw/Dataset219_PETCT/labelsTr/PETCT_080922db5a_01282006.nii.gz,0.0,2.027886417388916,0.0
25,,0,0,,49440000,0,0,0,/well/papiez/users/hri611/python/nnUNet_results/Dataset219_PETCT/nnUNetTrainer_1500epochs_1e2lr__nnUNetPlans__3d_fullres_maxnum_512_patch_192/crossval_results_folds_0_1_2_3_4/PETCT_08198c4f0c_11102005.nii.gz,/well/papiez/users/hri611/python/nnUnet_raw/Dataset219_PETCT/labelsTr/PETCT_08198c4f0c_11102005.nii.gz,,0.0,0.0
26,0.859345584939489,1629,1509,0.7533794404275385,52147276,9586,11095,11215,/well/papiez/users/hri611/python/nnUNet_results/Dataset219_PETCT/nnUNetTrainer_1500epochs_1e2lr__nnUNetPlans__3d_fullres_maxnum_512_patch_192/crossval_results_folds_0_1_2_3_4/PETCT_08212d7f6c_09112003.nii.gz,/well/papiez/users/hri611/python/nnUnet_raw/Dataset219_PETCT/labelsTr/PETCT_08212d7f6c_09112003.nii.gz,0.859345584939489,0.0,0.0
27,0.0,0,326,0.0,52159674,0,326,0,/well/papiez/users/hri611/python/nnUNet_results/Dataset219_PETCT/nnUNetTrainer_1500epochs_1e2lr__nnUNetPlans__3d_fullres_maxnum_512_patch_192/crossval_results_folds_0_1_2_3_4/PETCT_098c4b7b87_08312003.nii.gz,/well/papiez/users/hri611/python/nnUnet_raw/Dataset219_PETCT/labelsTr/PETCT_098c4b7b87_08312003.nii.gz,0.0,4.055772834777832,0.0
28,0.8216939078751857,107,2533,0.6973518284993695,94871277,6083,8616,6190,/well/papiez/users/hri611/python/nnUNet_results/Dataset219_PETCT/nnUNetTrainer_1500epochs_1e2lr__nnUNetPlans__3d_fullres_maxnum_512_patch_192/crossval_results_folds_0_1_2_3_4/PETCT_09ee00bdc6_09302005.nii.gz,/well/papiez/users/hri611/python/nnUnet_raw/Dataset219_PETCT/labelsTr/PETCT_09ee00bdc6_09302005.nii.gz,0.8216939078751857,0.1368512306213379,0.0
29,,0,0,,48640000,0,0,0,/well/papiez/users/hri611/python/nnUNet_results/Dataset219_PETCT/nnUNetTrainer_1500epochs_1e2lr__nnUNetPlans__3d_fullres_maxnum_512_patch_192/crossval_results_folds_0_1_2_3_4/PETCT_0af7ffe12a_08122005.nii.gz,/well/papiez/users/hri611/python/nnUnet_raw/Dataset219_PETCT/labelsTr/PETCT_0af7ffe12a_08122005.nii.gz,,0.0,0.0
30,0.8175889888393433,1781,5296,0.6914592143697955,52137063,15860,21156,17641,/well/papiez/users/hri611/python/nnUNet_results/Dataset219_PETCT/nnUNetTrainer_1500epochs_1e2lr__nnUNetPlans__3d_fullres_maxnum_512_patch_192/crossval_results_folds_0_1_2_3_4/PETCT_0b57b247b6_05022002.nii.gz,/well/papiez/users/hri611/python/nnUnet_raw/Dataset219_PETCT/labelsTr/PETCT_0b57b247b6_05022002.nii.gz,0.8175889888393433,7.514376663208008,0.0
31,0.8634413477972723,6685,1145,0.7596980112938866,52127416,24754,25899,31439,/well/papiez/users/hri611/python/nnUNet_results/Dataset219_PETCT/nnUNetTrainer_1500epochs_1e2lr__nnUNetPlans__3d_fullres_maxnum_512_patch_192/crossval_results_folds_0_1_2_3_4/PETCT_0b98dbe00d_08112002.nii.gz,/well/papiez/users/hri611/python/nnUnet_raw/Dataset219_PETCT/labelsTr/PETCT_0b98dbe00d_08112002.nii.gz,0.8634413477972723,0.0,4.8768802185058595
32,0.9134966485522774,4098,5994,0.8407674466305874,52096621,53287,59281,57385,/well/papiez/users/hri611/python/nnUNet_results/Dataset219_PETCT/nnUNetTrainer_1500epochs_1e2lr__nnUNetPlans__3d_fullres_maxnum_512_patch_192/crossval_results_folds_0_1_2_3_4/PETCT_0beb67c923_07251999.nii.gz,/well/papiez/users/hri611/python/nnUnet_raw/Dataset219_PETCT/labelsTr/PETCT_0beb67c923_07251999.nii.gz,0.9134966485522774,1.8412711029052735,0.14929225158691406
33,,0,0,,52160000,0,0,0,/well/papiez/users/hri611/python/nnUNet_results/Dataset219_PETCT/nnUNetTrainer_1500epochs_1e2lr__nnUNetPlans__3d_fullres_maxnum_512_patch_192/crossval_results_folds_0_1_2_3_4/PETCT_0c13e4df10_10112003.nii.gz,/well/papiez/users/hri611/python/nnUnet_raw/Dataset219_PETCT/labelsTr/PETCT_0c13e4df10_10112003.nii.gz,,0.0,0.0
34,0.45866785277438005,7858,16483,0.297578853201743,52125347,10312,26795,18170,/well/papiez/users/hri611/python/nnUNet_results/Dataset219_PETCT/nnUNetTrainer_1500epochs_1e2lr__nnUNetPlans__3d_fullres_maxnum_512_patch_192/crossval_results_folds_0_1_2_3_4/PETCT_0cda25453b_10122003.nii.gz,/well/papiez/users/hri611/python/nnUnet_raw/Dataset219_PETCT/labelsTr/PETCT_0cda25453b_10122003.nii.gz,0.45866785277438005,14.481348403930664,82.37199981307984
35,0.7855082730354703,4058,181,0.6467794350470795,45427999,7762,7943,11820,/well/papiez/users/hri611/python/nnUNet_results/Dataset219_PETCT/nnUNetTrainer_1500epochs_1e2lr__nnUNetPlans__3d_fullres_maxnum_512_patch_192/crossval_results_folds_0_1_2_3_4/PETCT_0e2034240b_01312003.nii.gz,/well/papiez/users/hri611/python/nnUnet_raw/Dataset219_PETCT/labelsTr/PETCT_0e2034240b_01312003.nii.gz,0.7855082730354703,0.0,1.1072508659362792
36,,0,0,,52160000,0,0,0,/well/papiez/users/hri611/python/nnUNet_results/Dataset219_PETCT/nnUNetTrainer_1500epochs_1e2lr__nnUNetPlans__3d_fullres_maxnum_512_patch_192/crossval_results_folds_0_1_2_3_4/PETCT_0e9a98ecda_02202003.nii.gz,/well/papiez/users/hri611/python/nnUnet_raw/Dataset219_PETCT/labelsTr/PETCT_0e9a98ecda_02202003.nii.gz,,0.0,0.0
37,0.8520062722598368,11646,529,0.742169797335931,52112779,35046,35575,46692,/well/papiez/users/hri611/python/nnUNet_results/Dataset219_PETCT/nnUNetTrainer_1500epochs_1e2lr__nnUNetPlans__3d_fullres_maxnum_512_patch_192/crossval_results_folds_0_1_2_3_4/PETCT_0ea07b421b_10272001.nii.gz,/well/papiez/users/hri611/python/nnUnet_raw/Dataset219_PETCT/labelsTr/PETCT_0ea07b421b_10272001.nii.gz,0.8520062722598368,0.07464612579345703,30.803967910766602
38,0.41766109785202865,129,359,0.26395173453996984,45439337,175,534,304,/well/papiez/users/hri611/python/nnUNet_results/Dataset219_PETCT/nnUNetTrainer_1500epochs_1e2lr__nnUNetPlans__3d_fullres_maxnum_512_patch_192/crossval_results_folds_0_1_2_3_4/PETCT_0f4ee9e078_02102005.nii.gz,/well/papiez/users/hri611/python/nnUnet_raw/Dataset219_PETCT/labelsTr/PETCT_0f4ee9e078_02102005.nii.gz,0.41766109785202865,4.117977939605713,1.530245578765869
39,0.5896656534954408,249,21,0.41810344827586204,45439536,194,215,443,/well/papiez/users/hri611/python/nnUNet_results/Dataset219_PETCT/nnUNetTrainer_1500epochs_1e2lr__nnUNetPlans__3d_fullres_maxnum_512_patch_192/crossval_results_folds_0_1_2_3_4/PETCT_0fa313309d_04232005.nii.gz,/well/papiez/users/hri611/python/nnUnet_raw/Dataset219_PETCT/labelsTr/PETCT_0fa313309d_04232005.nii.gz,0.5896656534954408,0.21149735641479492,1.1196918869018555
40,,0,0,,46080000,0,0,0,/well/papiez/users/hri611/python/nnUNet_results/Dataset219_PETCT/nnUNetTrainer_1500epochs_1e2lr__nnUNetPlans__3d_fullres_maxnum_512_patch_192/crossval_results_folds_0_1_2_3_4/PETCT_0fa313309d_10032005.nii.gz,/well/papiez/users/hri611/python/nnUnet_raw/Dataset219_PETCT/labelsTr/PETCT_0fa313309d_10032005.nii.gz,,0.0,0.0
41,0.8524590163934426,40,23,0.7428571428571429,54079755,182,205,222,/well/papiez/users/hri611/python/nnUNet_results/Dataset219_PETCT/nnUNetTrainer_1500epochs_1e2lr__nnUNetPlans__3d_fullres_maxnum_512_patch_192/crossval_results_folds_0_1_2_3_4/PETCT_1019ae8551_04062007.nii.gz,/well/papiez/users/hri611/python/nnUnet_raw/Dataset219_PETCT/labelsTr/PETCT_1019ae8551_04062007.nii.gz,0.8524590163934426,0.09952816772460937,0.0
42,0.1684368361864301,6624,31,0.09196343293764497,45432671,674,705,7298,/well/papiez/users/hri611/python/nnUNet_results/Dataset219_PETCT/nnUNetTrainer_1500epochs_1e2lr__nnUNetPlans__3d_fullres_maxnum_512_patch_192/crossval_results_folds_0_1_2_3_4/PETCT_108c1763d4_09302004.nii.gz,/well/papiez/users/hri611/python/nnUnet_raw/Dataset219_PETCT/labelsTr/PETCT_108c1763d4_09302004.nii.gz,0.1684368361864301,0.12441020965576172,0.012441020965576172
43,0.794755877034358,186,722,0.6594148537134283,45437334,1758,2480,1944,/well/papiez/users/hri611/python/nnUNet_results/Dataset219_PETCT/nnUNetTrainer_1500epochs_1e2lr__nnUNetPlans__3d_fullres_maxnum_512_patch_192/crossval_results_folds_0_1_2_3_4/PETCT_119165872d_02122005.nii.gz,/well/papiez/users/hri611/python/nnUnet_raw/Dataset219_PETCT/labelsTr/PETCT_119165872d_02122005.nii.gz,0.794755877034358,4.3045932540893554,0.3110255241394043
44,0.31451612903225806,168,2,0.18660287081339713,45439791,39,41,207,/well/papiez/users/hri611/python/nnUNet_results/Dataset219_PETCT/nnUNetTrainer_1500epochs_1e2lr__nnUNetPlans__3d_fullres_maxnum_512_patch_192/crossval_results_folds_0_1_2_3_4/PETCT_11afab3485_05252003.nii.gz,/well/papiez/users/hri611/python/nnUnet_raw/Dataset219_PETCT/labelsTr/PETCT_11afab3485_05252003.nii.gz,0.31451612903225806,0.0,1.9034762077331542
45,0.8286211879793974,1104,8146,0.7073895988864988,45408388,22362,30508,23466,/well/papiez/users/hri611/python/nnUNet_results/Dataset219_PETCT/nnUNetTrainer_1500epochs_1e2lr__nnUNetPlans__3d_fullres_maxnum_512_patch_192/crossval_results_folds_0_1_2_3_4/PETCT_11e258cc1f_03062003.nii.gz,/well/papiez/users/hri611/python/nnUnet_raw/Dataset219_PETCT/labelsTr/PETCT_11e258cc1f_03062003.nii.gz,0.8286211879793974,8.858006927490234,3.060491157531738
46,0.7621052631578947,225,1,0.6156462585034014,52159412,362,363,587,/well/papiez/users/hri611/python/nnUNet_results/Dataset219_PETCT/nnUNetTrainer_1500epochs_1e2lr__nnUNetPlans__3d_fullres_maxnum_512_patch_192/crossval_results_folds_0_1_2_3_4/PETCT_12025abab5_11012004.nii.gz,/well/papiez/users/hri611/python/nnUnet_raw/Dataset219_PETCT/labelsTr/PETCT_12025abab5_11012004.nii.gz,0.7621052631578947,0.0,1.9159172286987305
47,0.9146528844810727,193,418,0.8427284427284427,104476115,3274,3692,3467,/well/papiez/users/hri611/python/nnUNet_results/Dataset219_PETCT/nnUNetTrainer_1500epochs_1e2lr__nnUNetPlans__3d_fullres_maxnum_512_patch_192/crossval_results_folds_0_1_2_3_4/PETCT_1253499c80_10072005.nii.gz,/well/papiez/users/hri611/python/nnUnet_raw/Dataset219_PETCT/labelsTr/PETCT_1253499c80_10072005.nii.gz,0.9146528844810727,3.7198652687072755,0.0
48,0.8539243163000217,29758,15900,0.7450854498048696,47820889,133453,149353,163211,/well/papiez/users/hri611/python/nnUNet_results/Dataset219_PETCT/nnUNetTrainer_1500epochs_1e2lr__nnUNetPlans__3d_fullres_maxnum_512_patch_192/crossval_results_folds_0_1_2_3_4/PETCT_1285b86bea_02242006.nii.gz,/well/papiez/users/hri611/python/nnUnet_raw/Dataset219_PETCT/labelsTr/PETCT_1285b86bea_02242006.nii.gz,0.8539243163000217,6.95453071975708,113.92242898178101
49,0.7980584487814744,1712,285,0.6639744236917382,58874057,3946,4231,5658,/well/papiez/users/hri611/python/nnUNet_results/Dataset219_PETCT/nnUNetTrainer_1500epochs_1e2lr__nnUNetPlans__3d_fullres_maxnum_512_patch_192/crossval_results_folds_0_1_2_3_4/PETCT_1291700093_07132003.nii.gz,/well/papiez/users/hri611/python/nnUnet_raw/Dataset219_PETCT/labelsTr/PETCT_1291700093_07132003.nii.gz,0.7980584487814744,0.0,0.6469330902099609
50,0.5193801955658475,103537,2729,0.35078566017448254,51996316,57418,60147,160955,/well/papiez/users/hri611/python/nnUNet_results/Dataset219_PETCT/nnUNetTrainer_1500epochs_1e2lr__nnUNetPlans__3d_fullres_maxnum_512_patch_192/crossval_results_folds_0_1_2_3_4/PETCT_13b40a817b_02182001.nii.gz,/well/papiez/users/hri611/python/nnUnet_raw/Dataset219_PETCT/labelsTr/PETCT_13b40a817b_02182001.nii.gz,0.5193801955658475,28.4028508644104,106.93057519912719
51,0.8630186847852463,97,2161,0.7590438587130509,85590629,7113,9274,7210,/well/papiez/users/hri611/python/nnUNet_results/Dataset219_PETCT/nnUNetTrainer_1500epochs_1e2lr__nnUNetPlans__3d_fullres_maxnum_512_patch_192/crossval_results_folds_0_1_2_3_4/PETCT_13f476b02b_11192001.nii.gz,/well/papiez/users/hri611/python/nnUnet_raw/Dataset219_PETCT/labelsTr/PETCT_13f476b02b_11192001.nii.gz,0.8630186847852463,2.886316864013672,0.0
52,0.0,0,67,0.0,105759933,0,67,0,/well/papiez/users/hri611/python/nnUNet_results/Dataset219_PETCT/nnUNetTrainer_1500epochs_1e2lr__nnUNetPlans__3d_fullres_maxnum_512_patch_192/crossval_results_folds_0_1_2_3_4/PETCT_141fffa2a9_03012003.nii.gz,/well/papiez/users/hri611/python/nnUnet_raw/Dataset219_PETCT/labelsTr/PETCT_141fffa2a9_03012003.nii.gz,0.0,0.8335484046936035,0.0
53,0.8148007650117755,9597,2120,0.6874799957324229,52122508,25775,27895,35372,/well/papiez/users/hri611/python/nnUNet_results/Dataset219_PETCT/nnUNetTrainer_1500epochs_1e2lr__nnUNetPlans__3d_fullres_maxnum_512_patch_192/crossval_results_folds_0_1_2_3_4/PETCT_1472967bef_12212002.nii.gz,/well/papiez/users/hri611/python/nnUnet_raw/Dataset219_PETCT/labelsTr/PETCT_1472967bef_12212002.nii.gz,0.8148007650117755,0.0870871467590332,5.1630237007141115
54,0.8985837465933968,3305,1235,0.8158439135196528,52135347,20113,21348,23418,/well/papiez/users/hri611/python/nnUNet_results/Dataset219_PETCT/nnUNetTrainer_1500epochs_1e2lr__nnUNetPlans__3d_fullres_maxnum_512_patch_192/crossval_results_folds_0_1_2_3_4/PETCT_147a9fcff3_08162001.nii.gz,/well/papiez/users/hri611/python/nnUnet_raw/Dataset219_PETCT/labelsTr/PETCT_147a9fcff3_08162001.nii.gz,0.8985837465933968,0.0,3.9935677299499512
55,,0,0,,45440000,0,0,0,/well/papiez/users/hri611/python/nnUNet_results/Dataset219_PETCT/nnUNetTrainer_1500epochs_1e2lr__nnUNetPlans__3d_fullres_maxnum_512_patch_192/crossval_results_folds_0_1_2_3_4/PETCT_14929994cf_04302005.nii.gz,/well/papiez/users/hri611/python/nnUnet_raw/Dataset219_PETCT/labelsTr/PETCT_14929994cf_04302005.nii.gz,,0.0,0.0
56,0.7379480840543882,848,0,0.584720861900098,52157958,1194,1194,2042,/well/papiez/users/hri611/python/nnUNet_results/Dataset219_PETCT/nnUNetTrainer_1500epochs_1e2lr__nnUNetPlans__3d_fullres_maxnum_512_patch_192/crossval_results_folds_0_1_2_3_4/PETCT_14c4d2c208_09222002.nii.gz,/well/papiez/users/hri611/python/nnUnet_raw/Dataset219_PETCT/labelsTr/PETCT_14c4d2c208_09222002.nii.gz,0.7379480840543882,0.0,2.898757884979248
57,0.8500698357655445,2484,629,0.739236052940191,52148062,8825,9454,11309,/well/papiez/users/hri611/python/nnUNet_results/Dataset219_PETCT/nnUNetTrainer_1500epochs_1e2lr__nnUNetPlans__3d_fullres_maxnum_512_patch_192/crossval_results_folds_0_1_2_3_4/PETCT_154e94256c_11252000.nii.gz,/well/papiez/users/hri611/python/nnUnet_raw/Dataset219_PETCT/labelsTr/PETCT_154e94256c_11252000.nii.gz,0.8500698357655445,5.411844120025635,4.491208568572998
58,,0,0,,50400000,0,0,0,/well/papiez/users/hri611/python/nnUNet_results/Dataset219_PETCT/nnUNetTrainer_1500epochs_1e2lr__nnUNetPlans__3d_fullres_maxnum_512_patch_192/crossval_results_folds_0_1_2_3_4/PETCT_1553bd8c8f_06142007.nii.gz,/well/papiez/users/hri611/python/nnUnet_raw/Dataset219_PETCT/labelsTr/PETCT_1553bd8c8f_06142007.nii.gz,,0.0,0.0
59,0.6835126928215717,58578,6563,0.5191942900585313,52184517,70342,76905,128920,/well/papiez/users/hri611/python/nnUNet_results/Dataset219_PETCT/nnUNetTrainer_1500epochs_1e2lr__nnUNetPlans__3d_fullres_maxnum_512_patch_192/crossval_results_folds_0_1_2_3_4/PETCT_15a205ffcc_08192005.nii.gz,/well/papiez/users/hri611/python/nnUnet_raw/Dataset219_PETCT/labelsTr/PETCT_15a205ffcc_08192005.nii.gz,0.6835126928215717,2.625055423736572,67.41789261245728
60,0.9078064545495926,4854,5273,0.8311772746974294,45380014,49859,55132,54713,/well/papiez/users/hri611/python/nnUNet_results/Dataset219_PETCT/nnUNetTrainer_1500epochs_1e2lr__nnUNetPlans__3d_fullres_maxnum_512_patch_192/crossval_results_folds_0_1_2_3_4/PETCT_15cfa01130_02242001.nii.gz,/well/papiez/users/hri611/python/nnUnet_raw/Dataset219_PETCT/labelsTr/PETCT_15cfa01130_02242001.nii.gz,0.9078064545495926,0.4478767547607422,4.976408386230469
61,0.9453456640388114,807,635,0.8963559261122691,45426087,12471,13106,13278,/well/papiez/users/hri611/python/nnUNet_results/Dataset219_PETCT/nnUNetTrainer_1500epochs_1e2lr__nnUNetPlans__3d_fullres_maxnum_512_patch_192/crossval_results_folds_0_1_2_3_4/PETCT_15f4b7254f_07182003.nii.gz,/well/papiez/users/hri611/python/nnUnet_raw/Dataset219_PETCT/labelsTr/PETCT_15f4b7254f_07182003.nii.gz,0.9453456640388114,0.0,2.4882041931152346
62,0.9230769230769231,1,7,0.8571428571428571,45439944,48,55,49,/well/papiez/users/hri611/python/nnUNet_results/Dataset219_PETCT/nnUNetTrainer_1500epochs_1e2lr__nnUNetPlans__3d_fullres_maxnum_512_patch_192/crossval_results_folds_0_1_2_3_4/PETCT_15f4b7254f_10112003.nii.gz,/well/papiez/users/hri611/python/nnUnet_raw/Dataset219_PETCT/labelsTr/PETCT_15f4b7254f_10112003.nii.gz,0.9230769230769231,0.0,0.0
63,0.9174838665227476,13525,847,0.8475475220638153,45505728,79900,80747,93425,/well/papiez/users/hri611/python/nnUNet_results/Dataset219_PETCT/nnUNetTrainer_1500epochs_1e2lr__nnUNetPlans__3d_fullres_maxnum_512_patch_192/crossval_results_folds_0_1_2_3_4/PETCT_16cdbc8689_07152005.nii.gz,/well/papiez/users/hri611/python/nnUnet_raw/Dataset219_PETCT/labelsTr/PETCT_16cdbc8689_07152005.nii.gz,0.9174838665227476,4.752470008850097,2.674819507598877
64,0.0,0,459,0.0,92319541,0,459,0,/well/papiez/users/hri611/python/nnUNet_results/Dataset219_PETCT/nnUNetTrainer_1500epochs_1e2lr__nnUNetPlans__3d_fullres_maxnum_512_patch_192/crossval_results_folds_0_1_2_3_4/PETCT_173b804eda_10112004.nii.gz,/well/papiez/users/hri611/python/nnUnet_raw/Dataset219_PETCT/labelsTr/PETCT_173b804eda_10112004.nii.gz,0.0,5.710428623199463,0.0
65,,0,0,,43840000,0,0,0,/well/papiez/users/hri611/python/nnUNet_results/Dataset219_PETCT/nnUNetTrainer_1500epochs_1e2lr__nnUNetPlans__3d_fullres_maxnum_512_patch_192/crossval_results_folds_0_1_2_3_4/PETCT_176bdc5388_06222006.nii.gz,/well/papiez/users/hri611/python/nnUnet_raw/Dataset219_PETCT/labelsTr/PETCT_176bdc5388_06222006.nii.gz,,0.0,0.0
66,0.0,0,25,0.0,49119975,0,25,0,/well/papiez/users/hri611/python/nnUNet_results/Dataset219_PETCT/nnUNetTrainer_1500epochs_1e2lr__nnUNetPlans__3d_fullres_maxnum_512_patch_192/crossval_results_folds_0_1_2_3_4/PETCT_1774857f8e_11232006.nii.gz,/well/papiez/users/hri611/python/nnUnet_raw/Dataset219_PETCT/labelsTr/PETCT_1774857f8e_11232006.nii.gz,0.0,0.3110255241394043,0.0
67,0.0,0,37,0.0,45439963,0,37,0,/well/papiez/users/hri611/python/nnUNet_results/Dataset219_PETCT/nnUNetTrainer_1500epochs_1e2lr__nnUNetPlans__3d_fullres_maxnum_512_patch_192/crossval_results_folds_0_1_2_3_4/PETCT_1781ba966c_08082002.nii.gz,/well/papiez/users/hri611/python/nnUnet_raw/Dataset219_PETCT/labelsTr/PETCT_1781ba966c_08082002.nii.gz,0.0,0.4603177757263184,0.0
68,,0,0,,38720000,0,0,0,/well/papiez/users/hri611/python/nnUNet_results/Dataset219_PETCT/nnUNetTrainer_1500epochs_1e2lr__nnUNetPlans__3d_fullres_maxnum_512_patch_192/crossval_results_folds_0_1_2_3_4/PETCT_17b46d7275_11132003.nii.gz,/well/papiez/users/hri611/python/nnUnet_raw/Dataset219_PETCT/labelsTr/PETCT_17b46d7275_11132003.nii.gz,,0.0,0.0
69,0.9195147431933991,2466,1309,0.8510201665416947,52134661,21564,22873,24030,/well/papiez/users/hri611/python/nnUNet_results/Dataset219_PETCT/nnUNetTrainer_1500epochs_1e2lr__nnUNetPlans__3d_fullres_maxnum_512_patch_192/crossval_results_folds_0_1_2_3_4/PETCT_17d334cb6c_08282000.nii.gz,/well/papiez/users/hri611/python/nnUnet_raw/Dataset219_PETCT/labelsTr/PETCT_17d334cb6c_08282000.nii.gz,0.9195147431933991,2.9111989059448242,0.0
70,0.0,0,440,0.0,49439560,0,440,0,/well/papiez/users/hri611/python/nnUNet_results/Dataset219_PETCT/nnUNetTrainer_1500epochs_1e2lr__nnUNetPlans__3d_fullres_maxnum_512_patch_192/crossval_results_folds_0_1_2_3_4/PETCT_182bdeba22_05102007.nii.gz,/well/papiez/users/hri611/python/nnUnet_raw/Dataset219_PETCT/labelsTr/PETCT_182bdeba22_05102007.nii.gz,0.0,5.474049224853515,0.0
71,0.0,0,41,0.0,52159959,0,41,0,/well/papiez/users/hri611/python/nnUNet_results/Dataset219_PETCT/nnUNetTrainer_1500epochs_1e2lr__nnUNetPlans__3d_fullres_maxnum_512_patch_192/crossval_results_folds_0_1_2_3_4/PETCT_185bac7954_01222005.nii.gz,/well/papiez/users/hri611/python/nnUnet_raw/Dataset219_PETCT/labelsTr/PETCT_185bac7954_01222005.nii.gz,0.0,0.5100818595886231,0.0
72,0.7886476026660934,73,1893,0.6510472133475328,52154366,3668,5561,3741,/well/papiez/users/hri611/python/nnUNet_results/Dataset219_PETCT/nnUNetTrainer_1500epochs_1e2lr__nnUNetPlans__3d_fullres_maxnum_512_patch_192/crossval_results_folds_0_1_2_3_4/PETCT_185da4c8b6_04182003.nii.gz,/well/papiez/users/hri611/python/nnUnet_raw/Dataset219_PETCT/labelsTr/PETCT_185da4c8b6_04182003.nii.gz,0.7886476026660934,0.0,0.04976408386230469
73,0.9555084745762712,2,40,0.9148073022312373,52319507,451,491,453,/well/papiez/users/hri611/python/nnUNet_results/Dataset219_PETCT/nnUNetTrainer_1500epochs_1e2lr__nnUNetPlans__3d_fullres_maxnum_512_patch_192/crossval_results_folds_0_1_2_3_4/PETCT_18e8b02af3_08142005.nii.gz,/well/papiez/users/hri611/python/nnUnet_raw/Dataset219_PETCT/labelsTr/PETCT_18e8b02af3_08142005.nii.gz,0.9555084745762712,0.0,0.0
74,0.0,0,431,0.0,99039569,0,431,0,/well/papiez/users/hri611/python/nnUNet_results/Dataset219_PETCT/nnUNetTrainer_1500epochs_1e2lr__nnUNetPlans__3d_fullres_maxnum_512_patch_192/crossval_results_folds_0_1_2_3_4/PETCT_1928952a0f_06202003.nii.gz,/well/papiez/users/hri611/python/nnUnet_raw/Dataset219_PETCT/labelsTr/PETCT_1928952a0f_06202003.nii.gz,0.0,5.36208003616333,0.0
75,,0,0,,38720000,0,0,0,/well/papiez/users/hri611/python/nnUNet_results/Dataset219_PETCT/nnUNetTrainer_1500epochs_1e2lr__nnUNetPlans__3d_fullres_maxnum_512_patch_192/crossval_results_folds_0_1_2_3_4/PETCT_193dea6ac7_04102003.nii.gz,/well/papiez/users/hri611/python/nnUnet_raw/Dataset219_PETCT/labelsTr/PETCT_193dea6ac7_04102003.nii.gz,,0.0,0.0
76,,0,0,,45120000,0,0,0,/well/papiez/users/hri611/python/nnUNet_results/Dataset219_PETCT/nnUNetTrainer_1500epochs_1e2lr__nnUNetPlans__3d_fullres_maxnum_512_patch_192/crossval_results_folds_0_1_2_3_4/PETCT_1956667fce_02102006.nii.gz,/well/papiez/users/hri611/python/nnUnet_raw/Dataset219_PETCT/labelsTr/PETCT_1956667fce_02102006.nii.gz,,0.0,0.0
77,0.9254663580849344,1460,9232,0.8612725762922981,47442928,66380,75612,67840,/well/papiez/users/hri611/python/nnUNet_results/Dataset219_PETCT/nnUNetTrainer_1500epochs_1e2lr__nnUNetPlans__3d_fullres_maxnum_512_patch_192/crossval_results_folds_0_1_2_3_4/PETCT_1956667fce_07282005.nii.gz,/well/papiez/users/hri611/python/nnUnet_raw/Dataset219_PETCT/labelsTr/PETCT_1956667fce_07282005.nii.gz,0.9254663580849344,20.614771739959718,2.550409297943115
78,0.49073700264657066,11201,152,0.3251500921357665,52143177,5470,5622,16671,/well/papiez/users/hri611/python/nnUNet_results/Dataset219_PETCT/nnUNetTrainer_1500epochs_1e2lr__nnUNetPlans__3d_fullres_maxnum_512_patch_192/crossval_results_folds_0_1_2_3_4/PETCT_19838cb8e5_07292002.nii.gz,/well/papiez/users/hri611/python/nnUnet_raw/Dataset219_PETCT/labelsTr/PETCT_19838cb8e5_07292002.nii.gz,0.49073700264657066,0.09952816772460937,2.4508811302185056
79,0.6752165838575749,31111,2292,0.5096807339449542,52091875,34722,37014,65833,/well/papiez/users/hri611/python/nnUNet_results/Dataset219_PETCT/nnUNetTrainer_1500epochs_1e2lr__nnUNetPlans__3d_fullres_maxnum_512_patch_192/crossval_results_folds_0_1_2_3_4/PETCT_19b68a666b_04142005.nii.gz,/well/papiez/users/hri611/python/nnUnet_raw/Dataset219_PETCT/labelsTr/PETCT_19b68a666b_04142005.nii.gz,0.6752165838575749,0.9703996353149413,2.1398556060791014
80,0.0,1112,15158,0.0,52143730,0,15158,1112,/well/papiez/users/hri611/python/nnUNet_results/Dataset219_PETCT/nnUNetTrainer_1500epochs_1e2lr__nnUNetPlans__3d_fullres_maxnum_512_patch_192/crossval_results_folds_0_1_2_3_4/PETCT_1a1712f7d0_02142005.nii.gz,/well/papiez/users/hri611/python/nnUnet_raw/Dataset219_PETCT/labelsTr/PETCT_1a1712f7d0_02142005.nii.gz,0.0,188.5809957962036,13.834415313720703
81,0.9416103257529195,63,32,0.8896631823461092,50399139,766,798,829,/well/papiez/users/hri611/python/nnUNet_results/Dataset219_PETCT/nnUNetTrainer_1500epochs_1e2lr__nnUNetPlans__3d_fullres_maxnum_512_patch_192/crossval_results_folds_0_1_2_3_4/PETCT_1a1712f7d0_02162007.nii.gz,/well/papiez/users/hri611/python/nnUnet_raw/Dataset219_PETCT/labelsTr/PETCT_1a1712f7d0_02162007.nii.gz,0.9416103257529195,0.0,0.0
82,0.5320746916557569,1560,5231,0.36246714232069094,52149348,3861,9092,5421,/well/papiez/users/hri611/python/nnUNet_results/Dataset219_PETCT/nnUNetTrainer_1500epochs_1e2lr__nnUNetPlans__3d_fullres_maxnum_512_patch_192/crossval_results_folds_0_1_2_3_4/PETCT_1a1712f7d0_07052001.nii.gz,/well/papiez/users/hri611/python/nnUnet_raw/Dataset219_PETCT/labelsTr/PETCT_1a1712f7d0_07052001.nii.gz,0.5320746916557569,63.33723773574829,4.628059799194336
83,0.0,0,79,0.0,52159921,0,79,0,/well/papiez/users/hri611/python/nnUNet_results/Dataset219_PETCT/nnUNetTrainer_1500epochs_1e2lr__nnUNetPlans__3d_fullres_maxnum_512_patch_192/crossval_results_folds_0_1_2_3_4/PETCT_1a3d4e63ee_07032004.nii.gz,/well/papiez/users/hri611/python/nnUnet_raw/Dataset219_PETCT/labelsTr/PETCT_1a3d4e63ee_07032004.nii.gz,0.0,0.9828406562805175,0.0
84,0.0,0,718,0.0,45119282,0,718,0,/well/papiez/users/hri611/python/nnUNet_results/Dataset219_PETCT/nnUNetTrainer_1500epochs_1e2lr__nnUNetPlans__3d_fullres_maxnum_512_patch_192/crossval_results_folds_0_1_2_3_4/PETCT_1a8bd52f71_05052006.nii.gz,/well/papiez/users/hri611/python/nnUnet_raw/Dataset219_PETCT/labelsTr/PETCT_1a8bd52f71_05052006.nii.gz,0.0,8.93265305328369,0.0
85,0.5856246985045828,153,706,0.4140518417462483,58878534,607,1313,760,/well/papiez/users/hri611/python/nnUNet_results/Dataset219_PETCT/nnUNetTrainer_1500epochs_1e2lr__nnUNetPlans__3d_fullres_maxnum_512_patch_192/crossval_results_folds_0_1_2_3_4/PETCT_1a90052cb2_06222001.nii.gz,/well/papiez/users/hri611/python/nnUnet_raw/Dataset219_PETCT/labelsTr/PETCT_1a90052cb2_06222001.nii.gz,0.5856246985045828,8.435012214660645,0.0
86,0.0,0,552,0.0,52159448,0,552,0,/well/papiez/users/hri611/python/nnUNet_results/Dataset219_PETCT/nnUNetTrainer_1500epochs_1e2lr__nnUNetPlans__3d_fullres_maxnum_512_patch_192/crossval_results_folds_0_1_2_3_4/PETCT_1a90052cb2_09062003.nii.gz,/well/papiez/users/hri611/python/nnUnet_raw/Dataset219_PETCT/labelsTr/PETCT_1a90052cb2_09062003.nii.gz,0.0,6.867443572998047,0.0
87,,0,0,,45440000,0,0,0,/well/papiez/users/hri611/python/nnUNet_results/Dataset219_PETCT/nnUNetTrainer_1500epochs_1e2lr__nnUNetPlans__3d_fullres_maxnum_512_patch_192/crossval_results_folds_0_1_2_3_4/PETCT_1ac497ed9d_10282004.nii.gz,/well/papiez/users/hri611/python/nnUnet_raw/Dataset219_PETCT/labelsTr/PETCT_1ac497ed9d_10282004.nii.gz,,0.0,0.0
88,0.15472779369627507,282,13,0.08385093167701864,58879678,27,40,309,/well/papiez/users/hri611/python/nnUNet_results/Dataset219_PETCT/nnUNetTrainer_1500epochs_1e2lr__nnUNetPlans__3d_fullres_maxnum_512_patch_192/crossval_results_folds_0_1_2_3_4/PETCT_1b199d094d_03162002.nii.gz,/well/papiez/users/hri611/python/nnUnet_raw/Dataset219_PETCT/labelsTr/PETCT_1b199d094d_03162002.nii.gz,0.15472779369627507,0.12441020965576172,3.3590756607055665
89,0.8412151126919029,1237,3138,0.7259458782260085,52144036,11589,14727,12826,/well/papiez/users/hri611/python/nnUNet_results/Dataset219_PETCT/nnUNetTrainer_1500epochs_1e2lr__nnUNetPlans__3d_fullres_maxnum_512_patch_192/crossval_results_folds_0_1_2_3_4/PETCT_1b1bdfc35b_10292000.nii.gz,/well/papiez/users/hri611/python/nnUnet_raw/Dataset219_PETCT/labelsTr/PETCT_1b1bdfc35b_10292000.nii.gz,0.8412151126919029,14.792373928070068,2.5628503189086915
90,0.8164019083121014,9725,1012,0.6897627784680286,52125391,23872,24884,33597,/well/papiez/users/hri611/python/nnUNet_results/Dataset219_PETCT/nnUNetTrainer_1500epochs_1e2lr__nnUNetPlans__3d_fullres_maxnum_512_patch_192/crossval_results_folds_0_1_2_3_4/PETCT_1bb48bfb40_12022000.nii.gz,/well/papiez/users/hri611/python/nnUnet_raw/Dataset219_PETCT/labelsTr/PETCT_1bb48bfb40_12022000.nii.gz,0.8164019083121014,0.4478767547607422,14.207645942687988
91,0.0,0,194,0.0,52159806,0,194,0,/well/papiez/users/hri611/python/nnUNet_results/Dataset219_PETCT/nnUNetTrainer_1500epochs_1e2lr__nnUNetPlans__3d_fullres_maxnum_512_patch_192/crossval_results_folds_0_1_2_3_4/PETCT_1bdefef7d5_01142006.nii.gz,/well/papiez/users/hri611/python/nnUnet_raw/Dataset219_PETCT/labelsTr/PETCT_1bdefef7d5_01142006.nii.gz,0.0,2.413558067321777,0.0
92,,0,0,,52800000,0,0,0,/well/papiez/users/hri611/python/nnUNet_results/Dataset219_PETCT/nnUNetTrainer_1500epochs_1e2lr__nnUNetPlans__3d_fullres_maxnum_512_patch_192/crossval_results_folds_0_1_2_3_4/PETCT_1cb2d26a19_06042007.nii.gz,/well/papiez/users/hri611/python/nnUnet_raw/Dataset219_PETCT/labelsTr/PETCT_1cb2d26a19_06042007.nii.gz,,0.0,0.0
93,,0,0,,47520000,0,0,0,/well/papiez/users/hri611/python/nnUNet_results/Dataset219_PETCT/nnUNetTrainer_1500epochs_1e2lr__nnUNetPlans__3d_fullres_maxnum_512_patch_192/crossval_results_folds_0_1_2_3_4/PETCT_1f2a4f4280_06122005.nii.gz,/well/papiez/users/hri611/python/nnUnet_raw/Dataset219_PETCT/labelsTr/PETCT_1f2a4f4280_06122005.nii.gz,,0.0,0.0
94,,0,0,,52160000,0,0,0,/well/papiez/users/hri611/python/nnUNet_results/Dataset219_PETCT/nnUNetTrainer_1500epochs_1e2lr__nnUNetPlans__3d_fullres_maxnum_512_patch_192/crossval_results_folds_0_1_2_3_4/PETCT_1f2a4f4280_12202002.nii.gz,/well/papiez/users/hri611/python/nnUnet_raw/Dataset219_PETCT/labelsTr/PETCT_1f2a4f4280_12202002.nii.gz,,0.0,0.0
95,0.0,39,0,0.0,105759961,0,0,39,/well/papiez/users/hri611/python/nnUNet_results/Dataset219_PETCT/nnUNetTrainer_1500epochs_1e2lr__nnUNetPlans__3d_fullres_maxnum_512_patch_192/crossval_results_folds_0_1_2_3_4/PETCT_1f65acff65_05062007.nii.gz,/well/papiez/users/hri611/python/nnUnet_raw/Dataset219_PETCT/labelsTr/PETCT_1f65acff65_05062007.nii.gz,0.0,0.0,0.48519981765747067
96,,0,0,,52160000,0,0,0,/well/papiez/users/hri611/python/nnUNet_results/Dataset219_PETCT/nnUNetTrainer_1500epochs_1e2lr__nnUNetPlans__3d_fullres_maxnum_512_patch_192/crossval_results_folds_0_1_2_3_4/PETCT_1fa22c576e_10172004.nii.gz,/well/papiez/users/hri611/python/nnUnet_raw/Dataset219_PETCT/labelsTr/PETCT_1fa22c576e_10172004.nii.gz,,0.0,0.0
97,0.8057445200302343,0,1799,0.6746835443037975,52154470,3731,5530,3731,/well/papiez/users/hri611/python/nnUNet_results/Dataset219_PETCT/nnUNetTrainer_1500epochs_1e2lr__nnUNetPlans__3d_fullres_maxnum_512_patch_192/crossval_results_folds_0_1_2_3_4/PETCT_1fc35d02da_08092003.nii.gz,/well/papiez/users/hri611/python/nnUnet_raw/Dataset219_PETCT/labelsTr/PETCT_1fc35d02da_08092003.nii.gz,0.8057445200302343,0.0,0.0
98,0.9145456596112636,236,2037,0.8425464117484067,58865564,12163,14200,12399,/well/papiez/users/hri611/python/nnUNet_results/Dataset219_PETCT/nnUNetTrainer_1500epochs_1e2lr__nnUNetPlans__3d_fullres_maxnum_512_patch_192/crossval_results_folds_0_1_2_3_4/PETCT_1fcfa34d10_09192003.nii.gz,/well/papiez/users/hri611/python/nnUnet_raw/Dataset219_PETCT/labelsTr/PETCT_1fcfa34d10_09192003.nii.gz,0.9145456596112636,11.968262168884277,0.0
99,0.8573687539531942,1219,5997,0.7503459728757266,52131096,21688,27685,22907,/well/papiez/users/hri611/python/nnUNet_results/Dataset219_PETCT/nnUNetTrainer_1500epochs_1e2lr__nnUNetPlans__3d_fullres_maxnum_512_patch_192/crossval_results_folds_0_1_2_3_4/PETCT_1fe6e48293_06262003.nii.gz,/well/papiez/users/hri611/python/nnUnet_raw/Dataset219_PETCT/labelsTr/PETCT_1fe6e48293_06262003.nii.gz,0.8573687539531942,1.2067790336608886,0.1741742935180664
100,0.8783783783783784,0,180,0.7831325301204819,55199170,650,830,650,/well/papiez/users/hri611/python/nnUNet_results/Dataset219_PETCT/nnUNetTrainer_1500epochs_1e2lr__nnUNetPlans__3d_fullres_maxnum_512_patch_192/crossval_results_folds_0_1_2_3_4/PETCT_20995a0fe1_12022005.nii.gz,/well/papiez/users/hri611/python/nnUnet_raw/Dataset219_PETCT/labelsTr/PETCT_20995a0fe1_12022005.nii.gz,0.8783783783783784,0.0,0.0
101,0.0,0,2480,0.0,45437520,0,2480,0,/well/papiez/users/hri611/python/nnUNet_results/Dataset219_PETCT/nnUNetTrainer_1500epochs_1e2lr__nnUNetPlans__3d_fullres_maxnum_512_patch_192/crossval_results_folds_0_1_2_3_4/PETCT_20f4a3aa02_03172005.nii.gz,/well/papiez/users/hri611/python/nnUnet_raw/Dataset219_PETCT/labelsTr/PETCT_20f4a3aa02_03172005.nii.gz,0.0,30.853731994628905,0.0
102,0.0,0,576,0.0,43519424,0,576,0,/well/papiez/users/hri611/python/nnUNet_results/Dataset219_PETCT/nnUNetTrainer_1500epochs_1e2lr__nnUNetPlans__3d_fullres_maxnum_512_patch_192/crossval_results_folds_0_1_2_3_4/PETCT_2122b88719_09092006.nii.gz,/well/papiez/users/hri611/python/nnUnet_raw/Dataset219_PETCT/labelsTr/PETCT_2122b88719_09092006.nii.gz,0.0,7.166028076171875,0.0
103,0.4744557478057725,55556,909,0.31100752870547754,54638047,25488,26397,81044,/well/papiez/users/hri611/python/nnUNet_results/Dataset219_PETCT/nnUNetTrainer_1500epochs_1e2lr__nnUNetPlans__3d_fullres_maxnum_512_patch_192/crossval_results_folds_0_1_2_3_4/PETCT_2140db0ca5_04132007.nii.gz,/well/papiez/users/hri611/python/nnUnet_raw/Dataset219_PETCT/labelsTr/PETCT_2140db0ca5_04132007.nii.gz,0.4744557478057725,0.48519981765747067,35.855022422790526
104,0.8929121725731896,467,89,0.8065414057063326,52157126,2318,2407,2785,/well/papiez/users/hri611/python/nnUNet_results/Dataset219_PETCT/nnUNetTrainer_1500epochs_1e2lr__nnUNetPlans__3d_fullres_maxnum_512_patch_192/crossval_results_folds_0_1_2_3_4/PETCT_21853fc15b_10122002.nii.gz,/well/papiez/users/hri611/python/nnUnet_raw/Dataset219_PETCT/labelsTr/PETCT_21853fc15b_10122002.nii.gz,0.8929121725731896,0.0,0.012441020965576172
105,0.8430341719864815,4066,950,0.7286595261278805,45421514,13470,14420,17536,/well/papiez/users/hri611/python/nnUNet_results/Dataset219_PETCT/nnUNetTrainer_1500epochs_1e2lr__nnUNetPlans__3d_fullres_maxnum_512_patch_192/crossval_results_folds_0_1_2_3_4/PETCT_21e4ffcb52_05062002.nii.gz,/well/papiez/users/hri611/python/nnUnet_raw/Dataset219_PETCT/labelsTr/PETCT_21e4ffcb52_05062002.nii.gz,0.8430341719864815,2.9485219688415527,6.593741111755371
106,0.7995079950799509,1141,1793,0.6659836065573771,45431216,5850,7643,6991,/well/papiez/users/hri611/python/nnUNet_results/Dataset219_PETCT/nnUNetTrainer_1500epochs_1e2lr__nnUNetPlans__3d_fullres_maxnum_512_patch_192/crossval_results_folds_0_1_2_3_4/PETCT_2202a936e0_05312002.nii.gz,/well/papiez/users/hri611/python/nnUnet_raw/Dataset219_PETCT/labelsTr/PETCT_2202a936e0_05312002.nii.gz,0.7995079950799509,0.4105536918640137,1.6919788513183593
107,0.8239905919247354,1,448,0.7006666666666667,45438500,1051,1499,1052,/well/papiez/users/hri611/python/nnUNet_results/Dataset219_PETCT/nnUNetTrainer_1500epochs_1e2lr__nnUNetPlans__3d_fullres_maxnum_512_patch_192/crossval_results_folds_0_1_2_3_4/PETCT_223f70f0b0_11292003.nii.gz,/well/papiez/users/hri611/python/nnUnet_raw/Dataset219_PETCT/labelsTr/PETCT_223f70f0b0_11292003.nii.gz,0.8239905919247354,0.7091381950378418,0.0
108,0.875058934464875,224,41,0.7778709136630344,45438807,928,969,1152,/well/papiez/users/hri611/python/nnUNet_results/Dataset219_PETCT/nnUNetTrainer_1500epochs_1e2lr__nnUNetPlans__3d_fullres_maxnum_512_patch_192/crossval_results_folds_0_1_2_3_4/PETCT_22d07bdc49_01052003.nii.gz,/well/papiez/users/hri611/python/nnUnet_raw/Dataset219_PETCT/labelsTr/PETCT_22d07bdc49_01052003.nii.gz,0.875058934464875,0.2985845031738281,0.0
109,0.0,0,2,0.0,51839998,0,2,0,/well/papiez/users/hri611/python/nnUNet_results/Dataset219_PETCT/nnUNetTrainer_1500epochs_1e2lr__nnUNetPlans__3d_fullres_maxnum_512_patch_192/crossval_results_folds_0_1_2_3_4/PETCT_234f8427c0_12032005.nii.gz,/well/papiez/users/hri611/python/nnUnet_raw/Dataset219_PETCT/labelsTr/PETCT_234f8427c0_12032005.nii.gz,0.0,0.024882041931152343,0.0
110,0.0,0,21,0.0,45439979,0,21,0,/well/papiez/users/hri611/python/nnUNet_results/Dataset219_PETCT/nnUNetTrainer_1500epochs_1e2lr__nnUNetPlans__3d_fullres_maxnum_512_patch_192/crossval_results_folds_0_1_2_3_4/PETCT_234f8427c0_12092004.nii.gz,/well/papiez/users/hri611/python/nnUnet_raw/Dataset219_PETCT/labelsTr/PETCT_234f8427c0_12092004.nii.gz,0.0,0.26126144027709963,0.0
111,0.4444444444444444,42,68,0.2857142857142857,92319846,44,112,86,/well/papiez/users/hri611/python/nnUNet_results/Dataset219_PETCT/nnUNetTrainer_1500epochs_1e2lr__nnUNetPlans__3d_fullres_maxnum_512_patch_192/crossval_results_folds_0_1_2_3_4/PETCT_23ed525e82_08012003.nii.gz,/well/papiez/users/hri611/python/nnUnet_raw/Dataset219_PETCT/labelsTr/PETCT_23ed525e82_08012003.nii.gz,0.4444444444444444,0.7340202369689941,0.0
112,,0,0,,99520000,0,0,0,/well/papiez/users/hri611/python/nnUNet_results/Dataset219_PETCT/nnUNetTrainer_1500epochs_1e2lr__nnUNetPlans__3d_fullres_maxnum_512_patch_192/crossval_results_folds_0_1_2_3_4/PETCT_2428b44e92_03222007.nii.gz,/well/papiez/users/hri611/python/nnUnet_raw/Dataset219_PETCT/labelsTr/PETCT_2428b44e92_03222007.nii.gz,,0.0,0.0
113,0.11042944785276074,145,0,0.05844155844155844,45439846,9,9,154,/well/papiez/users/hri611/python/nnUNet_results/Dataset219_PETCT/nnUNetTrainer_1500epochs_1e2lr__nnUNetPlans__3d_fullres_maxnum_512_patch_192/crossval_results_folds_0_1_2_3_4/PETCT_245182006a_11042000.nii.gz,/well/papiez/users/hri611/python/nnUnet_raw/Dataset219_PETCT/labelsTr/PETCT_245182006a_11042000.nii.gz,0.11042944785276074,0.0,0.0
114,0.5678098092803198,28533,881,0.39646257386736705,52111264,19322,20203,47855,/well/papiez/users/hri611/python/nnUNet_results/Dataset219_PETCT/nnUNetTrainer_1500epochs_1e2lr__nnUNetPlans__3d_fullres_maxnum_512_patch_192/crossval_results_folds_0_1_2_3_4/PETCT_249c02c01c_03062003.nii.gz,/well/papiez/users/hri611/python/nnUnet_raw/Dataset219_PETCT/labelsTr/PETCT_249c02c01c_03062003.nii.gz,0.5678098092803198,0.0,44.09097830200195
115,,0,0,,45440000,0,0,0,/well/papiez/users/hri611/python/nnUNet_results/Dataset219_PETCT/nnUNetTrainer_1500epochs_1e2lr__nnUNetPlans__3d_fullres_maxnum_512_patch_192/crossval_results_folds_0_1_2_3_4/PETCT_249c02c01c_07262003.nii.gz,/well/papiez/users/hri611/python/nnUnet_raw/Dataset219_PETCT/labelsTr/PETCT_249c02c01c_07262003.nii.gz,,0.0,0.0
116,0.7810140237324703,849,2399,0.6407079646017699,50550960,5792,8191,6641,/well/papiez/users/hri611/python/nnUNet_results/Dataset219_PETCT/nnUNetTrainer_1500epochs_1e2lr__nnUNetPlans__3d_fullres_maxnum_512_patch_192/crossval_results_folds_0_1_2_3_4/PETCT_249dd35d0c_05202005.nii.gz,/well/papiez/users/hri611/python/nnUnet_raw/Dataset219_PETCT/labelsTr/PETCT_249dd35d0c_05202005.nii.gz,0.7810140237324703,5.113259616851806,8.310602005004883
117,0.0,0,47,0.0,72159953,0,47,0,/well/papiez/users/hri611/python/nnUNet_results/Dataset219_PETCT/nnUNetTrainer_1500epochs_1e2lr__nnUNetPlans__3d_fullres_maxnum_512_patch_192/crossval_results_folds_0_1_2_3_4/PETCT_24cb79a92b_04132003.nii.gz,/well/papiez/users/hri611/python/nnUnet_raw/Dataset219_PETCT/labelsTr/PETCT_24cb79a92b_04132003.nii.gz,0.0,0.58472798538208,0.0
118,0.4613532225158032,13772,2333,0.29984349187027215,52136998,6897,9230,20669,/well/papiez/users/hri611/python/nnUNet_results/Dataset219_PETCT/nnUNetTrainer_1500epochs_1e2lr__nnUNetPlans__3d_fullres_maxnum_512_patch_192/crossval_results_folds_0_1_2_3_4/PETCT_25707f94a2_07032003.nii.gz,/well/papiez/users/hri611/python/nnUnet_raw/Dataset219_PETCT/labelsTr/PETCT_25707f94a2_07032003.nii.gz,0.4613532225158032,0.0,170.6783666267395
119,0.0,0,72,0.0,47839928,0,72,0,/well/papiez/users/hri611/python/nnUNet_results/Dataset219_PETCT/nnUNetTrainer_1500epochs_1e2lr__nnUNetPlans__3d_fullres_maxnum_512_patch_192/crossval_results_folds_0_1_2_3_4/PETCT_265c26907a_11102005.nii.gz,/well/papiez/users/hri611/python/nnUnet_raw/Dataset219_PETCT/labelsTr/PETCT_265c26907a_11102005.nii.gz,0.0,0.8957535095214844,0.0
120,0.0,0,491,0.0,58879509,0,491,0,/well/papiez/users/hri611/python/nnUNet_results/Dataset219_PETCT/nnUNetTrainer_1500epochs_1e2lr__nnUNetPlans__3d_fullres_maxnum_512_patch_192/crossval_results_folds_0_1_2_3_4/PETCT_2716c9bfff_10042003.nii.gz,/well/papiez/users/hri611/python/nnUnet_raw/Dataset219_PETCT/labelsTr/PETCT_2716c9bfff_10042003.nii.gz,0.0,6.1085412940979005,0.0
121,,0,0,,58880000,0,0,0,/well/papiez/users/hri611/python/nnUNet_results/Dataset219_PETCT/nnUNetTrainer_1500epochs_1e2lr__nnUNetPlans__3d_fullres_maxnum_512_patch_192/crossval_results_folds_0_1_2_3_4/PETCT_2716c9bfff_10312002.nii.gz,/well/papiez/users/hri611/python/nnUnet_raw/Dataset219_PETCT/labelsTr/PETCT_2716c9bfff_10312002.nii.gz,,0.0,0.0
122,,0,0,,52160000,0,0,0,/well/papiez/users/hri611/python/nnUNet_results/Dataset219_PETCT/nnUNetTrainer_1500epochs_1e2lr__nnUNetPlans__3d_fullres_maxnum_512_patch_192/crossval_results_folds_0_1_2_3_4/PETCT_2716c9bfff_11202004.nii.gz,/well/papiez/users/hri611/python/nnUnet_raw/Dataset219_PETCT/labelsTr/PETCT_2716c9bfff_11202004.nii.gz,,0.0,0.0
123,0.0,0,176,0.0,54559824,0,176,0,/well/papiez/users/hri611/python/nnUNet_results/Dataset219_PETCT/nnUNetTrainer_1500epochs_1e2lr__nnUNetPlans__3d_fullres_maxnum_512_patch_192/crossval_results_folds_0_1_2_3_4/PETCT_274688d0a8_03242007.nii.gz,/well/papiez/users/hri611/python/nnUnet_raw/Dataset219_PETCT/labelsTr/PETCT_274688d0a8_03242007.nii.gz,0.0,2.189619689941406,0.0
124,0.8138434080856677,2103,296,0.6861180164856732,52152357,5244,5540,7347,/well/papiez/users/hri611/python/nnUNet_results/Dataset219_PETCT/nnUNetTrainer_1500epochs_1e2lr__nnUNetPlans__3d_fullres_maxnum_512_patch_192/crossval_results_folds_0_1_2_3_4/PETCT_275fb00a66_05042001.nii.gz,/well/papiez/users/hri611/python/nnUnet_raw/Dataset219_PETCT/labelsTr/PETCT_275fb00a66_05042001.nii.gz,0.8138434080856677,0.0,8.28571996307373
125,0.0,0,110,0.0,46239890,0,110,0,/well/papiez/users/hri611/python/nnUNet_results/Dataset219_PETCT/nnUNetTrainer_1500epochs_1e2lr__nnUNetPlans__3d_fullres_maxnum_512_patch_192/crossval_results_folds_0_1_2_3_4/PETCT_2791a0b3c2_08292005.nii.gz,/well/papiez/users/hri611/python/nnUnet_raw/Dataset219_PETCT/labelsTr/PETCT_2791a0b3c2_08292005.nii.gz,0.0,1.3685123062133788,0.0
126,0.8158757303691037,494,4674,0.6890119147911903,45423382,11450,16124,11944,/well/papiez/users/hri611/python/nnUNet_results/Dataset219_PETCT/nnUNetTrainer_1500epochs_1e2lr__nnUNetPlans__3d_fullres_maxnum_512_patch_192/crossval_results_folds_0_1_2_3_4/PETCT_27ad42f8a9_07142002.nii.gz,/well/papiez/users/hri611/python/nnUnet_raw/Dataset219_PETCT/labelsTr/PETCT_27ad42f8a9_07142002.nii.gz,0.8158757303691037,0.8584304466247559,0.0
127,0.36118247277200854,17526,129,0.22039212222909124,52137354,4991,5120,22517,/well/papiez/users/hri611/python/nnUNet_results/Dataset219_PETCT/nnUNetTrainer_1500epochs_1e2lr__nnUNetPlans__3d_fullres_maxnum_512_patch_192/crossval_results_folds_0_1_2_3_4/PETCT_27d69a8466_12162001.nii.gz,/well/papiez/users/hri611/python/nnUnet_raw/Dataset219_PETCT/labelsTr/PETCT_27d69a8466_12162001.nii.gz,0.36118247277200854,0.0,67.9777385559082
128,,0,0,,52160000,0,0,0,/well/papiez/users/hri611/python/nnUNet_results/Dataset219_PETCT/nnUNetTrainer_1500epochs_1e2lr__nnUNetPlans__3d_fullres_maxnum_512_patch_192/crossval_results_folds_0_1_2_3_4/PETCT_28a0a0a163_10222004.nii.gz,/well/papiez/users/hri611/python/nnUnet_raw/Dataset219_PETCT/labelsTr/PETCT_28a0a0a163_10222004.nii.gz,,0.0,0.0
129,0.0,0,170,0.0,98079830,0,170,0,/well/papiez/users/hri611/python/nnUNet_results/Dataset219_PETCT/nnUNetTrainer_1500epochs_1e2lr__nnUNetPlans__3d_fullres_maxnum_512_patch_192/crossval_results_folds_0_1_2_3_4/PETCT_2946d59a94_11062006.nii.gz,/well/papiez/users/hri611/python/nnUnet_raw/Dataset219_PETCT/labelsTr/PETCT_2946d59a94_11062006.nii.gz,0.0,2.1149735641479492,0.0
130,0.7560833737275812,9,5023,0.607824799314161,52147169,7799,12822,7808,/well/papiez/users/hri611/python/nnUNet_results/Dataset219_PETCT/nnUNetTrainer_1500epochs_1e2lr__nnUNetPlans__3d_fullres_maxnum_512_patch_192/crossval_results_folds_0_1_2_3_4/PETCT_29ab45ef17_06272002.nii.gz,/well/papiez/users/hri611/python/nnUnet_raw/Dataset219_PETCT/labelsTr/PETCT_29ab45ef17_06272002.nii.gz,0.7560833737275812,1.4555994529724121,0.09952816772460937
131,0.0,0,5,0.0,45439995,0,5,0,/well/papiez/users/hri611/python/nnUNet_results/Dataset219_PETCT/nnUNetTrainer_1500epochs_1e2lr__nnUNetPlans__3d_fullres_maxnum_512_patch_192/crossval_results_folds_0_1_2_3_4/PETCT_2a41141775_09242005.nii.gz,/well/papiez/users/hri611/python/nnUnet_raw/Dataset219_PETCT/labelsTr/PETCT_2a41141775_09242005.nii.gz,0.0,0.06220510482788086,0.0
132,0.9565217391304348,2,2,0.9166666666666666,85599952,44,46,46,/well/papiez/users/hri611/python/nnUNet_results/Dataset219_PETCT/nnUNetTrainer_1500epochs_1e2lr__nnUNetPlans__3d_fullres_maxnum_512_patch_192/crossval_results_folds_0_1_2_3_4/PETCT_2a6f4f0753_07312003.nii.gz,/well/papiez/users/hri611/python/nnUnet_raw/Dataset219_PETCT/labelsTr/PETCT_2a6f4f0753_07312003.nii.gz,0.9565217391304348,0.0,0.0
133,0.7643160577740017,1190,197,0.6185368536853685,45436364,2249,2446,3439,/well/papiez/users/hri611/python/nnUNet_results/Dataset219_PETCT/nnUNetTrainer_1500epochs_1e2lr__nnUNetPlans__3d_fullres_maxnum_512_patch_192/crossval_results_folds_0_1_2_3_4/PETCT_2a78eed085_12222001.nii.gz,/well/papiez/users/hri611/python/nnUnet_raw/Dataset219_PETCT/labelsTr/PETCT_2a78eed085_12222001.nii.gz,0.7643160577740017,0.0,13.983707565307617
134,,0,0,,32000000,0,0,0,/well/papiez/users/hri611/python/nnUNet_results/Dataset219_PETCT/nnUNetTrainer_1500epochs_1e2lr__nnUNetPlans__3d_fullres_maxnum_512_patch_192/crossval_results_folds_0_1_2_3_4/PETCT_2ad62beb52_03082003.nii.gz,/well/papiez/users/hri611/python/nnUnet_raw/Dataset219_PETCT/labelsTr/PETCT_2ad62beb52_03082003.nii.gz,,0.0,0.0
135,0.8547848664688428,19,1547,0.7463967611336032,51033825,4609,6156,4628,/well/papiez/users/hri611/python/nnUNet_results/Dataset219_PETCT/nnUNetTrainer_1500epochs_1e2lr__nnUNetPlans__3d_fullres_maxnum_512_patch_192/crossval_results_folds_0_1_2_3_4/PETCT_2b29531d8c_10162005.nii.gz,/well/papiez/users/hri611/python/nnUnet_raw/Dataset219_PETCT/labelsTr/PETCT_2b29531d8c_10162005.nii.gz,0.8547848664688428,2.090091522216797,0.0
136,0.0,0,72,0.0,47839928,0,72,0,/well/papiez/users/hri611/python/nnUNet_results/Dataset219_PETCT/nnUNetTrainer_1500epochs_1e2lr__nnUNetPlans__3d_fullres_maxnum_512_patch_192/crossval_results_folds_0_1_2_3_4/PETCT_2b8064fbe2_06112006.nii.gz,/well/papiez/users/hri611/python/nnUnet_raw/Dataset219_PETCT/labelsTr/PETCT_2b8064fbe2_06112006.nii.gz,0.0,0.8957535095214844,0.0
137,0.9177489177489178,3,16,0.848,43839875,106,122,109,/well/papiez/users/hri611/python/nnUNet_results/Dataset219_PETCT/nnUNetTrainer_1500epochs_1e2lr__nnUNetPlans__3d_fullres_maxnum_512_patch_192/crossval_results_folds_0_1_2_3_4/PETCT_2ce074c2ea_02042006.nii.gz,/well/papiez/users/hri611/python/nnUnet_raw/Dataset219_PETCT/labelsTr/PETCT_2ce074c2ea_02042006.nii.gz,0.9177489177489178,0.06220510482788086,0.0
138,0.7011494252873564,104,0,0.5398230088495575,94079774,122,122,226,/well/papiez/users/hri611/python/nnUNet_results/Dataset219_PETCT/nnUNetTrainer_1500epochs_1e2lr__nnUNetPlans__3d_fullres_maxnum_512_patch_192/crossval_results_folds_0_1_2_3_4/PETCT_2d70838805_04302007.nii.gz,/well/papiez/users/hri611/python/nnUnet_raw/Dataset219_PETCT/labelsTr/PETCT_2d70838805_04302007.nii.gz,0.7011494252873564,0.0,0.0
139,0.3597185576077397,1117,3251,0.2193029490616622,45434405,1227,4478,2344,/well/papiez/users/hri611/python/nnUNet_results/Dataset219_PETCT/nnUNetTrainer_1500epochs_1e2lr__nnUNetPlans__3d_fullres_maxnum_512_patch_192/crossval_results_folds_0_1_2_3_4/PETCT_2dac5ef654_11042000.nii.gz,/well/papiez/users/hri611/python/nnUnet_raw/Dataset219_PETCT/labelsTr/PETCT_2dac5ef654_11042000.nii.gz,0.3597185576077397,40.37111303329468,0.0
140,0.8039118183325046,196,2170,0.6721175166297118,51832784,4850,7020,5046,/well/papiez/users/hri611/python/nnUNet_results/Dataset219_PETCT/nnUNetTrainer_1500epochs_1e2lr__nnUNetPlans__3d_fullres_maxnum_512_patch_192/crossval_results_folds_0_1_2_3_4/PETCT_2dc17aaeaf_07012005.nii.gz,/well/papiez/users/hri611/python/nnUnet_raw/Dataset219_PETCT/labelsTr/PETCT_2dc17aaeaf_07012005.nii.gz,0.8039118183325046,2.60017338180542,0.3110255241394043
141,0.9000461926589205,2028,785,0.8182581728905544,78864522,12665,13450,14693,/well/papiez/users/hri611/python/nnUNet_results/Dataset219_PETCT/nnUNetTrainer_1500epochs_1e2lr__nnUNetPlans__3d_fullres_maxnum_512_patch_192/crossval_results_folds_0_1_2_3_4/PETCT_2e44706eaf_05062005.nii.gz,/well/papiez/users/hri611/python/nnUnet_raw/Dataset219_PETCT/labelsTr/PETCT_2e44706eaf_05062005.nii.gz,0.9000461926589205,6.245392524719239,0.9579586143493652
142,0.07009609949123799,1630,15,0.03632103104862332,45438293,62,77,1692,/well/papiez/users/hri611/python/nnUNet_results/Dataset219_PETCT/nnUNetTrainer_1500epochs_1e2lr__nnUNetPlans__3d_fullres_maxnum_512_patch_192/crossval_results_folds_0_1_2_3_4/PETCT_2e97a9e5c2_06232003.nii.gz,/well/papiez/users/hri611/python/nnUnet_raw/Dataset219_PETCT/labelsTr/PETCT_2e97a9e5c2_06232003.nii.gz,0.07009609949123799,0.1741742935180664,19.85586946105957
143,0.0,0,3,0.0,52159997,0,3,0,/well/papiez/users/hri611/python/nnUNet_results/Dataset219_PETCT/nnUNetTrainer_1500epochs_1e2lr__nnUNetPlans__3d_fullres_maxnum_512_patch_192/crossval_results_folds_0_1_2_3_4/PETCT_2f2ee78c89_05012003.nii.gz,/well/papiez/users/hri611/python/nnUnet_raw/Dataset219_PETCT/labelsTr/PETCT_2f2ee78c89_05012003.nii.gz,0.0,0.037323062896728515,0.0
144,0.8611191553794091,2393,14392,0.7561099648368255,46651178,52037,66429,54430,/well/papiez/users/hri611/python/nnUNet_results/Dataset219_PETCT/nnUNetTrainer_1500epochs_1e2lr__nnUNetPlans__3d_fullres_maxnum_512_patch_192/crossval_results_folds_0_1_2_3_4/PETCT_2f7200f771_11052005.nii.gz,/well/papiez/users/hri611/python/nnUnet_raw/Dataset219_PETCT/labelsTr/PETCT_2f7200f771_11052005.nii.gz,0.8611191553794091,0.3483485870361328,2.413558067321777
145,0.0,0,228,0.0,52319772,0,228,0,/well/papiez/users/hri611/python/nnUNet_results/Dataset219_PETCT/nnUNetTrainer_1500epochs_1e2lr__nnUNetPlans__3d_fullres_maxnum_512_patch_192/crossval_results_folds_0_1_2_3_4/PETCT_302613f9a5_04062007.nii.gz,/well/papiez/users/hri611/python/nnUnet_raw/Dataset219_PETCT/labelsTr/PETCT_302613f9a5_04062007.nii.gz,0.0,2.8365527801513672,0.0
146,0.0,0,541,0.0,99039459,0,541,0,/well/papiez/users/hri611/python/nnUNet_results/Dataset219_PETCT/nnUNetTrainer_1500epochs_1e2lr__nnUNetPlans__3d_fullres_maxnum_512_patch_192/crossval_results_folds_0_1_2_3_4/PETCT_30287f520f_11232003.nii.gz,/well/papiez/users/hri611/python/nnUnet_raw/Dataset219_PETCT/labelsTr/PETCT_30287f520f_11232003.nii.gz,0.0,6.730592342376709,0.0
147,0.7548740861088545,2143,271,0.6062632523242538,52153869,3717,3988,5860,/well/papiez/users/hri611/python/nnUNet_results/Dataset219_PETCT/nnUNetTrainer_1500epochs_1e2lr__nnUNetPlans__3d_fullres_maxnum_512_patch_192/crossval_results_folds_0_1_2_3_4/PETCT_3049d4f1a4_02242002.nii.gz,/well/papiez/users/hri611/python/nnUnet_raw/Dataset219_PETCT/labelsTr/PETCT_3049d4f1a4_02242002.nii.gz,0.7548740861088545,0.0,3.2844295349121095
148,0.8697333170969314,15861,1255,0.7694938993185553,45365746,57138,58393,72999,/well/papiez/users/hri611/python/nnUNet_results/Dataset219_PETCT/nnUNetTrainer_1500epochs_1e2lr__nnUNetPlans__3d_fullres_maxnum_512_patch_192/crossval_results_folds_0_1_2_3_4/PETCT_30c4b7062b_01182001.nii.gz,/well/papiez/users/hri611/python/nnUnet_raw/Dataset219_PETCT/labelsTr/PETCT_30c4b7062b_01182001.nii.gz,0.8697333170969314,7.004294803619385,11.109831722259521
149,0.0,0,292,0.0,99039708,0,292,0,/well/papiez/users/hri611/python/nnUNet_results/Dataset219_PETCT/nnUNetTrainer_1500epochs_1e2lr__nnUNetPlans__3d_fullres_maxnum_512_patch_192/crossval_results_folds_0_1_2_3_4/PETCT_30e2b83b74_04262003.nii.gz,/well/papiez/users/hri611/python/nnUnet_raw/Dataset219_PETCT/labelsTr/PETCT_30e2b83b74_04262003.nii.gz,0.0,3.6327781219482422,0.0
150,,0,0,,92320000,0,0,0,/well/papiez/users/hri611/python/nnUNet_results/Dataset219_PETCT/nnUNetTrainer_1500epochs_1e2lr__nnUNetPlans__3d_fullres_maxnum_512_patch_192/crossval_results_folds_0_1_2_3_4/PETCT_30e2b83b74_07212003.nii.gz,/well/papiez/users/hri611/python/nnUnet_raw/Dataset219_PETCT/labelsTr/PETCT_30e2b83b74_07212003.nii.gz,,0.0,0.0
151,0.0,0,43,0.0,99039957,0,43,0,/well/papiez/users/hri611/python/nnUNet_results/Dataset219_PETCT/nnUNetTrainer_1500epochs_1e2lr__nnUNetPlans__3d_fullres_maxnum_512_patch_192/crossval_results_folds_0_1_2_3_4/PETCT_30e2b83b74_09012002.nii.gz,/well/papiez/users/hri611/python/nnUnet_raw/Dataset219_PETCT/labelsTr/PETCT_30e2b83b74_09012002.nii.gz,0.0,0.5349639015197754,0.0
152,0.9461642954171731,569,184,0.8978290366350068,52152630,6617,6801,7186,/well/papiez/users/hri611/python/nnUNet_results/Dataset219_PETCT/nnUNetTrainer_1500epochs_1e2lr__nnUNetPlans__3d_fullres_maxnum_512_patch_192/crossval_results_folds_0_1_2_3_4/PETCT_31ddf5013a_02222001.nii.gz,/well/papiez/users/hri611/python/nnUnet_raw/Dataset219_PETCT/labelsTr/PETCT_31ddf5013a_02222001.nii.gz,0.9461642954171731,0.0,0.0
153,0.6567185091775256,2470,7330,0.48889120684259935,45420826,9374,16704,11844,/well/papiez/users/hri611/python/nnUNet_results/Dataset219_PETCT/nnUNetTrainer_1500epochs_1e2lr__nnUNetPlans__3d_fullres_maxnum_512_patch_192/crossval_results_folds_0_1_2_3_4/PETCT_321bba14bc_03072002.nii.gz,/well/papiez/users/hri611/python/nnUnet_raw/Dataset219_PETCT/labelsTr/PETCT_321bba14bc_03072002.nii.gz,0.6567185091775256,1.7541839561462402,4.565854694366455
154,,0,0,,45440000,0,0,0,/well/papiez/users/hri611/python/nnUNet_results/Dataset219_PETCT/nnUNetTrainer_1500epochs_1e2lr__nnUNetPlans__3d_fullres_maxnum_512_patch_192/crossval_results_folds_0_1_2_3_4/PETCT_32219760da_03132003.nii.gz,/well/papiez/users/hri611/python/nnUnet_raw/Dataset219_PETCT/labelsTr/PETCT_32219760da_03132003.nii.gz,,0.0,0.0
155,0.8741108476585655,2331,1067,0.7763738071734123,52144805,11797,12864,14128,/well/papiez/users/hri611/python/nnUNet_results/Dataset219_PETCT/nnUNetTrainer_1500epochs_1e2lr__nnUNetPlans__3d_fullres_maxnum_512_patch_192/crossval_results_folds_0_1_2_3_4/PETCT_323cc5aff8_11092001.nii.gz,/well/papiez/users/hri611/python/nnUnet_raw/Dataset219_PETCT/labelsTr/PETCT_323cc5aff8_11092001.nii.gz,0.8741108476585655,3.8691575202941895,0.012441020965576172
156,0.8703296703296703,31,28,0.7704280155642024,99839743,198,226,229,/well/papiez/users/hri611/python/nnUNet_results/Dataset219_PETCT/nnUNetTrainer_1500epochs_1e2lr__nnUNetPlans__3d_fullres_maxnum_512_patch_192/crossval_results_folds_0_1_2_3_4/PETCT_32aa845af1_01262007.nii.gz,/well/papiez/users/hri611/python/nnUnet_raw/Dataset219_PETCT/labelsTr/PETCT_32aa845af1_01262007.nii.gz,0.8703296703296703,0.0,0.0
157,0.914661704107404,247,1037,0.8427434170238824,50871835,6881,7918,7128,/well/papiez/users/hri611/python/nnUNet_results/Dataset219_PETCT/nnUNetTrainer_1500epochs_1e2lr__nnUNetPlans__3d_fullres_maxnum_512_patch_192/crossval_results_folds_0_1_2_3_4/PETCT_32aa845af1_06152007.nii.gz,/well/papiez/users/hri611/python/nnUnet_raw/Dataset219_PETCT/labelsTr/PETCT_32aa845af1_06152007.nii.gz,0.914661704107404,2.239383773803711,1.5426865997314452
158,0.8504663348561586,7740,2505,0.739835953173011,45400621,29134,31639,36874,/well/papiez/users/hri611/python/nnUNet_results/Dataset219_PETCT/nnUNetTrainer_1500epochs_1e2lr__nnUNetPlans__3d_fullres_maxnum_512_patch_192/crossval_results_folds_0_1_2_3_4/PETCT_335a00191d_02162001.nii.gz,/well/papiez/users/hri611/python/nnUnet_raw/Dataset219_PETCT/labelsTr/PETCT_335a00191d_02162001.nii.gz,0.8504663348561586,0.5100818595886231,21.970843025207518
159,0.0,0,85,0.0,49919915,0,85,0,/well/papiez/users/hri611/python/nnUNet_results/Dataset219_PETCT/nnUNetTrainer_1500epochs_1e2lr__nnUNetPlans__3d_fullres_maxnum_512_patch_192/crossval_results_folds_0_1_2_3_4/PETCT_345b11778a_10142005.nii.gz,/well/papiez/users/hri611/python/nnUnet_raw/Dataset219_PETCT/labelsTr/PETCT_345b11778a_10142005.nii.gz,0.0,1.0574867820739746,0.0
160,,0,0,,54240000,0,0,0,/well/papiez/users/hri611/python/nnUNet_results/Dataset219_PETCT/nnUNetTrainer_1500epochs_1e2lr__nnUNetPlans__3d_fullres_maxnum_512_patch_192/crossval_results_folds_0_1_2_3_4/PETCT_3481507253_06172007.nii.gz,/well/papiez/users/hri611/python/nnUnet_raw/Dataset219_PETCT/labelsTr/PETCT_3481507253_06172007.nii.gz,,0.0,0.0
161,0.0,0,211,0.0,55359789,0,211,0,/well/papiez/users/hri611/python/nnUNet_results/Dataset219_PETCT/nnUNetTrainer_1500epochs_1e2lr__nnUNetPlans__3d_fullres_maxnum_512_patch_192/crossval_results_folds_0_1_2_3_4/PETCT_34aa521b46_03302007.nii.gz,/well/papiez/users/hri611/python/nnUnet_raw/Dataset219_PETCT/labelsTr/PETCT_34aa521b46_03302007.nii.gz,0.0,2.625055423736572,0.0
162,,0,0,,52160000,0,0,0,/well/papiez/users/hri611/python/nnUNet_results/Dataset219_PETCT/nnUNetTrainer_1500epochs_1e2lr__nnUNetPlans__3d_fullres_maxnum_512_patch_192/crossval_results_folds_0_1_2_3_4/PETCT_34d3efa936_10222004.nii.gz,/well/papiez/users/hri611/python/nnUnet_raw/Dataset219_PETCT/labelsTr/PETCT_34d3efa936_10222004.nii.gz,,0.0,0.0
163,0.6670635865682305,2641,155,0.5004466678577809,45594403,2801,2956,5442,/well/papiez/users/hri611/python/nnUNet_results/Dataset219_PETCT/nnUNetTrainer_1500epochs_1e2lr__nnUNetPlans__3d_fullres_maxnum_512_patch_192/crossval_results_folds_0_1_2_3_4/PETCT_350e91119a_10232005.nii.gz,/well/papiez/users/hri611/python/nnUnet_raw/Dataset219_PETCT/labelsTr/PETCT_350e91119a_10232005.nii.gz,0.6670635865682305,0.6966971740722656,5.78507474899292
164,0.8657701091093631,654,404,0.7633109619686801,92315530,3412,3816,4066,/well/papiez/users/hri611/python/nnUNet_results/Dataset219_PETCT/nnUNetTrainer_1500epochs_1e2lr__nnUNetPlans__3d_fullres_maxnum_512_patch_192/crossval_results_folds_0_1_2_3_4/PETCT_35c9c85a96_04082005.nii.gz,/well/papiez/users/hri611/python/nnUnet_raw/Dataset219_PETCT/labelsTr/PETCT_35c9c85a96_04082005.nii.gz,0.8657701091093631,0.037323062896728515,1.082368824005127
165,0.8696068066253839,1808,3372,0.7692958624682671,90377547,17273,20645,19081,/well/papiez/users/hri611/python/nnUNet_results/Dataset219_PETCT/nnUNetTrainer_1500epochs_1e2lr__nnUNetPlans__3d_fullres_maxnum_512_patch_192/crossval_results_folds_0_1_2_3_4/PETCT_35c9c85a96_09232005.nii.gz,/well/papiez/users/hri611/python/nnUnet_raw/Dataset219_PETCT/labelsTr/PETCT_35c9c85a96_09232005.nii.gz,0.8696068066253839,0.26126144027709963,5.561136371612549
166,,0,0,,52800000,0,0,0,/well/papiez/users/hri611/python/nnUNet_results/Dataset219_PETCT/nnUNetTrainer_1500epochs_1e2lr__nnUNetPlans__3d_fullres_maxnum_512_patch_192/crossval_results_folds_0_1_2_3_4/PETCT_35de69968e_10272006.nii.gz,/well/papiez/users/hri611/python/nnUnet_raw/Dataset219_PETCT/labelsTr/PETCT_35de69968e_10272006.nii.gz,,0.0,0.0
167,0.4429530201342282,50,33,0.28448275862068967,49919884,33,66,83,/well/papiez/users/hri611/python/nnUNet_results/Dataset219_PETCT/nnUNetTrainer_1500epochs_1e2lr__nnUNetPlans__3d_fullres_maxnum_512_patch_192/crossval_results_folds_0_1_2_3_4/PETCT_36870de2f2_05142006.nii.gz,/well/papiez/users/hri611/python/nnUnet_raw/Dataset219_PETCT/labelsTr/PETCT_36870de2f2_05142006.nii.gz,0.4429530201342282,0.360789608001709,0.0
168,0.09544626593806922,12329,86,0.05011476664116297,52146930,655,741,12984,/well/papiez/users/hri611/python/nnUNet_results/Dataset219_PETCT/nnUNetTrainer_1500epochs_1e2lr__nnUNetPlans__3d_fullres_maxnum_512_patch_192/crossval_results_folds_0_1_2_3_4/PETCT_36bb0257fc_08032003.nii.gz,/well/papiez/users/hri611/python/nnUnet_raw/Dataset219_PETCT/labelsTr/PETCT_36bb0257fc_08032003.nii.gz,0.09544626593806922,0.0,150.4741485786438
169,0.7627915845674696,3195,4269,0.6165425122013871,100940535,12001,16270,15196,/well/papiez/users/hri611/python/nnUNet_results/Dataset219_PETCT/nnUNetTrainer_1500epochs_1e2lr__nnUNetPlans__3d_fullres_maxnum_512_patch_192/crossval_results_folds_0_1_2_3_4/PETCT_36d8219e3f_02092006.nii.gz,/well/papiez/users/hri611/python/nnUnet_raw/Dataset219_PETCT/labelsTr/PETCT_36d8219e3f_02092006.nii.gz,0.7627915845674696,18.97255697250366,5.411844120025635
170,0.8703324405230818,999,647,0.7704323570432356,99032830,5524,6171,6523,/well/papiez/users/hri611/python/nnUNet_results/Dataset219_PETCT/nnUNetTrainer_1500epochs_1e2lr__nnUNetPlans__3d_fullres_maxnum_512_patch_192/crossval_results_folds_0_1_2_3_4/PETCT_3708f576ec_03082002.nii.gz,/well/papiez/users/hri611/python/nnUnet_raw/Dataset219_PETCT/labelsTr/PETCT_3708f576ec_03082002.nii.gz,0.8703324405230818,1.8537121238708496,0.024882041931152343
171,0.0,0,60,0.0,48799940,0,60,0,/well/papiez/users/hri611/python/nnUNet_results/Dataset219_PETCT/nnUNetTrainer_1500epochs_1e2lr__nnUNetPlans__3d_fullres_maxnum_512_patch_192/crossval_results_folds_0_1_2_3_4/PETCT_372746cc99_07152006.nii.gz,/well/papiez/users/hri611/python/nnUnet_raw/Dataset219_PETCT/labelsTr/PETCT_372746cc99_07152006.nii.gz,0.0,0.7464612579345703,0.0
172,0.7818543285740105,712,495,0.641839762611276,45436630,2163,2658,2875,/well/papiez/users/hri611/python/nnUNet_results/Dataset219_PETCT/nnUNetTrainer_1500epochs_1e2lr__nnUNetPlans__3d_fullres_maxnum_512_patch_192/crossval_results_folds_0_1_2_3_4/PETCT_37472e737f_06202003.nii.gz,/well/papiez/users/hri611/python/nnUnet_raw/Dataset219_PETCT/labelsTr/PETCT_37472e737f_06202003.nii.gz,0.7818543285740105,0.024882041931152343,0.0
173,0.8862940187475529,3415,1522,0.7958061047233022,52135822,19241,20763,22656,/well/papiez/users/hri611/python/nnUNet_results/Dataset219_PETCT/nnUNetTrainer_1500epochs_1e2lr__nnUNetPlans__3d_fullres_maxnum_512_patch_192/crossval_results_folds_0_1_2_3_4/PETCT_37952b7ffb_08242002.nii.gz,/well/papiez/users/hri611/python/nnUnet_raw/Dataset219_PETCT/labelsTr/PETCT_37952b7ffb_08242002.nii.gz,0.8862940187475529,0.3856716499328613,4.1553010025024415
174,0.8035143502635763,9468,2273,0.6715620454291149,52124252,24007,26280,33475,/well/papiez/users/hri611/python/nnUNet_results/Dataset219_PETCT/nnUNetTrainer_1500epochs_1e2lr__nnUNetPlans__3d_fullres_maxnum_512_patch_192/crossval_results_folds_0_1_2_3_4/PETCT_380f71df1e_08192001.nii.gz,/well/papiez/users/hri611/python/nnUnet_raw/Dataset219_PETCT/labelsTr/PETCT_380f71df1e_08192001.nii.gz,0.8035143502635763,0.8584304466247559,17.106403827667236
175,0.0,0,45,0.0,52159955,0,45,0,/well/papiez/users/hri611/python/nnUNet_results/Dataset219_PETCT/nnUNetTrainer_1500epochs_1e2lr__nnUNetPlans__3d_fullres_maxnum_512_patch_192/crossval_results_folds_0_1_2_3_4/PETCT_389462c0ac_03032005.nii.gz,/well/papiez/users/hri611/python/nnUnet_raw/Dataset219_PETCT/labelsTr/PETCT_389462c0ac_03032005.nii.gz,0.0,0.5598459434509278,0.0
176,,0,0,,52160000,0,0,0,/well/papiez/users/hri611/python/nnUNet_results/Dataset219_PETCT/nnUNetTrainer_1500epochs_1e2lr__nnUNetPlans__3d_fullres_maxnum_512_patch_192/crossval_results_folds_0_1_2_3_4/PETCT_389462c0ac_04272003.nii.gz,/well/papiez/users/hri611/python/nnUnet_raw/Dataset219_PETCT/labelsTr/PETCT_389462c0ac_04272003.nii.gz,,0.0,0.0
177,0.0,0,85,0.0,56159915,0,85,0,/well/papiez/users/hri611/python/nnUNet_results/Dataset219_PETCT/nnUNetTrainer_1500epochs_1e2lr__nnUNetPlans__3d_fullres_maxnum_512_patch_192/crossval_results_folds_0_1_2_3_4/PETCT_389462c0ac_08292005.nii.gz,/well/papiez/users/hri611/python/nnUnet_raw/Dataset219_PETCT/labelsTr/PETCT_389462c0ac_08292005.nii.gz,0.0,1.0574867820739746,0.0
178,0.0,0,13,0.0,97279987,0,13,0,/well/papiez/users/hri611/python/nnUNet_results/Dataset219_PETCT/nnUNetTrainer_1500epochs_1e2lr__nnUNetPlans__3d_fullres_maxnum_512_patch_192/crossval_results_folds_0_1_2_3_4/PETCT_389c968170_02172006.nii.gz,/well/papiez/users/hri611/python/nnUnet_raw/Dataset219_PETCT/labelsTr/PETCT_389c968170_02172006.nii.gz,0.0,0.16173327255249023,0.0
179,,0,0,,100960000,0,0,0,/well/papiez/users/hri611/python/nnUNet_results/Dataset219_PETCT/nnUNetTrainer_1500epochs_1e2lr__nnUNetPlans__3d_fullres_maxnum_512_patch_192/crossval_results_folds_0_1_2_3_4/PETCT_389c968170_08192005.nii.gz,/well/papiez/users/hri611/python/nnUnet_raw/Dataset219_PETCT/labelsTr/PETCT_389c968170_08192005.nii.gz,,0.0,0.0
180,0.0,0,919,0.0,52799081,0,919,0,/well/papiez/users/hri611/python/nnUNet_results/Dataset219_PETCT/nnUNetTrainer_1500epochs_1e2lr__nnUNetPlans__3d_fullres_maxnum_512_patch_192/crossval_results_folds_0_1_2_3_4/PETCT_38a374d01a_05242007.nii.gz,/well/papiez/users/hri611/python/nnUnet_raw/Dataset219_PETCT/labelsTr/PETCT_38a374d01a_05242007.nii.gz,0.0,11.433298267364501,0.0
181,,0,0,,71520000,0,0,0,/well/papiez/users/hri611/python/nnUNet_results/Dataset219_PETCT/nnUNetTrainer_1500epochs_1e2lr__nnUNetPlans__3d_fullres_maxnum_512_patch_192/crossval_results_folds_0_1_2_3_4/PETCT_390129c0d2_04272007.nii.gz,/well/papiez/users/hri611/python/nnUnet_raw/Dataset219_PETCT/labelsTr/PETCT_390129c0d2_04272007.nii.gz,,0.0,0.0
182,0.7123648970158385,19773,1384,0.5532350705296055,52112644,26199,27583,45972,/well/papiez/users/hri611/python/nnUNet_results/Dataset219_PETCT/nnUNetTrainer_1500epochs_1e2lr__nnUNetPlans__3d_fullres_maxnum_512_patch_192/crossval_results_folds_0_1_2_3_4/PETCT_39159c05c2_02232001.nii.gz,/well/papiez/users/hri611/python/nnUnet_raw/Dataset219_PETCT/labelsTr/PETCT_39159c05c2_02232001.nii.gz,0.7123648970158385,0.012441020965576172,59.54272634124756
183,0.0,0,67,0.0,65439933,0,67,0,/well/papiez/users/hri611/python/nnUNet_results/Dataset219_PETCT/nnUNetTrainer_1500epochs_1e2lr__nnUNetPlans__3d_fullres_maxnum_512_patch_192/crossval_results_folds_0_1_2_3_4/PETCT_39eca178a1_06082003.nii.gz,/well/papiez/users/hri611/python/nnUnet_raw/Dataset219_PETCT/labelsTr/PETCT_39eca178a1_06082003.nii.gz,0.0,0.8335484046936035,0.0
184,,0,0,,49440000,0,0,0,/well/papiez/users/hri611/python/nnUNet_results/Dataset219_PETCT/nnUNetTrainer_1500epochs_1e2lr__nnUNetPlans__3d_fullres_maxnum_512_patch_192/crossval_results_folds_0_1_2_3_4/PETCT_3a40a26443_10022005.nii.gz,/well/papiez/users/hri611/python/nnUnet_raw/Dataset219_PETCT/labelsTr/PETCT_3a40a26443_10022005.nii.gz,,0.0,0.0
185,0.0,0,16,0.0,52159984,0,16,0,/well/papiez/users/hri611/python/nnUNet_results/Dataset219_PETCT/nnUNetTrainer_1500epochs_1e2lr__nnUNetPlans__3d_fullres_maxnum_512_patch_192/crossval_results_folds_0_1_2_3_4/PETCT_3b14690fce_09072002.nii.gz,/well/papiez/users/hri611/python/nnUnet_raw/Dataset219_PETCT/labelsTr/PETCT_3b14690fce_09072002.nii.gz,0.0,0.19905633544921875,0.0
186,0.6515004840271055,18150,3450,0.48312993539124194,58838210,20190,23640,38340,/well/papiez/users/hri611/python/nnUNet_results/Dataset219_PETCT/nnUNetTrainer_1500epochs_1e2lr__nnUNetPlans__3d_fullres_maxnum_512_patch_192/crossval_results_folds_0_1_2_3_4/PETCT_3b1c9155f5_01312003.nii.gz,/well/papiez/users/hri611/python/nnUnet_raw/Dataset219_PETCT/labelsTr/PETCT_3b1c9155f5_01312003.nii.gz,0.6515004840271055,2.2891478576660154,76.47495587539673
187,0.8973068552774756,3649,881,0.8137412112988776,52135679,19791,20672,23440,/well/papiez/users/hri611/python/nnUNet_results/Dataset219_PETCT/nnUNetTrainer_1500epochs_1e2lr__nnUNetPlans__3d_fullres_maxnum_512_patch_192/crossval_results_folds_0_1_2_3_4/PETCT_3b26172779_11102001.nii.gz,/well/papiez/users/hri611/python/nnUnet_raw/Dataset219_PETCT/labelsTr/PETCT_3b26172779_11102001.nii.gz,0.8973068552774756,1.3685123062133788,11.707000728607177
188,0.0,0,19,0.0,45439981,0,19,0,/well/papiez/users/hri611/python/nnUNet_results/Dataset219_PETCT/nnUNetTrainer_1500epochs_1e2lr__nnUNetPlans__3d_fullres_maxnum_512_patch_192/crossval_results_folds_0_1_2_3_4/PETCT_3b2a4af482_01262003.nii.gz,/well/papiez/users/hri611/python/nnUnet_raw/Dataset219_PETCT/labelsTr/PETCT_3b2a4af482_01262003.nii.gz,0.0,0.23637939834594726,0.0
189,0.8946157386102163,748,1542,0.8093255620316403,45427990,9720,11262,10468,/well/papiez/users/hri611/python/nnUNet_results/Dataset219_PETCT/nnUNetTrainer_1500epochs_1e2lr__nnUNetPlans__3d_fullres_maxnum_512_patch_192/crossval_results_folds_0_1_2_3_4/PETCT_3b73c2480a_10192001.nii.gz,/well/papiez/users/hri611/python/nnUnet_raw/Dataset219_PETCT/labelsTr/PETCT_3b73c2480a_10192001.nii.gz,0.8946157386102163,0.0,0.0
190,,0,0,,48480000,0,0,0,/well/papiez/users/hri611/python/nnUNet_results/Dataset219_PETCT/nnUNetTrainer_1500epochs_1e2lr__nnUNetPlans__3d_fullres_maxnum_512_patch_192/crossval_results_folds_0_1_2_3_4/PETCT_3bce0eb7aa_06032007.nii.gz,/well/papiez/users/hri611/python/nnUnet_raw/Dataset219_PETCT/labelsTr/PETCT_3bce0eb7aa_06032007.nii.gz,,0.0,0.0
191,0.9310344827586207,16,12,0.8709677419354839,45439783,189,201,205,/well/papiez/users/hri611/python/nnUNet_results/Dataset219_PETCT/nnUNetTrainer_1500epochs_1e2lr__nnUNetPlans__3d_fullres_maxnum_512_patch_192/crossval_results_folds_0_1_2_3_4/PETCT_3c3050f75e_09052002.nii.gz,/well/papiez/users/hri611/python/nnUnet_raw/Dataset219_PETCT/labelsTr/PETCT_3c3050f75e_09052002.nii.gz,0.9310344827586207,0.0,0.0
192,0.034623614082863255,180,4783,0.017616785431512273,78874948,89,4872,269,/well/papiez/users/hri611/python/nnUNet_results/Dataset219_PETCT/nnUNetTrainer_1500epochs_1e2lr__nnUNetPlans__3d_fullres_maxnum_512_patch_192/crossval_results_folds_0_1_2_3_4/PETCT_3c3ee87fc6_06132003.nii.gz,/well/papiez/users/hri611/python/nnUnet_raw/Dataset219_PETCT/labelsTr/PETCT_3c3ee87fc6_06132003.nii.gz,0.034623614082863255,59.505403278350826,2.027886417388916
193,0.8228973332030869,11104,1587,0.6990871369294606,52117825,29484,31071,40588,/well/papiez/users/hri611/python/nnUNet_results/Dataset219_PETCT/nnUNetTrainer_1500epochs_1e2lr__nnUNetPlans__3d_fullres_maxnum_512_patch_192/crossval_results_folds_0_1_2_3_4/PETCT_3c71e8f518_12112000.nii.gz,/well/papiez/users/hri611/python/nnUnet_raw/Dataset219_PETCT/labelsTr/PETCT_3c71e8f518_12112000.nii.gz,0.8228973332030869,2.8614348220825194,13.22480528640747
194,0.0,0,14,0.0,94719986,0,14,0,/well/papiez/users/hri611/python/nnUNet_results/Dataset219_PETCT/nnUNetTrainer_1500epochs_1e2lr__nnUNetPlans__3d_fullres_maxnum_512_patch_192/crossval_results_folds_0_1_2_3_4/PETCT_3c94a00f90_05112007.nii.gz,/well/papiez/users/hri611/python/nnUnet_raw/Dataset219_PETCT/labelsTr/PETCT_3c94a00f90_05112007.nii.gz,0.0,0.1741742935180664,0.0
195,,0,0,,45440000,0,0,0,/well/papiez/users/hri611/python/nnUNet_results/Dataset219_PETCT/nnUNetTrainer_1500epochs_1e2lr__nnUNetPlans__3d_fullres_maxnum_512_patch_192/crossval_results_folds_0_1_2_3_4/PETCT_3cd49210eb_12292002.nii.gz,/well/papiez/users/hri611/python/nnUnet_raw/Dataset219_PETCT/labelsTr/PETCT_3cd49210eb_12292002.nii.gz,,0.0,0.0
196,0.0,0,101,0.0,52159899,0,101,0,/well/papiez/users/hri611/python/nnUNet_results/Dataset219_PETCT/nnUNetTrainer_1500epochs_1e2lr__nnUNetPlans__3d_fullres_maxnum_512_patch_192/crossval_results_folds_0_1_2_3_4/PETCT_3cf68da275_03202003.nii.gz,/well/papiez/users/hri611/python/nnUnet_raw/Dataset219_PETCT/labelsTr/PETCT_3cf68da275_03202003.nii.gz,0.0,1.2565431175231934,0.0
197,0.8493310063990692,981,3681,0.7381193124368048,52142198,13140,16821,14121,/well/papiez/users/hri611/python/nnUNet_results/Dataset219_PETCT/nnUNetTrainer_1500epochs_1e2lr__nnUNetPlans__3d_fullres_maxnum_512_patch_192/crossval_results_folds_0_1_2_3_4/PETCT_3d6f425a76_01282002.nii.gz,/well/papiez/users/hri611/python/nnUnet_raw/Dataset219_PETCT/labelsTr/PETCT_3d6f425a76_01282002.nii.gz,0.8493310063990692,4.93908532333374,10.94809844970703
198,0.0,0,57,0.0,52159943,0,57,0,/well/papiez/users/hri611/python/nnUNet_results/Dataset219_PETCT/nnUNetTrainer_1500epochs_1e2lr__nnUNetPlans__3d_fullres_maxnum_512_patch_192/crossval_results_folds_0_1_2_3_4/PETCT_3d6f425a76_07222002.nii.gz,/well/papiez/users/hri611/python/nnUnet_raw/Dataset219_PETCT/labelsTr/PETCT_3d6f425a76_07222002.nii.gz,0.0,0.7091381950378418,0.0
199,,0,0,,45440000,0,0,0,/well/papiez/users/hri611/python/nnUNet_results/Dataset219_PETCT/nnUNetTrainer_1500epochs_1e2lr__nnUNetPlans__3d_fullres_maxnum_512_patch_192/crossval_results_folds_0_1_2_3_4/PETCT_3d8b79d739_11282004.nii.gz,/well/papiez/users/hri611/python/nnUnet_raw/Dataset219_PETCT/labelsTr/PETCT_3d8b79d739_11282004.nii.gz,,0.0,0.0
200,0.86691776522285,1801,319,0.7650969529085873,45430975,6905,7224,8706,/well/papiez/users/hri611/python/nnUNet_results/Dataset219_PETCT/nnUNetTrainer_1500epochs_1e2lr__nnUNetPlans__3d_fullres_maxnum_512_patch_192/crossval_results_folds_0_1_2_3_4/PETCT_3eac8f16d4_09302001.nii.gz,/well/papiez/users/hri611/python/nnUnet_raw/Dataset219_PETCT/labelsTr/PETCT_3eac8f16d4_09302001.nii.gz,0.86691776522285,0.0,9.741319416046142
201,0.0,0,26,0.0,52159974,0,26,0,/well/papiez/users/hri611/python/nnUNet_results/Dataset219_PETCT/nnUNetTrainer_1500epochs_1e2lr__nnUNetPlans__3d_fullres_maxnum_512_patch_192/crossval_results_folds_0_1_2_3_4/PETCT_3f2ee0274d_09162002.nii.gz,/well/papiez/users/hri611/python/nnUnet_raw/Dataset219_PETCT/labelsTr/PETCT_3f2ee0274d_09162002.nii.gz,0.0,0.32346654510498046,0.0
202,,0,0,,52160000,0,0,0,/well/papiez/users/hri611/python/nnUNet_results/Dataset219_PETCT/nnUNetTrainer_1500epochs_1e2lr__nnUNetPlans__3d_fullres_maxnum_512_patch_192/crossval_results_folds_0_1_2_3_4/PETCT_3f3df20439_05092005.nii.gz,/well/papiez/users/hri611/python/nnUnet_raw/Dataset219_PETCT/labelsTr/PETCT_3f3df20439_05092005.nii.gz,,0.0,0.0
203,0.721502011622709,1947,3037,0.5643356643356643,45588560,6456,9493,8403,/well/papiez/users/hri611/python/nnUNet_results/Dataset219_PETCT/nnUNetTrainer_1500epochs_1e2lr__nnUNetPlans__3d_fullres_maxnum_512_patch_192/crossval_results_folds_0_1_2_3_4/PETCT_3f5a9f616f_06032007.nii.gz,/well/papiez/users/hri611/python/nnUnet_raw/Dataset219_PETCT/labelsTr/PETCT_3f5a9f616f_06032007.nii.gz,0.721502011622709,0.5722869644165038,7.713432998657226
204,0.7917817924194119,2851,88,0.6553301278292483,45431473,5588,5676,8439,/well/papiez/users/hri611/python/nnUNet_results/Dataset219_PETCT/nnUNetTrainer_1500epochs_1e2lr__nnUNetPlans__3d_fullres_maxnum_512_patch_192/crossval_results_folds_0_1_2_3_4/PETCT_3fd361ec14_10242004.nii.gz,/well/papiez/users/hri611/python/nnUnet_raw/Dataset219_PETCT/labelsTr/PETCT_3fd361ec14_10242004.nii.gz,0.7917817924194119,0.0,1.8412711029052735
205,0.0,0,169,0.0,58879831,0,169,0,/well/papiez/users/hri611/python/nnUNet_results/Dataset219_PETCT/nnUNetTrainer_1500epochs_1e2lr__nnUNetPlans__3d_fullres_maxnum_512_patch_192/crossval_results_folds_0_1_2_3_4/PETCT_402c061122_02222003.nii.gz,/well/papiez/users/hri611/python/nnUnet_raw/Dataset219_PETCT/labelsTr/PETCT_402c061122_02222003.nii.gz,0.0,2.102532543182373,0.0
206,,0,0,,45440000,0,0,0,/well/papiez/users/hri611/python/nnUNet_results/Dataset219_PETCT/nnUNetTrainer_1500epochs_1e2lr__nnUNetPlans__3d_fullres_maxnum_512_patch_192/crossval_results_folds_0_1_2_3_4/PETCT_402c061122_08252003.nii.gz,/well/papiez/users/hri611/python/nnUnet_raw/Dataset219_PETCT/labelsTr/PETCT_402c061122_08252003.nii.gz,,0.0,0.0
207,,0,0,,45120000,0,0,0,/well/papiez/users/hri611/python/nnUNet_results/Dataset219_PETCT/nnUNetTrainer_1500epochs_1e2lr__nnUNetPlans__3d_fullres_maxnum_512_patch_192/crossval_results_folds_0_1_2_3_4/PETCT_404f8c732f_06142007.nii.gz,/well/papiez/users/hri611/python/nnUnet_raw/Dataset219_PETCT/labelsTr/PETCT_404f8c732f_06142007.nii.gz,,0.0,0.0
208,0.0,319,0,0.0,52159681,0,0,319,/well/papiez/users/hri611/python/nnUNet_results/Dataset219_PETCT/nnUNetTrainer_1500epochs_1e2lr__nnUNetPlans__3d_fullres_maxnum_512_patch_192/crossval_results_folds_0_1_2_3_4/PETCT_4076ea9a15_04292005.nii.gz,/well/papiez/users/hri611/python/nnUnet_raw/Dataset219_PETCT/labelsTr/PETCT_4076ea9a15_04292005.nii.gz,0.0,0.0,3.9686856880187986
209,,0,0,,79520000,0,0,0,/well/papiez/users/hri611/python/nnUNet_results/Dataset219_PETCT/nnUNetTrainer_1500epochs_1e2lr__nnUNetPlans__3d_fullres_maxnum_512_patch_192/crossval_results_folds_0_1_2_3_4/PETCT_4095c12e2d_11302006.nii.gz,/well/papiez/users/hri611/python/nnUnet_raw/Dataset219_PETCT/labelsTr/PETCT_4095c12e2d_11302006.nii.gz,,0.0,0.0
210,0.7786259541984732,229,380,0.6375,52158320,1071,1451,1300,/well/papiez/users/hri611/python/nnUNet_results/Dataset219_PETCT/nnUNetTrainer_1500epochs_1e2lr__nnUNetPlans__3d_fullres_maxnum_512_patch_192/crossval_results_folds_0_1_2_3_4/PETCT_40a125468a_07032004.nii.gz,/well/papiez/users/hri611/python/nnUnet_raw/Dataset219_PETCT/labelsTr/PETCT_40a125468a_07032004.nii.gz,0.7786259541984732,3.844275478363037,0.0
211,0.8765657114049715,2426,757,0.7802554366586124,45425515,11302,12059,13728,/well/papiez/users/hri611/python/nnUNet_results/Dataset219_PETCT/nnUNetTrainer_1500epochs_1e2lr__nnUNetPlans__3d_fullres_maxnum_512_patch_192/crossval_results_folds_0_1_2_3_4/PETCT_40f0749cb7_10062001.nii.gz,/well/papiez/users/hri611/python/nnUnet_raw/Dataset219_PETCT/labelsTr/PETCT_40f0749cb7_10062001.nii.gz,0.8765657114049715,0.0,0.3981126708984375
212,0.0,0,107,0.0,52159893,0,107,0,/well/papiez/users/hri611/python/nnUNet_results/Dataset219_PETCT/nnUNetTrainer_1500epochs_1e2lr__nnUNetPlans__3d_fullres_maxnum_512_patch_192/crossval_results_folds_0_1_2_3_4/PETCT_411801de5a_08252002.nii.gz,/well/papiez/users/hri611/python/nnUnet_raw/Dataset219_PETCT/labelsTr/PETCT_411801de5a_08252002.nii.gz,0.0,1.3311892433166503,0.0
213,,0,0,,53600000,0,0,0,/well/papiez/users/hri611/python/nnUNet_results/Dataset219_PETCT/nnUNetTrainer_1500epochs_1e2lr__nnUNetPlans__3d_fullres_maxnum_512_patch_192/crossval_results_folds_0_1_2_3_4/PETCT_416d3b9b78_08142006.nii.gz,/well/papiez/users/hri611/python/nnUnet_raw/Dataset219_PETCT/labelsTr/PETCT_416d3b9b78_08142006.nii.gz,,0.0,0.0
214,,0,0,,93760000,0,0,0,/well/papiez/users/hri611/python/nnUNet_results/Dataset219_PETCT/nnUNetTrainer_1500epochs_1e2lr__nnUNetPlans__3d_fullres_maxnum_512_patch_192/crossval_results_folds_0_1_2_3_4/PETCT_41bd54f97a_03252007.nii.gz,/well/papiez/users/hri611/python/nnUnet_raw/Dataset219_PETCT/labelsTr/PETCT_41bd54f97a_03252007.nii.gz,,0.0,0.0
215,0.0,0,62,0.0,52159938,0,62,0,/well/papiez/users/hri611/python/nnUNet_results/Dataset219_PETCT/nnUNetTrainer_1500epochs_1e2lr__nnUNetPlans__3d_fullres_maxnum_512_patch_192/crossval_results_folds_0_1_2_3_4/PETCT_41f4d41517_11132004.nii.gz,/well/papiez/users/hri611/python/nnUnet_raw/Dataset219_PETCT/labelsTr/PETCT_41f4d41517_11132004.nii.gz,0.0,0.7713432998657226,0.0
216,0.0157600406710727,0,3872,0.007942608250064053,45436097,31,3903,31,/well/papiez/users/hri611/python/nnUNet_results/Dataset219_PETCT/nnUNetTrainer_1500epochs_1e2lr__nnUNetPlans__3d_fullres_maxnum_512_patch_192/crossval_results_folds_0_1_2_3_4/PETCT_41fadf6520_02272003.nii.gz,/well/papiez/users/hri611/python/nnUnet_raw/Dataset219_PETCT/labelsTr/PETCT_41fadf6520_02272003.nii.gz,0.0157600406710727,47.89793071746826,0.0
217,0.8503499382461919,1009,445,0.7396598030438675,92314415,4131,4576,5140,/well/papiez/users/hri611/python/nnUNet_results/Dataset219_PETCT/nnUNetTrainer_1500epochs_1e2lr__nnUNetPlans__3d_fullres_maxnum_512_patch_192/crossval_results_folds_0_1_2_3_4/PETCT_424e9b79c5_05112003.nii.gz,/well/papiez/users/hri611/python/nnUnet_raw/Dataset219_PETCT/labelsTr/PETCT_424e9b79c5_05112003.nii.gz,0.8503499382461919,4.851998176574707,0.012441020965576172
218,0.8547962188129552,2360,1388,0.7464140730717186,52145220,11032,12420,13392,/well/papiez/users/hri611/python/nnUNet_results/Dataset219_PETCT/nnUNetTrainer_1500epochs_1e2lr__nnUNetPlans__3d_fullres_maxnum_512_patch_192/crossval_results_folds_0_1_2_3_4/PETCT_4250de48c8_02122001.nii.gz,/well/papiez/users/hri611/python/nnUnet_raw/Dataset219_PETCT/labelsTr/PETCT_4250de48c8_02122001.nii.gz,0.8547962188129552,0.0,2.17717866897583
219,0.7501684509994759,2976,361,0.6002156463400024,52151653,5010,5371,7986,/well/papiez/users/hri611/python/nnUNet_results/Dataset219_PETCT/nnUNetTrainer_1500epochs_1e2lr__nnUNetPlans__3d_fullres_maxnum_512_patch_192/crossval_results_folds_0_1_2_3_4/PETCT_42e9f16c09_01052003.nii.gz,/well/papiez/users/hri611/python/nnUnet_raw/Dataset219_PETCT/labelsTr/PETCT_42e9f16c09_01052003.nii.gz,0.7501684509994759,0.870871467590332,15.066076389312745
220,0.8427115112731602,7697,2872,0.7281775628825677,45401118,28313,31185,36010,/well/papiez/users/hri611/python/nnUNet_results/Dataset219_PETCT/nnUNetTrainer_1500epochs_1e2lr__nnUNetPlans__3d_fullres_maxnum_512_patch_192/crossval_results_folds_0_1_2_3_4/PETCT_43323b7d42_05272001.nii.gz,/well/papiez/users/hri611/python/nnUnet_raw/Dataset219_PETCT/labelsTr/PETCT_43323b7d42_05272001.nii.gz,0.8427115112731602,0.0,13.672682041168212
221,0.8481960517358748,36,410,0.7364066193853428,50878308,1246,1656,1282,/well/papiez/users/hri611/python/nnUNet_results/Dataset219_PETCT/nnUNetTrainer_1500epochs_1e2lr__nnUNetPlans__3d_fullres_maxnum_512_patch_192/crossval_results_folds_0_1_2_3_4/PETCT_43647ff727_03022006.nii.gz,/well/papiez/users/hri611/python/nnUnet_raw/Dataset219_PETCT/labelsTr/PETCT_43647ff727_03022006.nii.gz,0.8481960517358748,0.24882041931152343,0.0
222,,0,0,,45440000,0,0,0,/well/papiez/users/hri611/python/nnUNet_results/Dataset219_PETCT/nnUNetTrainer_1500epochs_1e2lr__nnUNetPlans__3d_fullres_maxnum_512_patch_192/crossval_results_folds_0_1_2_3_4/PETCT_437d2c96fe_11162003.nii.gz,/well/papiez/users/hri611/python/nnUnet_raw/Dataset219_PETCT/labelsTr/PETCT_437d2c96fe_11162003.nii.gz,,0.0,0.0
223,0.0,0,127,0.0,46399873,0,127,0,/well/papiez/users/hri611/python/nnUNet_results/Dataset219_PETCT/nnUNetTrainer_1500epochs_1e2lr__nnUNetPlans__3d_fullres_maxnum_512_patch_192/crossval_results_folds_0_1_2_3_4/PETCT_43c9c71b31_05142007.nii.gz,/well/papiez/users/hri611/python/nnUnet_raw/Dataset219_PETCT/labelsTr/PETCT_43c9c71b31_05142007.nii.gz,0.0,1.5800096626281739,0.0
224,0.19298245614035087,2,1010,0.10679611650485436,101758867,121,1131,123,/well/papiez/users/hri611/python/nnUNet_results/Dataset219_PETCT/nnUNetTrainer_1500epochs_1e2lr__nnUNetPlans__3d_fullres_maxnum_512_patch_192/crossval_results_folds_0_1_2_3_4/PETCT_4404466919_09102005.nii.gz,/well/papiez/users/hri611/python/nnUnet_raw/Dataset219_PETCT/labelsTr/PETCT_4404466919_09102005.nii.gz,0.19298245614035087,12.391256881713867,0.0
225,0.0,0,60,0.0,45439940,0,60,0,/well/papiez/users/hri611/python/nnUNet_results/Dataset219_PETCT/nnUNetTrainer_1500epochs_1e2lr__nnUNetPlans__3d_fullres_maxnum_512_patch_192/crossval_results_folds_0_1_2_3_4/PETCT_4481687483_10172003.nii.gz,/well/papiez/users/hri611/python/nnUnet_raw/Dataset219_PETCT/labelsTr/PETCT_4481687483_10172003.nii.gz,0.0,0.7464612579345703,0.0
226,,0,0,,87840000,0,0,0,/well/papiez/users/hri611/python/nnUNet_results/Dataset219_PETCT/nnUNetTrainer_1500epochs_1e2lr__nnUNetPlans__3d_fullres_maxnum_512_patch_192/crossval_results_folds_0_1_2_3_4/PETCT_448225c237_01162006.nii.gz,/well/papiez/users/hri611/python/nnUnet_raw/Dataset219_PETCT/labelsTr/PETCT_448225c237_01162006.nii.gz,,0.0,0.0
227,0.9238312428734321,4314,8378,0.858444585717313,45350339,76969,85347,81283,/well/papiez/users/hri611/python/nnUNet_results/Dataset219_PETCT/nnUNetTrainer_1500epochs_1e2lr__nnUNetPlans__3d_fullres_maxnum_512_patch_192/crossval_results_folds_0_1_2_3_4/PETCT_44b08f570e_02102001.nii.gz,/well/papiez/users/hri611/python/nnUnet_raw/Dataset219_PETCT/labelsTr/PETCT_44b08f570e_02102001.nii.gz,0.9238312428734321,1.953240291595459,0.012441020965576172
228,0.0,0,80,0.0,52159920,0,80,0,/well/papiez/users/hri611/python/nnUNet_results/Dataset219_PETCT/nnUNetTrainer_1500epochs_1e2lr__nnUNetPlans__3d_fullres_maxnum_512_patch_192/crossval_results_folds_0_1_2_3_4/PETCT_44b95650c3_10022003.nii.gz,/well/papiez/users/hri611/python/nnUnet_raw/Dataset219_PETCT/labelsTr/PETCT_44b95650c3_10022003.nii.gz,0.0,0.9952816772460937,0.0
229,0.0,0,286,0.0,52159714,0,286,0,/well/papiez/users/hri611/python/nnUNet_results/Dataset219_PETCT/nnUNetTrainer_1500epochs_1e2lr__nnUNetPlans__3d_fullres_maxnum_512_patch_192/crossval_results_folds_0_1_2_3_4/PETCT_44bf7dc508_07252002.nii.gz,/well/papiez/users/hri611/python/nnUnet_raw/Dataset219_PETCT/labelsTr/PETCT_44bf7dc508_07252002.nii.gz,0.0,3.5581319961547853,0.0
230,0.0,0,64,0.0,99039936,0,64,0,/well/papiez/users/hri611/python/nnUNet_results/Dataset219_PETCT/nnUNetTrainer_1500epochs_1e2lr__nnUNetPlans__3d_fullres_maxnum_512_patch_192/crossval_results_folds_0_1_2_3_4/PETCT_44c04dcf65_10032003.nii.gz,/well/papiez/users/hri611/python/nnUnet_raw/Dataset219_PETCT/labelsTr/PETCT_44c04dcf65_10032003.nii.gz,0.0,0.796225341796875,0.0
231,,0,0,,93600000,0,0,0,/well/papiez/users/hri611/python/nnUNet_results/Dataset219_PETCT/nnUNetTrainer_1500epochs_1e2lr__nnUNetPlans__3d_fullres_maxnum_512_patch_192/crossval_results_folds_0_1_2_3_4/PETCT_44cfacfd6e_04152007.nii.gz,/well/papiez/users/hri611/python/nnUnet_raw/Dataset219_PETCT/labelsTr/PETCT_44cfacfd6e_04152007.nii.gz,,0.0,0.0
232,0.0,0,18,0.0,38719982,0,18,0,/well/papiez/users/hri611/python/nnUNet_results/Dataset219_PETCT/nnUNetTrainer_1500epochs_1e2lr__nnUNetPlans__3d_fullres_maxnum_512_patch_192/crossval_results_folds_0_1_2_3_4/PETCT_44d6ba6772_07132003.nii.gz,/well/papiez/users/hri611/python/nnUnet_raw/Dataset219_PETCT/labelsTr/PETCT_44d6ba6772_07132003.nii.gz,0.0,0.2239383773803711,0.0
233,0.9444796284568292,12,251,0.8948,52157500,2237,2488,2249,/well/papiez/users/hri611/python/nnUNet_results/Dataset219_PETCT/nnUNetTrainer_1500epochs_1e2lr__nnUNetPlans__3d_fullres_maxnum_512_patch_192/crossval_results_folds_0_1_2_3_4/PETCT_456d14846b_09012003.nii.gz,/well/papiez/users/hri611/python/nnUnet_raw/Dataset219_PETCT/labelsTr/PETCT_456d14846b_09012003.nii.gz,0.9444796284568292,0.8957535095214844,0.0
234,0.5954198473282443,82,24,0.42391304347826086,52479816,78,102,160,/well/papiez/users/hri611/python/nnUNet_results/Dataset219_PETCT/nnUNetTrainer_1500epochs_1e2lr__nnUNetPlans__3d_fullres_maxnum_512_patch_192/crossval_results_folds_0_1_2_3_4/PETCT_456e6f9dc2_07282005.nii.gz,/well/papiez/users/hri611/python/nnUnet_raw/Dataset219_PETCT/labelsTr/PETCT_456e6f9dc2_07282005.nii.gz,0.5954198473282443,0.2985845031738281,0.0
235,0.7596999482669425,1777,81,0.6125130344108446,45435205,2937,3018,4714,/well/papiez/users/hri611/python/nnUNet_results/Dataset219_PETCT/nnUNetTrainer_1500epochs_1e2lr__nnUNetPlans__3d_fullres_maxnum_512_patch_192/crossval_results_folds_0_1_2_3_4/PETCT_465176d213_05162002.nii.gz,/well/papiez/users/hri611/python/nnUnet_raw/Dataset219_PETCT/labelsTr/PETCT_465176d213_05162002.nii.gz,0.7596999482669425,0.3856716499328613,0.0
236,0.8588110403397028,68,198,0.7525581395348837,48638925,809,1007,877,/well/papiez/users/hri611/python/nnUNet_results/Dataset219_PETCT/nnUNetTrainer_1500epochs_1e2lr__nnUNetPlans__3d_fullres_maxnum_512_patch_192/crossval_results_folds_0_1_2_3_4/PETCT_46ee4ddd68_03192007.nii.gz,/well/papiez/users/hri611/python/nnUnet_raw/Dataset219_PETCT/labelsTr/PETCT_46ee4ddd68_03192007.nii.gz,0.8588110403397028,0.024882041931152343,0.18661531448364257
237,,0,0,,45440000,0,0,0,/well/papiez/users/hri611/python/nnUNet_results/Dataset219_PETCT/nnUNetTrainer_1500epochs_1e2lr__nnUNetPlans__3d_fullres_maxnum_512_patch_192/crossval_results_folds_0_1_2_3_4/PETCT_474d7af918_12092004.nii.gz,/well/papiez/users/hri611/python/nnUnet_raw/Dataset219_PETCT/labelsTr/PETCT_474d7af918_12092004.nii.gz,,0.0,0.0
238,0.9538273165336915,1774,564,0.9117302827802318,103813513,24149,24713,25923,/well/papiez/users/hri611/python/nnUNet_results/Dataset219_PETCT/nnUNetTrainer_1500epochs_1e2lr__nnUNetPlans__3d_fullres_maxnum_512_patch_192/crossval_results_folds_0_1_2_3_4/PETCT_4776e75543_04012007.nii.gz,/well/papiez/users/hri611/python/nnUnet_raw/Dataset219_PETCT/labelsTr/PETCT_4776e75543_04012007.nii.gz,0.9538273165336915,0.1368512306213379,0.0
239,0.0,0,1585,0.0,51838415,0,1585,0,/well/papiez/users/hri611/python/nnUNet_results/Dataset219_PETCT/nnUNetTrainer_1500epochs_1e2lr__nnUNetPlans__3d_fullres_maxnum_512_patch_192/crossval_results_folds_0_1_2_3_4/PETCT_4785066413_08242006.nii.gz,/well/papiez/users/hri611/python/nnUnet_raw/Dataset219_PETCT/labelsTr/PETCT_4785066413_08242006.nii.gz,0.0,19.71901823043823,0.0
240,0.31546851178609125,10944,730,0.18727373990531884,52145636,2690,3420,13634,/well/papiez/users/hri611/python/nnUNet_results/Dataset219_PETCT/nnUNetTrainer_1500epochs_1e2lr__nnUNetPlans__3d_fullres_maxnum_512_patch_192/crossval_results_folds_0_1_2_3_4/PETCT_47cd731006_01252002.nii.gz,/well/papiez/users/hri611/python/nnUnet_raw/Dataset219_PETCT/labelsTr/PETCT_47cd731006_01252002.nii.gz,0.31546851178609125,1.3933943481445312,132.17340673828124
241,,0,0,,50400000,0,0,0,/well/papiez/users/hri611/python/nnUNet_results/Dataset219_PETCT/nnUNetTrainer_1500epochs_1e2lr__nnUNetPlans__3d_fullres_maxnum_512_patch_192/crossval_results_folds_0_1_2_3_4/PETCT_47f4460050_08062006.nii.gz,/well/papiez/users/hri611/python/nnUnet_raw/Dataset219_PETCT/labelsTr/PETCT_47f4460050_08062006.nii.gz,,0.0,0.0
242,0.8784844834032653,665,5185,0.7833012298118239,52133004,21146,26331,21811,/well/papiez/users/hri611/python/nnUNet_results/Dataset219_PETCT/nnUNetTrainer_1500epochs_1e2lr__nnUNetPlans__3d_fullres_maxnum_512_patch_192/crossval_results_folds_0_1_2_3_4/PETCT_4848bebb10_02232003.nii.gz,/well/papiez/users/hri611/python/nnUnet_raw/Dataset219_PETCT/labelsTr/PETCT_4848bebb10_02232003.nii.gz,0.8784844834032653,1.16945597076416,0.7340202369689941
243,0.0,0,347,0.0,52159653,0,347,0,/well/papiez/users/hri611/python/nnUNet_results/Dataset219_PETCT/nnUNetTrainer_1500epochs_1e2lr__nnUNetPlans__3d_fullres_maxnum_512_patch_192/crossval_results_folds_0_1_2_3_4/PETCT_48a34ccdf0_02152003.nii.gz,/well/papiez/users/hri611/python/nnUnet_raw/Dataset219_PETCT/labelsTr/PETCT_48a34ccdf0_02152003.nii.gz,0.0,4.317034275054931,0.0
244,,0,0,,58400000,0,0,0,/well/papiez/users/hri611/python/nnUNet_results/Dataset219_PETCT/nnUNetTrainer_1500epochs_1e2lr__nnUNetPlans__3d_fullres_maxnum_512_patch_192/crossval_results_folds_0_1_2_3_4/PETCT_48c70dc4a3_04132007.nii.gz,/well/papiez/users/hri611/python/nnUnet_raw/Dataset219_PETCT/labelsTr/PETCT_48c70dc4a3_04132007.nii.gz,,0.0,0.0
245,,0,0,,44960000,0,0,0,/well/papiez/users/hri611/python/nnUNet_results/Dataset219_PETCT/nnUNetTrainer_1500epochs_1e2lr__nnUNetPlans__3d_fullres_maxnum_512_patch_192/crossval_results_folds_0_1_2_3_4/PETCT_48c70dc4a3_10202006.nii.gz,/well/papiez/users/hri611/python/nnUnet_raw/Dataset219_PETCT/labelsTr/PETCT_48c70dc4a3_10202006.nii.gz,,0.0,0.0
246,0.821393105405022,1135,124,0.6969186326432354,92315846,2895,3019,4030,/well/papiez/users/hri611/python/nnUNet_results/Dataset219_PETCT/nnUNetTrainer_1500epochs_1e2lr__nnUNetPlans__3d_fullres_maxnum_512_patch_192/crossval_results_folds_0_1_2_3_4/PETCT_48cb8662f7_03072003.nii.gz,/well/papiez/users/hri611/python/nnUnet_raw/Dataset219_PETCT/labelsTr/PETCT_48cb8662f7_03072003.nii.gz,0.821393105405022,0.16173327255249023,3.0729321784973145
247,,0,0,,49120000,0,0,0,/well/papiez/users/hri611/python/nnUNet_results/Dataset219_PETCT/nnUNetTrainer_1500epochs_1e2lr__nnUNetPlans__3d_fullres_maxnum_512_patch_192/crossval_results_folds_0_1_2_3_4/PETCT_48d5467561_01272006.nii.gz,/well/papiez/users/hri611/python/nnUnet_raw/Dataset219_PETCT/labelsTr/PETCT_48d5467561_01272006.nii.gz,,0.0,0.0
248,0.0,0,45,0.0,51039955,0,45,0,/well/papiez/users/hri611/python/nnUNet_results/Dataset219_PETCT/nnUNetTrainer_1500epochs_1e2lr__nnUNetPlans__3d_fullres_maxnum_512_patch_192/crossval_results_folds_0_1_2_3_4/PETCT_48d5467561_10282005.nii.gz,/well/papiez/users/hri611/python/nnUnet_raw/Dataset219_PETCT/labelsTr/PETCT_48d5467561_10282005.nii.gz,0.0,0.5598459434509278,0.0
249,0.8956178551986935,8184,1020,0.8109673444239064,52111310,39486,40506,47670,/well/papiez/users/hri611/python/nnUNet_results/Dataset219_PETCT/nnUNetTrainer_1500epochs_1e2lr__nnUNetPlans__3d_fullres_maxnum_512_patch_192/crossval_results_folds_0_1_2_3_4/PETCT_49479d6e64_06072002.nii.gz,/well/papiez/users/hri611/python/nnUnet_raw/Dataset219_PETCT/labelsTr/PETCT_49479d6e64_06072002.nii.gz,0.8956178551986935,3.545690975189209,0.0
250,0.6713225665648188,703,50,0.5052562417871223,52158478,769,819,1472,/well/papiez/users/hri611/python/nnUNet_results/Dataset219_PETCT/nnUNetTrainer_1500epochs_1e2lr__nnUNetPlans__3d_fullres_maxnum_512_patch_192/crossval_results_folds_0_1_2_3_4/PETCT_49f3d297b0_07242003.nii.gz,/well/papiez/users/hri611/python/nnUnet_raw/Dataset219_PETCT/labelsTr/PETCT_49f3d297b0_07242003.nii.gz,0.6713225665648188,0.0,0.8957535095214844
251,,0,0,,36160000,0,0,0,/well/papiez/users/hri611/python/nnUNet_results/Dataset219_PETCT/nnUNetTrainer_1500epochs_1e2lr__nnUNetPlans__3d_fullres_maxnum_512_patch_192/crossval_results_folds_0_1_2_3_4/PETCT_4a0d2e5166_11242006.nii.gz,/well/papiez/users/hri611/python/nnUnet_raw/Dataset219_PETCT/labelsTr/PETCT_4a0d2e5166_11242006.nii.gz,,0.0,0.0
252,0.49702734839476814,1045,224,0.33069620253164556,45438104,627,851,1672,/well/papiez/users/hri611/python/nnUNet_results/Dataset219_PETCT/nnUNetTrainer_1500epochs_1e2lr__nnUNetPlans__3d_fullres_maxnum_512_patch_192/crossval_results_folds_0_1_2_3_4/PETCT_4a255db7bd_05242003.nii.gz,/well/papiez/users/hri611/python/nnUnet_raw/Dataset219_PETCT/labelsTr/PETCT_4a255db7bd_05242003.nii.gz,0.49702734839476814,1.0699278030395507,1.953240291595459
253,0.33571838331160364,1394,125982,0.2017196969222188,52000437,32187,158169,33581,/well/papiez/users/hri611/python/nnUNet_results/Dataset219_PETCT/nnUNetTrainer_1500epochs_1e2lr__nnUNetPlans__3d_fullres_maxnum_512_patch_192/crossval_results_folds_0_1_2_3_4/PETCT_4b688f46b0_02182005.nii.gz,/well/papiez/users/hri611/python/nnUnet_raw/Dataset219_PETCT/labelsTr/PETCT_4b688f46b0_02182005.nii.gz,0.33571838331160364,0.6469330902099609,0.6344920692443847
254,,0,0,,44960000,0,0,0,/well/papiez/users/hri611/python/nnUNet_results/Dataset219_PETCT/nnUNetTrainer_1500epochs_1e2lr__nnUNetPlans__3d_fullres_maxnum_512_patch_192/crossval_results_folds_0_1_2_3_4/PETCT_4bab91dccd_01052006.nii.gz,/well/papiez/users/hri611/python/nnUnet_raw/Dataset219_PETCT/labelsTr/PETCT_4bab91dccd_01052006.nii.gz,,0.0,0.0
255,0.745431518002533,1145,262,0.594173637150274,45436533,2060,2322,3205,/well/papiez/users/hri611/python/nnUNet_results/Dataset219_PETCT/nnUNetTrainer_1500epochs_1e2lr__nnUNetPlans__3d_fullres_maxnum_512_patch_192/crossval_results_folds_0_1_2_3_4/PETCT_4be28f9cd7_02032002.nii.gz,/well/papiez/users/hri611/python/nnUnet_raw/Dataset219_PETCT/labelsTr/PETCT_4be28f9cd7_02032002.nii.gz,0.745431518002533,2.3762350044250486,0.6966971740722656
256,0.7764177302625438,31836,4093,0.6345447702745314,98941687,62384,66477,94220,/well/papiez/users/hri611/python/nnUNet_results/Dataset219_PETCT/nnUNetTrainer_1500epochs_1e2lr__nnUNetPlans__3d_fullres_maxnum_512_patch_192/crossval_results_folds_0_1_2_3_4/PETCT_4c670a5445_06222001.nii.gz,/well/papiez/users/hri611/python/nnUnet_raw/Dataset219_PETCT/labelsTr/PETCT_4c670a5445_06222001.nii.gz,0.7764177302625438,1.8039480400085448,0.0
257,0.4518855216784249,83003,6110,0.29189412540624726,52034153,36734,42844,119737,/well/papiez/users/hri611/python/nnUNet_results/Dataset219_PETCT/nnUNetTrainer_1500epochs_1e2lr__nnUNetPlans__3d_fullres_maxnum_512_patch_192/crossval_results_folds_0_1_2_3_4/PETCT_4c75fa4a5d_04192001.nii.gz,/well/papiez/users/hri611/python/nnUnet_raw/Dataset219_PETCT/labelsTr/PETCT_4c75fa4a5d_04192001.nii.gz,0.4518855216784249,0.0,510.28091592407225
258,0.8797765984453766,6652,3293,0.7853581680443744,52113667,36388,39681,43040,/well/papiez/users/hri611/python/nnUNet_results/Dataset219_PETCT/nnUNetTrainer_1500epochs_1e2lr__nnUNetPlans__3d_fullres_maxnum_512_patch_192/crossval_results_folds_0_1_2_3_4/PETCT_4c9e7be363_09172000.nii.gz,/well/papiez/users/hri611/python/nnUnet_raw/Dataset219_PETCT/labelsTr/PETCT_4c9e7be363_09172000.nii.gz,0.8797765984453766,2.189619689941406,0.4478767547607422
259,0.0,54,140,0.0,85599806,0,140,54,/well/papiez/users/hri611/python/nnUNet_results/Dataset219_PETCT/nnUNetTrainer_1500epochs_1e2lr__nnUNetPlans__3d_fullres_maxnum_512_patch_192/crossval_results_folds_0_1_2_3_4/PETCT_4cb875dc0b_01132005.nii.gz,/well/papiez/users/hri611/python/nnUnet_raw/Dataset219_PETCT/labelsTr/PETCT_4cb875dc0b_01132005.nii.gz,0.0,1.741742935180664,0.6718151321411132
260,,0,0,,48160000,0,0,0,/well/papiez/users/hri611/python/nnUNet_results/Dataset219_PETCT/nnUNetTrainer_1500epochs_1e2lr__nnUNetPlans__3d_fullres_maxnum_512_patch_192/crossval_results_folds_0_1_2_3_4/PETCT_4cc808d16f_06112006.nii.gz,/well/papiez/users/hri611/python/nnUnet_raw/Dataset219_PETCT/labelsTr/PETCT_4cc808d16f_06112006.nii.gz,,0.0,0.0
261,0.5614639968173982,3271,36,0.3903023598820059,45434576,2117,2153,5388,/well/papiez/users/hri611/python/nnUNet_results/Dataset219_PETCT/nnUNetTrainer_1500epochs_1e2lr__nnUNetPlans__3d_fullres_maxnum_512_patch_192/crossval_results_folds_0_1_2_3_4/PETCT_4dcf62f869_11032000.nii.gz,/well/papiez/users/hri611/python/nnUnet_raw/Dataset219_PETCT/labelsTr/PETCT_4dcf62f869_11032000.nii.gz,0.5614639968173982,0.12441020965576172,20.166894985198976
262,,0,0,,52160000,0,0,0,/well/papiez/users/hri611/python/nnUNet_results/Dataset219_PETCT/nnUNetTrainer_1500epochs_1e2lr__nnUNetPlans__3d_fullres_maxnum_512_patch_192/crossval_results_folds_0_1_2_3_4/PETCT_4ea806706c_10302003.nii.gz,/well/papiez/users/hri611/python/nnUnet_raw/Dataset219_PETCT/labelsTr/PETCT_4ea806706c_10302003.nii.gz,,0.0,0.0
263,,0,0,,38720000,0,0,0,/well/papiez/users/hri611/python/nnUNet_results/Dataset219_PETCT/nnUNetTrainer_1500epochs_1e2lr__nnUNetPlans__3d_fullres_maxnum_512_patch_192/crossval_results_folds_0_1_2_3_4/PETCT_4ef69de4e1_10252002.nii.gz,/well/papiez/users/hri611/python/nnUnet_raw/Dataset219_PETCT/labelsTr/PETCT_4ef69de4e1_10252002.nii.gz,,0.0,0.0
264,0.0,0,372,0.0,89439628,0,372,0,/well/papiez/users/hri611/python/nnUNet_results/Dataset219_PETCT/nnUNetTrainer_1500epochs_1e2lr__nnUNetPlans__3d_fullres_maxnum_512_patch_192/crossval_results_folds_0_1_2_3_4/PETCT_4f6ff86453_08252006.nii.gz,/well/papiez/users/hri611/python/nnUnet_raw/Dataset219_PETCT/labelsTr/PETCT_4f6ff86453_08252006.nii.gz,0.0,4.628059799194336,0.0
265,0.6843860535624052,16153,2585,0.5202027961284376,52120946,20316,22901,36469,/well/papiez/users/hri611/python/nnUNet_results/Dataset219_PETCT/nnUNetTrainer_1500epochs_1e2lr__nnUNetPlans__3d_fullres_maxnum_512_patch_192/crossval_results_folds_0_1_2_3_4/PETCT_4f7a8f41c0_05272001.nii.gz,/well/papiez/users/hri611/python/nnUnet_raw/Dataset219_PETCT/labelsTr/PETCT_4f7a8f41c0_05272001.nii.gz,0.6843860535624052,0.0,52.637959705352785
266,0.0,0,40,0.0,42399960,0,40,0,/well/papiez/users/hri611/python/nnUNet_results/Dataset219_PETCT/nnUNetTrainer_1500epochs_1e2lr__nnUNetPlans__3d_fullres_maxnum_512_patch_192/crossval_results_folds_0_1_2_3_4/PETCT_4fb1817df3_06062005.nii.gz,/well/papiez/users/hri611/python/nnUnet_raw/Dataset219_PETCT/labelsTr/PETCT_4fb1817df3_06062005.nii.gz,0.0,0.49764083862304687,0.0
267,,0,0,,45440000,0,0,0,/well/papiez/users/hri611/python/nnUNet_results/Dataset219_PETCT/nnUNetTrainer_1500epochs_1e2lr__nnUNetPlans__3d_fullres_maxnum_512_patch_192/crossval_results_folds_0_1_2_3_4/PETCT_5001354a69_11282002.nii.gz,/well/papiez/users/hri611/python/nnUnet_raw/Dataset219_PETCT/labelsTr/PETCT_5001354a69_11282002.nii.gz,,0.0,0.0
268,0.51953125,157,89,0.35092348284960423,52159621,133,222,290,/well/papiez/users/hri611/python/nnUNet_results/Dataset219_PETCT/nnUNetTrainer_1500epochs_1e2lr__nnUNetPlans__3d_fullres_maxnum_512_patch_192/crossval_results_folds_0_1_2_3_4/PETCT_5060603ba4_09192003.nii.gz,/well/papiez/users/hri611/python/nnUnet_raw/Dataset219_PETCT/labelsTr/PETCT_5060603ba4_09192003.nii.gz,0.51953125,0.9952816772460937,1.953240291595459
269,0.0,0,62,0.0,52159938,0,62,0,/well/papiez/users/hri611/python/nnUNet_results/Dataset219_PETCT/nnUNetTrainer_1500epochs_1e2lr__nnUNetPlans__3d_fullres_maxnum_512_patch_192/crossval_results_folds_0_1_2_3_4/PETCT_5109748328_08032002.nii.gz,/well/papiez/users/hri611/python/nnUnet_raw/Dataset219_PETCT/labelsTr/PETCT_5109748328_08032002.nii.gz,0.0,0.7713432998657226,0.0
270,0.9570638582649431,2004,1653,0.9176629517055049,45395585,40758,42411,42762,/well/papiez/users/hri611/python/nnUNet_results/Dataset219_PETCT/nnUNetTrainer_1500epochs_1e2lr__nnUNetPlans__3d_fullres_maxnum_512_patch_192/crossval_results_folds_0_1_2_3_4/PETCT_510fb36781_02062003.nii.gz,/well/papiez/users/hri611/python/nnUnet_raw/Dataset219_PETCT/labelsTr/PETCT_510fb36781_02062003.nii.gz,0.9570638582649431,0.037323062896728515,0.0
271,0.0,0,181,0.0,43679819,0,181,0,/well/papiez/users/hri611/python/nnUNet_results/Dataset219_PETCT/nnUNetTrainer_1500epochs_1e2lr__nnUNetPlans__3d_fullres_maxnum_512_patch_192/crossval_results_folds_0_1_2_3_4/PETCT_515c40c4a6_07242006.nii.gz,/well/papiez/users/hri611/python/nnUnet_raw/Dataset219_PETCT/labelsTr/PETCT_515c40c4a6_07242006.nii.gz,0.0,2.251824794769287,0.0
272,0.7005215192540695,4960,725,0.5390789687043943,45427666,6649,7374,11609,/well/papiez/users/hri611/python/nnUNet_results/Dataset219_PETCT/nnUNetTrainer_1500epochs_1e2lr__nnUNetPlans__3d_fullres_maxnum_512_patch_192/crossval_results_folds_0_1_2_3_4/PETCT_5255c79083_10202001.nii.gz,/well/papiez/users/hri611/python/nnUnet_raw/Dataset219_PETCT/labelsTr/PETCT_5255c79083_10202001.nii.gz,0.7005215192540695,0.06220510482788086,24.6954266166687
273,0.901162625429944,307,3170,0.8201055463576159,45420672,15851,19021,16158,/well/papiez/users/hri611/python/nnUNet_results/Dataset219_PETCT/nnUNetTrainer_1500epochs_1e2lr__nnUNetPlans__3d_fullres_maxnum_512_patch_192/crossval_results_folds_0_1_2_3_4/PETCT_527c5afc5d_07182003.nii.gz,/well/papiez/users/hri611/python/nnUnet_raw/Dataset219_PETCT/labelsTr/PETCT_527c5afc5d_07182003.nii.gz,0.901162625429944,1.7790659980773926,0.49764083862304687
274,,0,0,,41440000,0,0,0,/well/papiez/users/hri611/python/nnUNet_results/Dataset219_PETCT/nnUNetTrainer_1500epochs_1e2lr__nnUNetPlans__3d_fullres_maxnum_512_patch_192/crossval_results_folds_0_1_2_3_4/PETCT_52f84711a5_04012006.nii.gz,/well/papiez/users/hri611/python/nnUnet_raw/Dataset219_PETCT/labelsTr/PETCT_52f84711a5_04012006.nii.gz,,0.0,0.0
275,,0,0,,48480000,0,0,0,/well/papiez/users/hri611/python/nnUNet_results/Dataset219_PETCT/nnUNetTrainer_1500epochs_1e2lr__nnUNetPlans__3d_fullres_maxnum_512_patch_192/crossval_results_folds_0_1_2_3_4/PETCT_53ccb9efbb_12152005.nii.gz,/well/papiez/users/hri611/python/nnUnet_raw/Dataset219_PETCT/labelsTr/PETCT_53ccb9efbb_12152005.nii.gz,,0.0,0.0
276,0.7538504274823297,697,7278,0.6049437756972309,50059813,12212,19490,12909,/well/papiez/users/hri611/python/nnUNet_results/Dataset219_PETCT/nnUNetTrainer_1500epochs_1e2lr__nnUNetPlans__3d_fullres_maxnum_512_patch_192/crossval_results_folds_0_1_2_3_4/PETCT_53dad1785b_12112005.nii.gz,/well/papiez/users/hri611/python/nnUnet_raw/Dataset219_PETCT/labelsTr/PETCT_53dad1785b_12112005.nii.gz,0.7538504274823297,30.90349607849121,4.503649589538574
277,,0,0,,46080000,0,0,0,/well/papiez/users/hri611/python/nnUNet_results/Dataset219_PETCT/nnUNetTrainer_1500epochs_1e2lr__nnUNetPlans__3d_fullres_maxnum_512_patch_192/crossval_results_folds_0_1_2_3_4/PETCT_5420205a5f_12072006.nii.gz,/well/papiez/users/hri611/python/nnUnet_raw/Dataset219_PETCT/labelsTr/PETCT_5420205a5f_12072006.nii.gz,,0.0,0.0
278,,0,0,,52480000,0,0,0,/well/papiez/users/hri611/python/nnUNet_results/Dataset219_PETCT/nnUNetTrainer_1500epochs_1e2lr__nnUNetPlans__3d_fullres_maxnum_512_patch_192/crossval_results_folds_0_1_2_3_4/PETCT_544676de40_03232007.nii.gz,/well/papiez/users/hri611/python/nnUnet_raw/Dataset219_PETCT/labelsTr/PETCT_544676de40_03232007.nii.gz,,0.0,0.0
279,0.7850348763474952,454,563,0.6461377870563675,53437126,1857,2420,2311,/well/papiez/users/hri611/python/nnUNet_results/Dataset219_PETCT/nnUNetTrainer_1500epochs_1e2lr__nnUNetPlans__3d_fullres_maxnum_512_patch_192/crossval_results_folds_0_1_2_3_4/PETCT_544676de40_07032005.nii.gz,/well/papiez/users/hri611/python/nnUnet_raw/Dataset219_PETCT/labelsTr/PETCT_544676de40_07032005.nii.gz,0.7850348763474952,0.2861434822082519,5.648223518371582
280,,0,0,,50560000,0,0,0,/well/papiez/users/hri611/python/nnUNet_results/Dataset219_PETCT/nnUNetTrainer_1500epochs_1e2lr__nnUNetPlans__3d_fullres_maxnum_512_patch_192/crossval_results_folds_0_1_2_3_4/PETCT_544676de40_12152005.nii.gz,/well/papiez/users/hri611/python/nnUnet_raw/Dataset219_PETCT/labelsTr/PETCT_544676de40_12152005.nii.gz,,0.0,0.0
281,0.9122250842084406,959,370,0.838615664845173,48791765,6906,7276,7865,/well/papiez/users/hri611/python/nnUNet_results/Dataset219_PETCT/nnUNetTrainer_1500epochs_1e2lr__nnUNetPlans__3d_fullres_maxnum_512_patch_192/crossval_results_folds_0_1_2_3_4/PETCT_548213edf7_09192005.nii.gz,/well/papiez/users/hri611/python/nnUnet_raw/Dataset219_PETCT/labelsTr/PETCT_548213edf7_09192005.nii.gz,0.9122250842084406,0.0,4.267270191192627
282,0.8017467248908297,339,342,0.6690962099125365,52157942,1377,1719,1716,/well/papiez/users/hri611/python/nnUNet_results/Dataset219_PETCT/nnUNetTrainer_1500epochs_1e2lr__nnUNetPlans__3d_fullres_maxnum_512_patch_192/crossval_results_folds_0_1_2_3_4/PETCT_548bd05667_04242004.nii.gz,/well/papiez/users/hri611/python/nnUnet_raw/Dataset219_PETCT/labelsTr/PETCT_548bd05667_04242004.nii.gz,0.8017467248908297,0.037323062896728515,0.0
283,,0,0,,45440000,0,0,0,/well/papiez/users/hri611/python/nnUNet_results/Dataset219_PETCT/nnUNetTrainer_1500epochs_1e2lr__nnUNetPlans__3d_fullres_maxnum_512_patch_192/crossval_results_folds_0_1_2_3_4/PETCT_54977a7e76_02212003.nii.gz,/well/papiez/users/hri611/python/nnUnet_raw/Dataset219_PETCT/labelsTr/PETCT_54977a7e76_02212003.nii.gz,,0.0,0.0
284,0.9733131746422419,44,715,0.948013698630137,58865400,13841,14556,13885,/well/papiez/users/hri611/python/nnUNet_results/Dataset219_PETCT/nnUNetTrainer_1500epochs_1e2lr__nnUNetPlans__3d_fullres_maxnum_512_patch_192/crossval_results_folds_0_1_2_3_4/PETCT_556b56485a_08292003.nii.gz,/well/papiez/users/hri611/python/nnUnet_raw/Dataset219_PETCT/labelsTr/PETCT_556b56485a_08292003.nii.gz,0.9733131746422419,0.0,0.024882041931152343
285,,0,0,,50880000,0,0,0,/well/papiez/users/hri611/python/nnUNet_results/Dataset219_PETCT/nnUNetTrainer_1500epochs_1e2lr__nnUNetPlans__3d_fullres_maxnum_512_patch_192/crossval_results_folds_0_1_2_3_4/PETCT_55819a54c2_04142007.nii.gz,/well/papiez/users/hri611/python/nnUnet_raw/Dataset219_PETCT/labelsTr/PETCT_55819a54c2_04142007.nii.gz,,0.0,0.0
286,0.0,58,0,0.0,52159942,0,0,58,/well/papiez/users/hri611/python/nnUNet_results/Dataset219_PETCT/nnUNetTrainer_1500epochs_1e2lr__nnUNetPlans__3d_fullres_maxnum_512_patch_192/crossval_results_folds_0_1_2_3_4/PETCT_55ae7986e1_05102003.nii.gz,/well/papiez/users/hri611/python/nnUnet_raw/Dataset219_PETCT/labelsTr/PETCT_55ae7986e1_05102003.nii.gz,0.0,0.0,0.721579216003418
287,0.8634230022432937,478,6767,0.7596696079081802,52129854,22901,29668,23379,/well/papiez/users/hri611/python/nnUNet_results/Dataset219_PETCT/nnUNetTrainer_1500epochs_1e2lr__nnUNetPlans__3d_fullres_maxnum_512_patch_192/crossval_results_folds_0_1_2_3_4/PETCT_55ca11402a_06052003.nii.gz,/well/papiez/users/hri611/python/nnUnet_raw/Dataset219_PETCT/labelsTr/PETCT_55ca11402a_06052003.nii.gz,0.8634230022432937,0.6842561531066894,0.2737024612426758
288,0.0,0,55,0.0,92959945,0,55,0,/well/papiez/users/hri611/python/nnUNet_results/Dataset219_PETCT/nnUNetTrainer_1500epochs_1e2lr__nnUNetPlans__3d_fullres_maxnum_512_patch_192/crossval_results_folds_0_1_2_3_4/PETCT_55d55902c6_05112006.nii.gz,/well/papiez/users/hri611/python/nnUnet_raw/Dataset219_PETCT/labelsTr/PETCT_55d55902c6_05112006.nii.gz,0.0,0.6842561531066894,0.0
289,,0,0,,51520000,0,0,0,/well/papiez/users/hri611/python/nnUNet_results/Dataset219_PETCT/nnUNetTrainer_1500epochs_1e2lr__nnUNetPlans__3d_fullres_maxnum_512_patch_192/crossval_results_folds_0_1_2_3_4/PETCT_55e3e62722_03032007.nii.gz,/well/papiez/users/hri611/python/nnUnet_raw/Dataset219_PETCT/labelsTr/PETCT_55e3e62722_03032007.nii.gz,,0.0,0.0
290,,0,0,,56000000,0,0,0,/well/papiez/users/hri611/python/nnUNet_results/Dataset219_PETCT/nnUNetTrainer_1500epochs_1e2lr__nnUNetPlans__3d_fullres_maxnum_512_patch_192/crossval_results_folds_0_1_2_3_4/PETCT_57c05962c1_09302005.nii.gz,/well/papiez/users/hri611/python/nnUnet_raw/Dataset219_PETCT/labelsTr/PETCT_57c05962c1_09302005.nii.gz,,0.0,0.0
291,0.9305352636472307,500,23,0.8700943864878291,52155974,3503,3526,4003,/well/papiez/users/hri611/python/nnUNet_results/Dataset219_PETCT/nnUNetTrainer_1500epochs_1e2lr__nnUNetPlans__3d_fullres_maxnum_512_patch_192/crossval_results_folds_0_1_2_3_4/PETCT_581fa95eb0_03242003.nii.gz,/well/papiez/users/hri611/python/nnUnet_raw/Dataset219_PETCT/labelsTr/PETCT_581fa95eb0_03242003.nii.gz,0.9305352636472307,0.0,0.0
292,,0,0,,52160000,0,0,0,/well/papiez/users/hri611/python/nnUNet_results/Dataset219_PETCT/nnUNetTrainer_1500epochs_1e2lr__nnUNetPlans__3d_fullres_maxnum_512_patch_192/crossval_results_folds_0_1_2_3_4/PETCT_591b3025ff_11132004.nii.gz,/well/papiez/users/hri611/python/nnUnet_raw/Dataset219_PETCT/labelsTr/PETCT_591b3025ff_11132004.nii.gz,,0.0,0.0
293,0.752,1,92,0.6025641025641025,44319766,141,233,142,/well/papiez/users/hri611/python/nnUNet_results/Dataset219_PETCT/nnUNetTrainer_1500epochs_1e2lr__nnUNetPlans__3d_fullres_maxnum_512_patch_192/crossval_results_folds_0_1_2_3_4/PETCT_59309d6625_03032006.nii.gz,/well/papiez/users/hri611/python/nnUnet_raw/Dataset219_PETCT/labelsTr/PETCT_59309d6625_03032006.nii.gz,0.752,0.9330765724182128,0.0
294,0.0,0,15,0.0,48799985,0,15,0,/well/papiez/users/hri611/python/nnUNet_results/Dataset219_PETCT/nnUNetTrainer_1500epochs_1e2lr__nnUNetPlans__3d_fullres_maxnum_512_patch_192/crossval_results_folds_0_1_2_3_4/PETCT_5951afb86e_03172006.nii.gz,/well/papiez/users/hri611/python/nnUnet_raw/Dataset219_PETCT/labelsTr/PETCT_5951afb86e_03172006.nii.gz,0.0,0.18661531448364257,0.0
295,0.0,0,113,0.0,48159887,0,113,0,/well/papiez/users/hri611/python/nnUNet_results/Dataset219_PETCT/nnUNetTrainer_1500epochs_1e2lr__nnUNetPlans__3d_fullres_maxnum_512_patch_192/crossval_results_folds_0_1_2_3_4/PETCT_595975bc57_03102006.nii.gz,/well/papiez/users/hri611/python/nnUnet_raw/Dataset219_PETCT/labelsTr/PETCT_595975bc57_03102006.nii.gz,0.0,1.4058353691101073,0.0
296,0.8268388286834217,1203,299,0.7047955974842768,51194912,3586,3885,4789,/well/papiez/users/hri611/python/nnUNet_results/Dataset219_PETCT/nnUNetTrainer_1500epochs_1e2lr__nnUNetPlans__3d_fullres_maxnum_512_patch_192/crossval_results_folds_0_1_2_3_4/PETCT_59e6d1de22_08062005.nii.gz,/well/papiez/users/hri611/python/nnUnet_raw/Dataset219_PETCT/labelsTr/PETCT_59e6d1de22_08062005.nii.gz,0.8268388286834217,0.0,0.3110255241394043
297,0.0,0,116,0.0,52159884,0,116,0,/well/papiez/users/hri611/python/nnUNet_results/Dataset219_PETCT/nnUNetTrainer_1500epochs_1e2lr__nnUNetPlans__3d_fullres_maxnum_512_patch_192/crossval_results_folds_0_1_2_3_4/PETCT_5a274a0f26_11082004.nii.gz,/well/papiez/users/hri611/python/nnUnet_raw/Dataset219_PETCT/labelsTr/PETCT_5a274a0f26_11082004.nii.gz,0.0,1.443158432006836,0.0
298,0.9150739136926982,3855,695,0.8434435536592919,52130937,24513,25208,28368,/well/papiez/users/hri611/python/nnUNet_results/Dataset219_PETCT/nnUNetTrainer_1500epochs_1e2lr__nnUNetPlans__3d_fullres_maxnum_512_patch_192/crossval_results_folds_0_1_2_3_4/PETCT_5ac322455f_05262003.nii.gz,/well/papiez/users/hri611/python/nnUnet_raw/Dataset219_PETCT/labelsTr/PETCT_5ac322455f_05262003.nii.gz,0.9150739136926982,0.04976408386230469,1.306307201385498
299,,0,0,,52160000,0,0,0,/well/papiez/users/hri611/python/nnUNet_results/Dataset219_PETCT/nnUNetTrainer_1500epochs_1e2lr__nnUNetPlans__3d_fullres_maxnum_512_patch_192/crossval_results_folds_0_1_2_3_4/PETCT_5ac4fd9091_11142004.nii.gz,/well/papiez/users/hri611/python/nnUnet_raw/Dataset219_PETCT/labelsTr/PETCT_5ac4fd9091_11142004.nii.gz,,0.0,0.0
300,,0,0,,47520000,0,0,0,/well/papiez/users/hri611/python/nnUNet_results/Dataset219_PETCT/nnUNetTrainer_1500epochs_1e2lr__nnUNetPlans__3d_fullres_maxnum_512_patch_192/crossval_results_folds_0_1_2_3_4/PETCT_5b0aa4e971_09102006.nii.gz,/well/papiez/users/hri611/python/nnUnet_raw/Dataset219_PETCT/labelsTr/PETCT_5b0aa4e971_09102006.nii.gz,,0.0,0.0
301,0.0,0,24,0.0,58879976,0,24,0,/well/papiez/users/hri611/python/nnUNet_results/Dataset219_PETCT/nnUNetTrainer_1500epochs_1e2lr__nnUNetPlans__3d_fullres_maxnum_512_patch_192/crossval_results_folds_0_1_2_3_4/PETCT_5b10c3f524_09122002.nii.gz,/well/papiez/users/hri611/python/nnUnet_raw/Dataset219_PETCT/labelsTr/PETCT_5b10c3f524_09122002.nii.gz,0.0,0.2985845031738281,0.0
302,0.0,0,4,0.0,50399996,0,4,0,/well/papiez/users/hri611/python/nnUNet_results/Dataset219_PETCT/nnUNetTrainer_1500epochs_1e2lr__nnUNetPlans__3d_fullres_maxnum_512_patch_192/crossval_results_folds_0_1_2_3_4/PETCT_5bd311a5e9_09122005.nii.gz,/well/papiez/users/hri611/python/nnUnet_raw/Dataset219_PETCT/labelsTr/PETCT_5bd311a5e9_09122005.nii.gz,0.0,0.04976408386230469,0.0
303,0.0,611,47,0.0,52159342,0,47,611,/well/papiez/users/hri611/python/nnUNet_results/Dataset219_PETCT/nnUNetTrainer_1500epochs_1e2lr__nnUNetPlans__3d_fullres_maxnum_512_patch_192/crossval_results_folds_0_1_2_3_4/PETCT_5c1baad5d8_03062003.nii.gz,/well/papiez/users/hri611/python/nnUnet_raw/Dataset219_PETCT/labelsTr/PETCT_5c1baad5d8_03062003.nii.gz,0.0,0.58472798538208,7.601463809967041
304,0.8147465437788018,188,13,0.687402799377916,45439357,442,455,630,/well/papiez/users/hri611/python/nnUNet_results/Dataset219_PETCT/nnUNetTrainer_1500epochs_1e2lr__nnUNetPlans__3d_fullres_maxnum_512_patch_192/crossval_results_folds_0_1_2_3_4/PETCT_5c35fcbe89_08102002.nii.gz,/well/papiez/users/hri611/python/nnUnet_raw/Dataset219_PETCT/labelsTr/PETCT_5c35fcbe89_08102002.nii.gz,0.8147465437788018,0.0,0.0
305,0.8395779679322091,3026,6629,0.7235108820160366,45405080,25265,31894,28291,/well/papiez/users/hri611/python/nnUNet_results/Dataset219_PETCT/nnUNetTrainer_1500epochs_1e2lr__nnUNetPlans__3d_fullres_maxnum_512_patch_192/crossval_results_folds_0_1_2_3_4/PETCT_5c55b3087d_12112000.nii.gz,/well/papiez/users/hri611/python/nnUnet_raw/Dataset219_PETCT/labelsTr/PETCT_5c55b3087d_12112000.nii.gz,0.8395779679322091,60.18965943145752,12.217082588195801
306,,0,0,,45440000,0,0,0,/well/papiez/users/hri611/python/nnUNet_results/Dataset219_PETCT/nnUNetTrainer_1500epochs_1e2lr__nnUNetPlans__3d_fullres_maxnum_512_patch_192/crossval_results_folds_0_1_2_3_4/PETCT_5c57a98a43_02242005.nii.gz,/well/papiez/users/hri611/python/nnUnet_raw/Dataset219_PETCT/labelsTr/PETCT_5c57a98a43_02242005.nii.gz,,0.0,0.0
307,0.8222021420788264,9938,3442,0.6980842566058172,52115683,30937,34379,40875,/well/papiez/users/hri611/python/nnUNet_results/Dataset219_PETCT/nnUNetTrainer_1500epochs_1e2lr__nnUNetPlans__3d_fullres_maxnum_512_patch_192/crossval_results_folds_0_1_2_3_4/PETCT_5cf118ac06_02282004.nii.gz,/well/papiez/users/hri611/python/nnUnet_raw/Dataset219_PETCT/labelsTr/PETCT_5cf118ac06_02282004.nii.gz,0.8222021420788264,18.823264720916747,6.6808282585144045
308,0.901521966849467,1576,6415,0.8207009513552325,47315432,36577,42992,38153,/well/papiez/users/hri611/python/nnUNet_results/Dataset219_PETCT/nnUNetTrainer_1500epochs_1e2lr__nnUNetPlans__3d_fullres_maxnum_512_patch_192/crossval_results_folds_0_1_2_3_4/PETCT_5d10be5b89_05302005.nii.gz,/well/papiez/users/hri611/python/nnUnet_raw/Dataset219_PETCT/labelsTr/PETCT_5d10be5b89_05302005.nii.gz,0.901521966849467,4.914203281402588,1.0077226982116698
309,0.718056979713292,12927,1096,0.5601317440401505,52128120,17857,18953,30784,/well/papiez/users/hri611/python/nnUNet_results/Dataset219_PETCT/nnUNetTrainer_1500epochs_1e2lr__nnUNetPlans__3d_fullres_maxnum_512_patch_192/crossval_results_folds_0_1_2_3_4/PETCT_5d553bf6b4_09162001.nii.gz,/well/papiez/users/hri611/python/nnUnet_raw/Dataset219_PETCT/labelsTr/PETCT_5d553bf6b4_09162001.nii.gz,0.718056979713292,0.3110255241394043,21.622494438171387
310,0.6111111111111112,1,13,0.44,46719975,11,24,12,/well/papiez/users/hri611/python/nnUNet_results/Dataset219_PETCT/nnUNetTrainer_1500epochs_1e2lr__nnUNetPlans__3d_fullres_maxnum_512_patch_192/crossval_results_folds_0_1_2_3_4/PETCT_5d994c3f44_03052006.nii.gz,/well/papiez/users/hri611/python/nnUnet_raw/Dataset219_PETCT/labelsTr/PETCT_5d994c3f44_03052006.nii.gz,0.6111111111111112,0.11196918869018554,0.0
311,0.9362012395187751,141,34,0.8800548320767649,47518541,1284,1318,1425,/well/papiez/users/hri611/python/nnUNet_results/Dataset219_PETCT/nnUNetTrainer_1500epochs_1e2lr__nnUNetPlans__3d_fullres_maxnum_512_patch_192/crossval_results_folds_0_1_2_3_4/PETCT_5de3ac617a_11132005.nii.gz,/well/papiez/users/hri611/python/nnUnet_raw/Dataset219_PETCT/labelsTr/PETCT_5de3ac617a_11132005.nii.gz,0.9362012395187751,0.0,0.0
312,0.6665630746121772,12341,534,0.49988346799254196,52134256,12869,13403,25210,/well/papiez/users/hri611/python/nnUNet_results/Dataset219_PETCT/nnUNetTrainer_1500epochs_1e2lr__nnUNetPlans__3d_fullres_maxnum_512_patch_192/crossval_results_folds_0_1_2_3_4/PETCT_5e2da717db_06282002.nii.gz,/well/papiez/users/hri611/python/nnUnet_raw/Dataset219_PETCT/labelsTr/PETCT_5e2da717db_06282002.nii.gz,0.6665630746121772,0.6344920692443847,62.466366268157955
313,,0,0,,45440000,0,0,0,/well/papiez/users/hri611/python/nnUNet_results/Dataset219_PETCT/nnUNetTrainer_1500epochs_1e2lr__nnUNetPlans__3d_fullres_maxnum_512_patch_192/crossval_results_folds_0_1_2_3_4/PETCT_5e339b2ecf_04032003.nii.gz,/well/papiez/users/hri611/python/nnUnet_raw/Dataset219_PETCT/labelsTr/PETCT_5e339b2ecf_04032003.nii.gz,,0.0,0.0
314,0.0,0,8,0.0,46399992,0,8,0,/well/papiez/users/hri611/python/nnUNet_results/Dataset219_PETCT/nnUNetTrainer_1500epochs_1e2lr__nnUNetPlans__3d_fullres_maxnum_512_patch_192/crossval_results_folds_0_1_2_3_4/PETCT_5e339b2ecf_05272006.nii.gz,/well/papiez/users/hri611/python/nnUnet_raw/Dataset219_PETCT/labelsTr/PETCT_5e339b2ecf_05272006.nii.gz,0.0,0.09952816772460937,0.0
315,,0,0,,43840000,0,0,0,/well/papiez/users/hri611/python/nnUNet_results/Dataset219_PETCT/nnUNetTrainer_1500epochs_1e2lr__nnUNetPlans__3d_fullres_maxnum_512_patch_192/crossval_results_folds_0_1_2_3_4/PETCT_5e339b2ecf_11112005.nii.gz,/well/papiez/users/hri611/python/nnUnet_raw/Dataset219_PETCT/labelsTr/PETCT_5e339b2ecf_11112005.nii.gz,,0.0,0.0
316,,0,0,,52160000,0,0,0,/well/papiez/users/hri611/python/nnUNet_results/Dataset219_PETCT/nnUNetTrainer_1500epochs_1e2lr__nnUNetPlans__3d_fullres_maxnum_512_patch_192/crossval_results_folds_0_1_2_3_4/PETCT_5e81863014_10182002.nii.gz,/well/papiez/users/hri611/python/nnUnet_raw/Dataset219_PETCT/labelsTr/PETCT_5e81863014_10182002.nii.gz,,0.0,0.0
317,0.48754683711703767,2285,40,0.32235499854269895,45436569,1106,1146,3391,/well/papiez/users/hri611/python/nnUNet_results/Dataset219_PETCT/nnUNetTrainer_1500epochs_1e2lr__nnUNetPlans__3d_fullres_maxnum_512_patch_192/crossval_results_folds_0_1_2_3_4/PETCT_5e8b013935_12162001.nii.gz,/well/papiez/users/hri611/python/nnUnet_raw/Dataset219_PETCT/labelsTr/PETCT_5e8b013935_12162001.nii.gz,0.48754683711703767,0.0,24.434165176391602
318,0.9256458793794482,691,6340,0.8615835892589968,45389204,43765,50105,44456,/well/papiez/users/hri611/python/nnUNet_results/Dataset219_PETCT/nnUNetTrainer_1500epochs_1e2lr__nnUNetPlans__3d_fullres_maxnum_512_patch_192/crossval_results_folds_0_1_2_3_4/PETCT_5ef99b0b6b_09072000.nii.gz,/well/papiez/users/hri611/python/nnUnet_raw/Dataset219_PETCT/labelsTr/PETCT_5ef99b0b6b_09072000.nii.gz,0.9256458793794482,1.231661075592041,0.024882041931152343
319,0.7167662966125818,366,1624,0.5585625554569654,52155492,2518,4142,2884,/well/papiez/users/hri611/python/nnUNet_results/Dataset219_PETCT/nnUNetTrainer_1500epochs_1e2lr__nnUNetPlans__3d_fullres_maxnum_512_patch_192/crossval_results_folds_0_1_2_3_4/PETCT_5f569fb737_09122002.nii.gz,/well/papiez/users/hri611/python/nnUnet_raw/Dataset219_PETCT/labelsTr/PETCT_5f569fb737_09122002.nii.gz,0.7167662966125818,17.890188148498535,0.0
320,0.0,0,17,0.0,45439983,0,17,0,/well/papiez/users/hri611/python/nnUNet_results/Dataset219_PETCT/nnUNetTrainer_1500epochs_1e2lr__nnUNetPlans__3d_fullres_maxnum_512_patch_192/crossval_results_folds_0_1_2_3_4/PETCT_5fa9d9a820_03242003.nii.gz,/well/papiez/users/hri611/python/nnUnet_raw/Dataset219_PETCT/labelsTr/PETCT_5fa9d9a820_03242003.nii.gz,0.0,0.21149735641479492,0.0
321,,0,0,,45440000,0,0,0,/well/papiez/users/hri611/python/nnUNet_results/Dataset219_PETCT/nnUNetTrainer_1500epochs_1e2lr__nnUNetPlans__3d_fullres_maxnum_512_patch_192/crossval_results_folds_0_1_2_3_4/PETCT_5fa9d9a820_09132003.nii.gz,/well/papiez/users/hri611/python/nnUnet_raw/Dataset219_PETCT/labelsTr/PETCT_5fa9d9a820_09132003.nii.gz,,0.0,0.0
322,0.0,0,148,0.0,45439852,0,148,0,/well/papiez/users/hri611/python/nnUNet_results/Dataset219_PETCT/nnUNetTrainer_1500epochs_1e2lr__nnUNetPlans__3d_fullres_maxnum_512_patch_192/crossval_results_folds_0_1_2_3_4/PETCT_5fa9d9a820_09152002.nii.gz,/well/papiez/users/hri611/python/nnUnet_raw/Dataset219_PETCT/labelsTr/PETCT_5fa9d9a820_09152002.nii.gz,0.0,1.8412711029052735,0.0
323,0.0,0,46,0.0,52159954,0,46,0,/well/papiez/users/hri611/python/nnUNet_results/Dataset219_PETCT/nnUNetTrainer_1500epochs_1e2lr__nnUNetPlans__3d_fullres_maxnum_512_patch_192/crossval_results_folds_0_1_2_3_4/PETCT_5fa9d9a820_09272004.nii.gz,/well/papiez/users/hri611/python/nnUnet_raw/Dataset219_PETCT/labelsTr/PETCT_5fa9d9a820_09272004.nii.gz,0.0,0.5722869644165038,0.0
324,0.0,0,80,0.0,52159920,0,80,0,/well/papiez/users/hri611/python/nnUNet_results/Dataset219_PETCT/nnUNetTrainer_1500epochs_1e2lr__nnUNetPlans__3d_fullres_maxnum_512_patch_192/crossval_results_folds_0_1_2_3_4/PETCT_6016a6c3af_07012002.nii.gz,/well/papiez/users/hri611/python/nnUnet_raw/Dataset219_PETCT/labelsTr/PETCT_6016a6c3af_07012002.nii.gz,0.0,0.9952816772460937,0.0
325,0.8126124469775565,11531,2738,0.6843700230047779,52114792,30939,33677,42470,/well/papiez/users/hri611/python/nnUNet_results/Dataset219_PETCT/nnUNetTrainer_1500epochs_1e2lr__nnUNetPlans__3d_fullres_maxnum_512_patch_192/crossval_results_folds_0_1_2_3_4/PETCT_605369e88d_09152002.nii.gz,/well/papiez/users/hri611/python/nnUnet_raw/Dataset219_PETCT/labelsTr/PETCT_605369e88d_09152002.nii.gz,0.8126124469775565,0.012441020965576172,0.0
326,0.0,0,152,0.0,50879848,0,152,0,/well/papiez/users/hri611/python/nnUNet_results/Dataset219_PETCT/nnUNetTrainer_1500epochs_1e2lr__nnUNetPlans__3d_fullres_maxnum_512_patch_192/crossval_results_folds_0_1_2_3_4/PETCT_607c1b38e3_04142007.nii.gz,/well/papiez/users/hri611/python/nnUnet_raw/Dataset219_PETCT/labelsTr/PETCT_607c1b38e3_04142007.nii.gz,0.0,1.891035186767578,0.0
327,0.0,0,3,0.0,48639997,0,3,0,/well/papiez/users/hri611/python/nnUNet_results/Dataset219_PETCT/nnUNetTrainer_1500epochs_1e2lr__nnUNetPlans__3d_fullres_maxnum_512_patch_192/crossval_results_folds_0_1_2_3_4/PETCT_607c1b38e3_10162006.nii.gz,/well/papiez/users/hri611/python/nnUnet_raw/Dataset219_PETCT/labelsTr/PETCT_607c1b38e3_10162006.nii.gz,0.0,0.037323062896728515,0.0
328,0.7899179095849231,1529,288,0.6527804318746417,45434767,3416,3704,4945,/well/papiez/users/hri611/python/nnUNet_results/Dataset219_PETCT/nnUNetTrainer_1500epochs_1e2lr__nnUNetPlans__3d_fullres_maxnum_512_patch_192/crossval_results_folds_0_1_2_3_4/PETCT_60baa6979c_08162003.nii.gz,/well/papiez/users/hri611/python/nnUnet_raw/Dataset219_PETCT/labelsTr/PETCT_60baa6979c_08162003.nii.gz,0.7899179095849231,0.24882041931152343,0.4727587966918945
329,0.868636402790938,1209,316,0.767778285366225,45433433,5042,5358,6251,/well/papiez/users/hri611/python/nnUNet_results/Dataset219_PETCT/nnUNetTrainer_1500epochs_1e2lr__nnUNetPlans__3d_fullres_maxnum_512_patch_192/crossval_results_folds_0_1_2_3_4/PETCT_61663450f8_08162003.nii.gz,/well/papiez/users/hri611/python/nnUnet_raw/Dataset219_PETCT/labelsTr/PETCT_61663450f8_08162003.nii.gz,0.868636402790938,0.4727587966918945,0.0
330,0.8978831299015272,7062,1597,0.8146895799002718,45393273,38068,39665,45130,/well/papiez/users/hri611/python/nnUNet_results/Dataset219_PETCT/nnUNetTrainer_1500epochs_1e2lr__nnUNetPlans__3d_fullres_maxnum_512_patch_192/crossval_results_folds_0_1_2_3_4/PETCT_6170317f2e_02182000.nii.gz,/well/papiez/users/hri611/python/nnUnet_raw/Dataset219_PETCT/labelsTr/PETCT_6170317f2e_02182000.nii.gz,0.8978831299015272,7.788079124450683,6.120982315063476
331,0.0,0,305,0.0,58079695,0,305,0,/well/papiez/users/hri611/python/nnUNet_results/Dataset219_PETCT/nnUNetTrainer_1500epochs_1e2lr__nnUNetPlans__3d_fullres_maxnum_512_patch_192/crossval_results_folds_0_1_2_3_4/PETCT_61d5bc58fc_06152007.nii.gz,/well/papiez/users/hri611/python/nnUnet_raw/Dataset219_PETCT/labelsTr/PETCT_61d5bc58fc_06152007.nii.gz,0.0,3.7945113945007325,0.0
332,0.0,0,92,0.0,59839908,0,92,0,/well/papiez/users/hri611/python/nnUNet_results/Dataset219_PETCT/nnUNetTrainer_1500epochs_1e2lr__nnUNetPlans__3d_fullres_maxnum_512_patch_192/crossval_results_folds_0_1_2_3_4/PETCT_61d5bc58fc_06182005.nii.gz,/well/papiez/users/hri611/python/nnUnet_raw/Dataset219_PETCT/labelsTr/PETCT_61d5bc58fc_06182005.nii.gz,0.0,1.1445739288330077,0.0
333,0.0,0,49,0.0,59199951,0,49,0,/well/papiez/users/hri611/python/nnUNet_results/Dataset219_PETCT/nnUNetTrainer_1500epochs_1e2lr__nnUNetPlans__3d_fullres_maxnum_512_patch_192/crossval_results_folds_0_1_2_3_4/PETCT_61d5bc58fc_06232006.nii.gz,/well/papiez/users/hri611/python/nnUnet_raw/Dataset219_PETCT/labelsTr/PETCT_61d5bc58fc_06232006.nii.gz,0.0,0.6096100273132324,0.0
334,0.0,0,489,0.0,55999511,0,489,0,/well/papiez/users/hri611/python/nnUNet_results/Dataset219_PETCT/nnUNetTrainer_1500epochs_1e2lr__nnUNetPlans__3d_fullres_maxnum_512_patch_192/crossval_results_folds_0_1_2_3_4/PETCT_61d5bc58fc_12152005.nii.gz,/well/papiez/users/hri611/python/nnUnet_raw/Dataset219_PETCT/labelsTr/PETCT_61d5bc58fc_12152005.nii.gz,0.0,6.083659252166748,0.0
335,0.9255295262330664,5995,970,0.8613820005572583,52109754,43281,44251,49276,/well/papiez/users/hri611/python/nnUNet_results/Dataset219_PETCT/nnUNetTrainer_1500epochs_1e2lr__nnUNetPlans__3d_fullres_maxnum_512_patch_192/crossval_results_folds_0_1_2_3_4/PETCT_62011ff15b_05052005.nii.gz,/well/papiez/users/hri611/python/nnUnet_raw/Dataset219_PETCT/labelsTr/PETCT_62011ff15b_05052005.nii.gz,0.9255295262330664,0.06220510482788086,11.955821147918702
336,0.9404140414041404,104,1220,0.8875297315664288,52148228,10448,11668,10552,/well/papiez/users/hri611/python/nnUNet_results/Dataset219_PETCT/nnUNetTrainer_1500epochs_1e2lr__nnUNetPlans__3d_fullres_maxnum_512_patch_192/crossval_results_folds_0_1_2_3_4/PETCT_62405d117c_03112001.nii.gz,/well/papiez/users/hri611/python/nnUnet_raw/Dataset219_PETCT/labelsTr/PETCT_62405d117c_03112001.nii.gz,0.9404140414041404,0.012441020965576172,0.012441020965576172
337,0.9179157744468237,201,29,0.8482849604221636,52158484,1286,1315,1487,/well/papiez/users/hri611/python/nnUNet_results/Dataset219_PETCT/nnUNetTrainer_1500epochs_1e2lr__nnUNetPlans__3d_fullres_maxnum_512_patch_192/crossval_results_folds_0_1_2_3_4/PETCT_62b114e09b_03272003.nii.gz,/well/papiez/users/hri611/python/nnUnet_raw/Dataset219_PETCT/labelsTr/PETCT_62b114e09b_03272003.nii.gz,0.9179157744468237,0.0,0.0
338,,0,0,,52160000,0,0,0,/well/papiez/users/hri611/python/nnUNet_results/Dataset219_PETCT/nnUNetTrainer_1500epochs_1e2lr__nnUNetPlans__3d_fullres_maxnum_512_patch_192/crossval_results_folds_0_1_2_3_4/PETCT_62b114e09b_06092003.nii.gz,/well/papiez/users/hri611/python/nnUnet_raw/Dataset219_PETCT/labelsTr/PETCT_62b114e09b_06092003.nii.gz,,0.0,0.0
339,0.8860915492957746,225,3657,0.7954796902165323,52141019,15099,18756,15324,/well/papiez/users/hri611/python/nnUNet_results/Dataset219_PETCT/nnUNetTrainer_1500epochs_1e2lr__nnUNetPlans__3d_fullres_maxnum_512_patch_192/crossval_results_folds_0_1_2_3_4/PETCT_62ced197ca_04142003.nii.gz,/well/papiez/users/hri611/python/nnUnet_raw/Dataset219_PETCT/labelsTr/PETCT_62ced197ca_04142003.nii.gz,0.8860915492957746,0.0,0.0
340,,0,0,,101600000,0,0,0,/well/papiez/users/hri611/python/nnUNet_results/Dataset219_PETCT/nnUNetTrainer_1500epochs_1e2lr__nnUNetPlans__3d_fullres_maxnum_512_patch_192/crossval_results_folds_0_1_2_3_4/PETCT_631b419cef_11232006.nii.gz,/well/papiez/users/hri611/python/nnUnet_raw/Dataset219_PETCT/labelsTr/PETCT_631b419cef_11232006.nii.gz,,0.0,0.0
341,,0,0,,52160000,0,0,0,/well/papiez/users/hri611/python/nnUNet_results/Dataset219_PETCT/nnUNetTrainer_1500epochs_1e2lr__nnUNetPlans__3d_fullres_maxnum_512_patch_192/crossval_results_folds_0_1_2_3_4/PETCT_63464433c8_01042003.nii.gz,/well/papiez/users/hri611/python/nnUnet_raw/Dataset219_PETCT/labelsTr/PETCT_63464433c8_01042003.nii.gz,,0.0,0.0
342,0.9276328502415458,494,1004,0.8650328858455717,45428901,9601,10605,10095,/well/papiez/users/hri611/python/nnUNet_results/Dataset219_PETCT/nnUNetTrainer_1500epochs_1e2lr__nnUNetPlans__3d_fullres_maxnum_512_patch_192/crossval_results_folds_0_1_2_3_4/PETCT_63508c679d_02172005.nii.gz,/well/papiez/users/hri611/python/nnUnet_raw/Dataset219_PETCT/labelsTr/PETCT_63508c679d_02172005.nii.gz,0.9276328502415458,5.26255186843872,0.0
343,0.0,0,125,0.0,45759875,0,125,0,/well/papiez/users/hri611/python/nnUNet_results/Dataset219_PETCT/nnUNetTrainer_1500epochs_1e2lr__nnUNetPlans__3d_fullres_maxnum_512_patch_192/crossval_results_folds_0_1_2_3_4/PETCT_63508c679d_08212005.nii.gz,/well/papiez/users/hri611/python/nnUnet_raw/Dataset219_PETCT/labelsTr/PETCT_63508c679d_08212005.nii.gz,0.0,1.5551276206970215,0.0
344,0.8724065239099079,3943,657,0.7736888713962413,52139674,15726,16383,19669,/well/papiez/users/hri611/python/nnUNet_results/Dataset219_PETCT/nnUNetTrainer_1500epochs_1e2lr__nnUNetPlans__3d_fullres_maxnum_512_patch_192/crossval_results_folds_0_1_2_3_4/PETCT_63dd9503eb_01182001.nii.gz,/well/papiez/users/hri611/python/nnUnet_raw/Dataset219_PETCT/labelsTr/PETCT_63dd9503eb_01182001.nii.gz,0.8724065239099079,0.0,2.6499374656677244
345,0.5655010875020914,2194,403,0.39421506881268953,52155713,1690,2093,3884,/well/papiez/users/hri611/python/nnUNet_results/Dataset219_PETCT/nnUNetTrainer_1500epochs_1e2lr__nnUNetPlans__3d_fullres_maxnum_512_patch_192/crossval_results_folds_0_1_2_3_4/PETCT_644d80e987_02152003.nii.gz,/well/papiez/users/hri611/python/nnUnet_raw/Dataset219_PETCT/labelsTr/PETCT_644d80e987_02152003.nii.gz,0.5655010875020914,0.0,0.0
346,0.9061965811965812,583,295,0.8284821254151201,52154881,4241,4536,4824,/well/papiez/users/hri611/python/nnUNet_results/Dataset219_PETCT/nnUNetTrainer_1500epochs_1e2lr__nnUNetPlans__3d_fullres_maxnum_512_patch_192/crossval_results_folds_0_1_2_3_4/PETCT_64909533c5_04142003.nii.gz,/well/papiez/users/hri611/python/nnUnet_raw/Dataset219_PETCT/labelsTr/PETCT_64909533c5_04142003.nii.gz,0.9061965811965812,0.0,0.0
347,,0,0,,49920000,0,0,0,/well/papiez/users/hri611/python/nnUNet_results/Dataset219_PETCT/nnUNetTrainer_1500epochs_1e2lr__nnUNetPlans__3d_fullres_maxnum_512_patch_192/crossval_results_folds_0_1_2_3_4/PETCT_64aff75516_01202006.nii.gz,/well/papiez/users/hri611/python/nnUnet_raw/Dataset219_PETCT/labelsTr/PETCT_64aff75516_01202006.nii.gz,,0.0,0.0
348,,0,0,,47840000,0,0,0,/well/papiez/users/hri611/python/nnUNet_results/Dataset219_PETCT/nnUNetTrainer_1500epochs_1e2lr__nnUNetPlans__3d_fullres_maxnum_512_patch_192/crossval_results_folds_0_1_2_3_4/PETCT_64aff75516_10162005.nii.gz,/well/papiez/users/hri611/python/nnUnet_raw/Dataset219_PETCT/labelsTr/PETCT_64aff75516_10162005.nii.gz,,0.0,0.0
349,,0,0,,41920000,0,0,0,/well/papiez/users/hri611/python/nnUNet_results/Dataset219_PETCT/nnUNetTrainer_1500epochs_1e2lr__nnUNetPlans__3d_fullres_maxnum_512_patch_192/crossval_results_folds_0_1_2_3_4/PETCT_64c0cba177_08072006.nii.gz,/well/papiez/users/hri611/python/nnUnet_raw/Dataset219_PETCT/labelsTr/PETCT_64c0cba177_08072006.nii.gz,,0.0,0.0
350,0.5208681135225376,285,2,0.35214446952595935,92319557,156,158,441,/well/papiez/users/hri611/python/nnUNet_results/Dataset219_PETCT/nnUNetTrainer_1500epochs_1e2lr__nnUNetPlans__3d_fullres_maxnum_512_patch_192/crossval_results_folds_0_1_2_3_4/PETCT_65346b03b8_03142004.nii.gz,/well/papiez/users/hri611/python/nnUnet_raw/Dataset219_PETCT/labelsTr/PETCT_65346b03b8_03142004.nii.gz,0.5208681135225376,0.0,2.6499374656677244
351,0.402493321460374,667,4,0.25195094760312153,52159103,226,230,893,/well/papiez/users/hri611/python/nnUNet_results/Dataset219_PETCT/nnUNetTrainer_1500epochs_1e2lr__nnUNetPlans__3d_fullres_maxnum_512_patch_192/crossval_results_folds_0_1_2_3_4/PETCT_6543c58e13_02252001.nii.gz,/well/papiez/users/hri611/python/nnUnet_raw/Dataset219_PETCT/labelsTr/PETCT_6543c58e13_02252001.nii.gz,0.402493321460374,0.0,2.2891478576660154
352,0.6916011463002425,3824,373,0.5285858699314838,45431097,4706,5079,8530,/well/papiez/users/hri611/python/nnUNet_results/Dataset219_PETCT/nnUNetTrainer_1500epochs_1e2lr__nnUNetPlans__3d_fullres_maxnum_512_patch_192/crossval_results_folds_0_1_2_3_4/PETCT_65a1330e90_06162001.nii.gz,/well/papiez/users/hri611/python/nnUnet_raw/Dataset219_PETCT/labelsTr/PETCT_65a1330e90_06162001.nii.gz,0.6916011463002425,0.0,33.030910663604736
353,0.809258554475314,5154,359,0.6796257554625755,49102792,11695,12054,16849,/well/papiez/users/hri611/python/nnUNet_results/Dataset219_PETCT/nnUNetTrainer_1500epochs_1e2lr__nnUNetPlans__3d_fullres_maxnum_512_patch_192/crossval_results_folds_0_1_2_3_4/PETCT_65bd1a4c38_09302005.nii.gz,/well/papiez/users/hri611/python/nnUnet_raw/Dataset219_PETCT/labelsTr/PETCT_65bd1a4c38_09302005.nii.gz,0.809258554475314,2.2269427528381347,30.144593799591064
354,,0,0,,52160000,0,0,0,/well/papiez/users/hri611/python/nnUNet_results/Dataset219_PETCT/nnUNetTrainer_1500epochs_1e2lr__nnUNetPlans__3d_fullres_maxnum_512_patch_192/crossval_results_folds_0_1_2_3_4/PETCT_6604b228c6_10232004.nii.gz,/well/papiez/users/hri611/python/nnUnet_raw/Dataset219_PETCT/labelsTr/PETCT_6604b228c6_10232004.nii.gz,,0.0,0.0
355,0.0,0,4359,0.0,52155641,0,4359,0,/well/papiez/users/hri611/python/nnUNet_results/Dataset219_PETCT/nnUNetTrainer_1500epochs_1e2lr__nnUNetPlans__3d_fullres_maxnum_512_patch_192/crossval_results_folds_0_1_2_3_4/PETCT_674c49778c_12222002.nii.gz,/well/papiez/users/hri611/python/nnUnet_raw/Dataset219_PETCT/labelsTr/PETCT_674c49778c_12222002.nii.gz,0.0,54.23041038894653,0.0
356,0.6828822015394186,10518,15479,0.5184670667555753,52106012,27991,43470,38509,/well/papiez/users/hri611/python/nnUNet_results/Dataset219_PETCT/nnUNetTrainer_1500epochs_1e2lr__nnUNetPlans__3d_fullres_maxnum_512_patch_192/crossval_results_folds_0_1_2_3_4/PETCT_685d7c09b5_12232000.nii.gz,/well/papiez/users/hri611/python/nnUnet_raw/Dataset219_PETCT/labelsTr/PETCT_685d7c09b5_12232000.nii.gz,0.6828822015394186,0.9579586143493652,2.0030043754577638
357,0.6824837310195228,2188,154,0.5180078205392056,52155141,2517,2671,4705,/well/papiez/users/hri611/python/nnUNet_results/Dataset219_PETCT/nnUNetTrainer_1500epochs_1e2lr__nnUNetPlans__3d_fullres_maxnum_512_patch_192/crossval_results_folds_0_1_2_3_4/PETCT_68b75093c5_11122000.nii.gz,/well/papiez/users/hri611/python/nnUnet_raw/Dataset219_PETCT/labelsTr/PETCT_68b75093c5_11122000.nii.gz,0.6824837310195228,0.0,9.853288604736328
358,0.9695840380701202,955,106,0.9409637213443134,45422028,16911,17017,17866,/well/papiez/users/hri611/python/nnUNet_results/Dataset219_PETCT/nnUNetTrainer_1500epochs_1e2lr__nnUNetPlans__3d_fullres_maxnum_512_patch_192/crossval_results_folds_0_1_2_3_4/PETCT_68f73c4518_11132004.nii.gz,/well/papiez/users/hri611/python/nnUnet_raw/Dataset219_PETCT/labelsTr/PETCT_68f73c4518_11132004.nii.gz,0.9695840380701202,0.0,0.0
359,,0,0,,50560000,0,0,0,/well/papiez/users/hri611/python/nnUNet_results/Dataset219_PETCT/nnUNetTrainer_1500epochs_1e2lr__nnUNetPlans__3d_fullres_maxnum_512_patch_192/crossval_results_folds_0_1_2_3_4/PETCT_69606f6a25_08132006.nii.gz,/well/papiez/users/hri611/python/nnUnet_raw/Dataset219_PETCT/labelsTr/PETCT_69606f6a25_08132006.nii.gz,,0.0,0.0
360,,0,0,,38720000,0,0,0,/well/papiez/users/hri611/python/nnUNet_results/Dataset219_PETCT/nnUNetTrainer_1500epochs_1e2lr__nnUNetPlans__3d_fullres_maxnum_512_patch_192/crossval_results_folds_0_1_2_3_4/PETCT_69aa8dbfd2_05242003.nii.gz,/well/papiez/users/hri611/python/nnUnet_raw/Dataset219_PETCT/labelsTr/PETCT_69aa8dbfd2_05242003.nii.gz,,0.0,0.0
361,,0,0,,44320000,0,0,0,/well/papiez/users/hri611/python/nnUNet_results/Dataset219_PETCT/nnUNetTrainer_1500epochs_1e2lr__nnUNetPlans__3d_fullres_maxnum_512_patch_192/crossval_results_folds_0_1_2_3_4/PETCT_69c90b6820_11212005.nii.gz,/well/papiez/users/hri611/python/nnUnet_raw/Dataset219_PETCT/labelsTr/PETCT_69c90b6820_11212005.nii.gz,,0.0,0.0
362,,0,0,,52160000,0,0,0,/well/papiez/users/hri611/python/nnUNet_results/Dataset219_PETCT/nnUNetTrainer_1500epochs_1e2lr__nnUNetPlans__3d_fullres_maxnum_512_patch_192/crossval_results_folds_0_1_2_3_4/PETCT_69ee62b035_12262002.nii.gz,/well/papiez/users/hri611/python/nnUnet_raw/Dataset219_PETCT/labelsTr/PETCT_69ee62b035_12262002.nii.gz,,0.0,0.0
363,0.8683761978712927,21752,9523,0.7673718034542777,45305558,103167,112690,124919,/well/papiez/users/hri611/python/nnUNet_results/Dataset219_PETCT/nnUNetTrainer_1500epochs_1e2lr__nnUNetPlans__3d_fullres_maxnum_512_patch_192/crossval_results_folds_0_1_2_3_4/PETCT_6a3477cd9a_01152005.nii.gz,/well/papiez/users/hri611/python/nnUnet_raw/Dataset219_PETCT/labelsTr/PETCT_6a3477cd9a_01152005.nii.gz,0.8683761978712927,11.035185596466064,22.841714492797852
364,0.46014856454527203,2615,74,0.29882659713168186,45436165,1146,1220,3761,/well/papiez/users/hri611/python/nnUNet_results/Dataset219_PETCT/nnUNetTrainer_1500epochs_1e2lr__nnUNetPlans__3d_fullres_maxnum_512_patch_192/crossval_results_folds_0_1_2_3_4/PETCT_6aea5c3a03_12272001.nii.gz,/well/papiez/users/hri611/python/nnUnet_raw/Dataset219_PETCT/labelsTr/PETCT_6aea5c3a03_12272001.nii.gz,0.46014856454527203,0.2861434822082519,28.62678924179077
365,0.0,0,7,0.0,51839993,0,7,0,/well/papiez/users/hri611/python/nnUNet_results/Dataset219_PETCT/nnUNetTrainer_1500epochs_1e2lr__nnUNetPlans__3d_fullres_maxnum_512_patch_192/crossval_results_folds_0_1_2_3_4/PETCT_6b177a3c28_06302005.nii.gz,/well/papiez/users/hri611/python/nnUnet_raw/Dataset219_PETCT/labelsTr/PETCT_6b177a3c28_06302005.nii.gz,0.0,0.0870871467590332,0.0
366,,0,0,,38720000,0,0,0,/well/papiez/users/hri611/python/nnUNet_results/Dataset219_PETCT/nnUNetTrainer_1500epochs_1e2lr__nnUNetPlans__3d_fullres_maxnum_512_patch_192/crossval_results_folds_0_1_2_3_4/PETCT_6b20c7eabb_07312003.nii.gz,/well/papiez/users/hri611/python/nnUnet_raw/Dataset219_PETCT/labelsTr/PETCT_6b20c7eabb_07312003.nii.gz,,0.0,0.0
367,0.8876691345417411,1572,1068,0.7980261647922883,51666929,10431,11499,12003,/well/papiez/users/hri611/python/nnUNet_results/Dataset219_PETCT/nnUNetTrainer_1500epochs_1e2lr__nnUNetPlans__3d_fullres_maxnum_512_patch_192/crossval_results_folds_0_1_2_3_4/PETCT_6c23f2686d_04212007.nii.gz,/well/papiez/users/hri611/python/nnUnet_raw/Dataset219_PETCT/labelsTr/PETCT_6c23f2686d_04212007.nii.gz,0.8876691345417411,2.314029899597168,0.0
368,0.8227148472574176,3498,5387,0.6988237686858073,45410499,20616,26003,24114,/well/papiez/users/hri611/python/nnUNet_results/Dataset219_PETCT/nnUNetTrainer_1500epochs_1e2lr__nnUNetPlans__3d_fullres_maxnum_512_patch_192/crossval_results_folds_0_1_2_3_4/PETCT_6c469107a0_06232002.nii.gz,/well/papiez/users/hri611/python/nnUnet_raw/Dataset219_PETCT/labelsTr/PETCT_6c469107a0_06232002.nii.gz,0.8227148472574176,2.5130862350463867,11.483062351226806
369,0.8518627163391024,290,215,0.741951967296883,95838043,1452,1667,1742,/well/papiez/users/hri611/python/nnUNet_results/Dataset219_PETCT/nnUNetTrainer_1500epochs_1e2lr__nnUNetPlans__3d_fullres_maxnum_512_patch_192/crossval_results_folds_0_1_2_3_4/PETCT_6c660140ca_08062006.nii.gz,/well/papiez/users/hri611/python/nnUnet_raw/Dataset219_PETCT/labelsTr/PETCT_6c660140ca_08062006.nii.gz,0.8518627163391024,0.9081945304870606,0.0
370,0.9540372670807453,18,19,0.9121140142517815,54079579,384,403,402,/well/papiez/users/hri611/python/nnUNet_results/Dataset219_PETCT/nnUNetTrainer_1500epochs_1e2lr__nnUNetPlans__3d_fullres_maxnum_512_patch_192/crossval_results_folds_0_1_2_3_4/PETCT_6d62e15c29_02232007.nii.gz,/well/papiez/users/hri611/python/nnUnet_raw/Dataset219_PETCT/labelsTr/PETCT_6d62e15c29_02232007.nii.gz,0.9540372670807453,0.0,0.0
371,0.0,0,13,0.0,54879987,0,13,0,/well/papiez/users/hri611/python/nnUNet_results/Dataset219_PETCT/nnUNetTrainer_1500epochs_1e2lr__nnUNetPlans__3d_fullres_maxnum_512_patch_192/crossval_results_folds_0_1_2_3_4/PETCT_6d62e15c29_08242006.nii.gz,/well/papiez/users/hri611/python/nnUnet_raw/Dataset219_PETCT/labelsTr/PETCT_6d62e15c29_08242006.nii.gz,0.0,0.16173327255249023,0.0
372,0.880122082179393,1404,717,0.7859089532653679,52150093,7786,8503,9190,/well/papiez/users/hri611/python/nnUNet_results/Dataset219_PETCT/nnUNetTrainer_1500epochs_1e2lr__nnUNetPlans__3d_fullres_maxnum_512_patch_192/crossval_results_folds_0_1_2_3_4/PETCT_6d6a193655_11172002.nii.gz,/well/papiez/users/hri611/python/nnUnet_raw/Dataset219_PETCT/labelsTr/PETCT_6d6a193655_11172002.nii.gz,0.880122082179393,0.0,0.0
373,,0,0,,45440000,0,0,0,/well/papiez/users/hri611/python/nnUNet_results/Dataset219_PETCT/nnUNetTrainer_1500epochs_1e2lr__nnUNetPlans__3d_fullres_maxnum_512_patch_192/crossval_results_folds_0_1_2_3_4/PETCT_6dd36a2c19_11282003.nii.gz,/well/papiez/users/hri611/python/nnUnet_raw/Dataset219_PETCT/labelsTr/PETCT_6dd36a2c19_11282003.nii.gz,,0.0,0.0
374,0.0,0,1782,0.0,52158218,0,1782,0,/well/papiez/users/hri611/python/nnUNet_results/Dataset219_PETCT/nnUNetTrainer_1500epochs_1e2lr__nnUNetPlans__3d_fullres_maxnum_512_patch_192/crossval_results_folds_0_1_2_3_4/PETCT_6e1dba94e8_11152002.nii.gz,/well/papiez/users/hri611/python/nnUnet_raw/Dataset219_PETCT/labelsTr/PETCT_6e1dba94e8_11152002.nii.gz,0.0,22.16989936065674,0.0
375,0.9001828303786027,3349,1510,0.8184840673913856,52133231,21910,23420,25259,/well/papiez/users/hri611/python/nnUNet_results/Dataset219_PETCT/nnUNetTrainer_1500epochs_1e2lr__nnUNetPlans__3d_fullres_maxnum_512_patch_192/crossval_results_folds_0_1_2_3_4/PETCT_6e7c7f8087_03232003.nii.gz,/well/papiez/users/hri611/python/nnUnet_raw/Dataset219_PETCT/labelsTr/PETCT_6e7c7f8087_03232003.nii.gz,0.9001828303786027,0.0870871467590332,2.4384401092529298
376,0.7653359298928919,119,122,0.6198738170347003,52159366,393,515,512,/well/papiez/users/hri611/python/nnUNet_results/Dataset219_PETCT/nnUNetTrainer_1500epochs_1e2lr__nnUNetPlans__3d_fullres_maxnum_512_patch_192/crossval_results_folds_0_1_2_3_4/PETCT_6efefcb92a_03262005.nii.gz,/well/papiez/users/hri611/python/nnUnet_raw/Dataset219_PETCT/labelsTr/PETCT_6efefcb92a_03262005.nii.gz,0.7653359298928919,1.2689841384887695,0.0
377,,0,0,,94240000,0,0,0,/well/papiez/users/hri611/python/nnUNet_results/Dataset219_PETCT/nnUNetTrainer_1500epochs_1e2lr__nnUNetPlans__3d_fullres_maxnum_512_patch_192/crossval_results_folds_0_1_2_3_4/PETCT_6f46454a8d_09032005.nii.gz,/well/papiez/users/hri611/python/nnUnet_raw/Dataset219_PETCT/labelsTr/PETCT_6f46454a8d_09032005.nii.gz,,0.0,0.0
378,0.0,0,4,0.0,99039996,0,4,0,/well/papiez/users/hri611/python/nnUNet_results/Dataset219_PETCT/nnUNetTrainer_1500epochs_1e2lr__nnUNetPlans__3d_fullres_maxnum_512_patch_192/crossval_results_folds_0_1_2_3_4/PETCT_6f46454a8d_09072003.nii.gz,/well/papiez/users/hri611/python/nnUnet_raw/Dataset219_PETCT/labelsTr/PETCT_6f46454a8d_09072003.nii.gz,0.0,0.04976408386230469,0.0
379,,0,0,,99040000,0,0,0,/well/papiez/users/hri611/python/nnUNet_results/Dataset219_PETCT/nnUNetTrainer_1500epochs_1e2lr__nnUNetPlans__3d_fullres_maxnum_512_patch_192/crossval_results_folds_0_1_2_3_4/PETCT_6f46454a8d_09122002.nii.gz,/well/papiez/users/hri611/python/nnUnet_raw/Dataset219_PETCT/labelsTr/PETCT_6f46454a8d_09122002.nii.gz,,0.0,0.0
380,0.8522242654250949,3184,593,0.742500681756204,52145332,10891,11484,14075,/well/papiez/users/hri611/python/nnUNet_results/Dataset219_PETCT/nnUNetTrainer_1500epochs_1e2lr__nnUNetPlans__3d_fullres_maxnum_512_patch_192/crossval_results_folds_0_1_2_3_4/PETCT_6fe855c937_12292001.nii.gz,/well/papiez/users/hri611/python/nnUnet_raw/Dataset219_PETCT/labelsTr/PETCT_6fe855c937_12292001.nii.gz,0.8522242654250949,0.0,1.2192200546264649
381,0.5490394337714863,869,23,0.378397212543554,52158565,543,566,1412,/well/papiez/users/hri611/python/nnUNet_results/Dataset219_PETCT/nnUNetTrainer_1500epochs_1e2lr__nnUNetPlans__3d_fullres_maxnum_512_patch_192/crossval_results_folds_0_1_2_3_4/PETCT_7094acd4c0_08232001.nii.gz,/well/papiez/users/hri611/python/nnUnet_raw/Dataset219_PETCT/labelsTr/PETCT_7094acd4c0_08232001.nii.gz,0.5490394337714863,0.0,9.281001640319824
382,0.9093468062071455,1295,6241,0.8337634835550262,45394667,37797,44038,39092,/well/papiez/users/hri611/python/nnUNet_results/Dataset219_PETCT/nnUNetTrainer_1500epochs_1e2lr__nnUNetPlans__3d_fullres_maxnum_512_patch_192/crossval_results_folds_0_1_2_3_4/PETCT_7147385005_05092002.nii.gz,/well/papiez/users/hri611/python/nnUnet_raw/Dataset219_PETCT/labelsTr/PETCT_7147385005_05092002.nii.gz,0.9093468062071455,4.553413673400879,0.9703996353149413
383,,0,0,,88000000,0,0,0,/well/papiez/users/hri611/python/nnUNet_results/Dataset219_PETCT/nnUNetTrainer_1500epochs_1e2lr__nnUNetPlans__3d_fullres_maxnum_512_patch_192/crossval_results_folds_0_1_2_3_4/PETCT_71ac560ffe_03192007.nii.gz,/well/papiez/users/hri611/python/nnUnet_raw/Dataset219_PETCT/labelsTr/PETCT_71ac560ffe_03192007.nii.gz,,0.0,0.0
384,,0,0,,45440000,0,0,0,/well/papiez/users/hri611/python/nnUNet_results/Dataset219_PETCT/nnUNetTrainer_1500epochs_1e2lr__nnUNetPlans__3d_fullres_maxnum_512_patch_192/crossval_results_folds_0_1_2_3_4/PETCT_71ae114917_04132003.nii.gz,/well/papiez/users/hri611/python/nnUnet_raw/Dataset219_PETCT/labelsTr/PETCT_71ae114917_04132003.nii.gz,,0.0,0.0
385,,0,0,,50880000,0,0,0,/well/papiez/users/hri611/python/nnUNet_results/Dataset219_PETCT/nnUNetTrainer_1500epochs_1e2lr__nnUNetPlans__3d_fullres_maxnum_512_patch_192/crossval_results_folds_0_1_2_3_4/PETCT_72725f2bda_07062007.nii.gz,/well/papiez/users/hri611/python/nnUnet_raw/Dataset219_PETCT/labelsTr/PETCT_72725f2bda_07062007.nii.gz,,0.0,0.0
386,0.0,0,94,0.0,38239906,0,94,0,/well/papiez/users/hri611/python/nnUNet_results/Dataset219_PETCT/nnUNetTrainer_1500epochs_1e2lr__nnUNetPlans__3d_fullres_maxnum_512_patch_192/crossval_results_folds_0_1_2_3_4/PETCT_72d2d6de52_08052005.nii.gz,/well/papiez/users/hri611/python/nnUnet_raw/Dataset219_PETCT/labelsTr/PETCT_72d2d6de52_08052005.nii.gz,0.0,1.16945597076416,0.0
387,0.8298334540188269,1442,908,0.7091584158415841,45431920,5730,6638,7172,/well/papiez/users/hri611/python/nnUNet_results/Dataset219_PETCT/nnUNetTrainer_1500epochs_1e2lr__nnUNetPlans__3d_fullres_maxnum_512_patch_192/crossval_results_folds_0_1_2_3_4/PETCT_72ee9ec897_11122001.nii.gz,/well/papiez/users/hri611/python/nnUnet_raw/Dataset219_PETCT/labelsTr/PETCT_72ee9ec897_11122001.nii.gz,0.8298334540188269,5.212787784576416,0.0
388,0.7571523449473792,7456,11558,0.6092076867742267,45071345,29641,41199,37097,/well/papiez/users/hri611/python/nnUNet_results/Dataset219_PETCT/nnUNetTrainer_1500epochs_1e2lr__nnUNetPlans__3d_fullres_maxnum_512_patch_192/crossval_results_folds_0_1_2_3_4/PETCT_7323c415d0_02262006.nii.gz,/well/papiez/users/hri611/python/nnUnet_raw/Dataset219_PETCT/labelsTr/PETCT_7323c415d0_02262006.nii.gz,0.7571523449473792,9.330765724182129,7.86272525024414
389,0.8801542568970632,1615,809,0.7859602649006623,84308675,8901,9710,10516,/well/papiez/users/hri611/python/nnUNet_results/Dataset219_PETCT/nnUNetTrainer_1500epochs_1e2lr__nnUNetPlans__3d_fullres_maxnum_512_patch_192/crossval_results_folds_0_1_2_3_4/PETCT_73597f33fe_02102007.nii.gz,/well/papiez/users/hri611/python/nnUnet_raw/Dataset219_PETCT/labelsTr/PETCT_73597f33fe_02102007.nii.gz,0.8801542568970632,1.5426865997314452,2.2891478576660154
390,0.8368364636249243,5943,1059,0.7194486737719369,84455042,17956,19015,23899,/well/papiez/users/hri611/python/nnUNet_results/Dataset219_PETCT/nnUNetTrainer_1500epochs_1e2lr__nnUNetPlans__3d_fullres_maxnum_512_patch_192/crossval_results_folds_0_1_2_3_4/PETCT_73597f33fe_05172007.nii.gz,/well/papiez/users/hri611/python/nnUnet_raw/Dataset219_PETCT/labelsTr/PETCT_73597f33fe_05172007.nii.gz,0.8368364636249243,2.1274145851135255,3.495926891326904
391,0.0,0,84,0.0,51839916,0,84,0,/well/papiez/users/hri611/python/nnUNet_results/Dataset219_PETCT/nnUNetTrainer_1500epochs_1e2lr__nnUNetPlans__3d_fullres_maxnum_512_patch_192/crossval_results_folds_0_1_2_3_4/PETCT_7365362464_03222007.nii.gz,/well/papiez/users/hri611/python/nnUnet_raw/Dataset219_PETCT/labelsTr/PETCT_7365362464_03222007.nii.gz,0.0,1.0450457611083985,0.0
392,0.9345198565546553,587,2371,0.8770880079780603,48135934,21108,23479,21695,/well/papiez/users/hri611/python/nnUNet_results/Dataset219_PETCT/nnUNetTrainer_1500epochs_1e2lr__nnUNetPlans__3d_fullres_maxnum_512_patch_192/crossval_results_folds_0_1_2_3_4/PETCT_73fda3a382_08122005.nii.gz,/well/papiez/users/hri611/python/nnUnet_raw/Dataset219_PETCT/labelsTr/PETCT_73fda3a382_08122005.nii.gz,0.9345198565546553,2.9111989059448242,0.037323062896728515
393,,0,0,,38720000,0,0,0,/well/papiez/users/hri611/python/nnUNet_results/Dataset219_PETCT/nnUNetTrainer_1500epochs_1e2lr__nnUNetPlans__3d_fullres_maxnum_512_patch_192/crossval_results_folds_0_1_2_3_4/PETCT_741f6130ed_11282004.nii.gz,/well/papiez/users/hri611/python/nnUnet_raw/Dataset219_PETCT/labelsTr/PETCT_741f6130ed_11282004.nii.gz,,0.0,0.0
394,0.9168660748745658,2177,1054,0.8464937286202965,52138952,17817,18871,19994,/well/papiez/users/hri611/python/nnUNet_results/Dataset219_PETCT/nnUNetTrainer_1500epochs_1e2lr__nnUNetPlans__3d_fullres_maxnum_512_patch_192/crossval_results_folds_0_1_2_3_4/PETCT_742a9413db_11102001.nii.gz,/well/papiez/users/hri611/python/nnUnet_raw/Dataset219_PETCT/labelsTr/PETCT_742a9413db_11102001.nii.gz,0.9168660748745658,0.012441020965576172,0.0
395,0.6410256410256411,0,112,0.4716981132075472,45119788,100,212,100,/well/papiez/users/hri611/python/nnUNet_results/Dataset219_PETCT/nnUNetTrainer_1500epochs_1e2lr__nnUNetPlans__3d_fullres_maxnum_512_patch_192/crossval_results_folds_0_1_2_3_4/PETCT_74bbceaeeb_06032005.nii.gz,/well/papiez/users/hri611/python/nnUnet_raw/Dataset219_PETCT/labelsTr/PETCT_74bbceaeeb_06032005.nii.gz,0.6410256410256411,0.09952816772460937,0.0
396,0.0,0,40,0.0,52159960,0,40,0,/well/papiez/users/hri611/python/nnUNet_results/Dataset219_PETCT/nnUNetTrainer_1500epochs_1e2lr__nnUNetPlans__3d_fullres_maxnum_512_patch_192/crossval_results_folds_0_1_2_3_4/PETCT_75046e0c12_10292004.nii.gz,/well/papiez/users/hri611/python/nnUnet_raw/Dataset219_PETCT/labelsTr/PETCT_75046e0c12_10292004.nii.gz,0.0,0.49764083862304687,0.0
397,0.0,0,164,0.0,46079836,0,164,0,/well/papiez/users/hri611/python/nnUNet_results/Dataset219_PETCT/nnUNetTrainer_1500epochs_1e2lr__nnUNetPlans__3d_fullres_maxnum_512_patch_192/crossval_results_folds_0_1_2_3_4/PETCT_75210090cd_07022005.nii.gz,/well/papiez/users/hri611/python/nnUnet_raw/Dataset219_PETCT/labelsTr/PETCT_75210090cd_07022005.nii.gz,0.0,2.0403274383544923,0.0
398,0.0,0,268,0.0,52159732,0,268,0,/well/papiez/users/hri611/python/nnUNet_results/Dataset219_PETCT/nnUNetTrainer_1500epochs_1e2lr__nnUNetPlans__3d_fullres_maxnum_512_patch_192/crossval_results_folds_0_1_2_3_4/PETCT_75d1080946_07282003.nii.gz,/well/papiez/users/hri611/python/nnUnet_raw/Dataset219_PETCT/labelsTr/PETCT_75d1080946_07282003.nii.gz,0.0,3.334193618774414,0.0
399,,0,0,,38720000,0,0,0,/well/papiez/users/hri611/python/nnUNet_results/Dataset219_PETCT/nnUNetTrainer_1500epochs_1e2lr__nnUNetPlans__3d_fullres_maxnum_512_patch_192/crossval_results_folds_0_1_2_3_4/PETCT_75d5e740f0_07112002.nii.gz,/well/papiez/users/hri611/python/nnUnet_raw/Dataset219_PETCT/labelsTr/PETCT_75d5e740f0_07112002.nii.gz,,0.0,0.0
400,0.0,0,112,0.0,52159888,0,112,0,/well/papiez/users/hri611/python/nnUNet_results/Dataset219_PETCT/nnUNetTrainer_1500epochs_1e2lr__nnUNetPlans__3d_fullres_maxnum_512_patch_192/crossval_results_folds_0_1_2_3_4/PETCT_75e42ff05f_09212002.nii.gz,/well/papiez/users/hri611/python/nnUnet_raw/Dataset219_PETCT/labelsTr/PETCT_75e42ff05f_09212002.nii.gz,0.0,1.3933943481445312,0.0
401,0.05740482359976081,4722,7,0.029550584855325263,45435127,144,151,4866,/well/papiez/users/hri611/python/nnUNet_results/Dataset219_PETCT/nnUNetTrainer_1500epochs_1e2lr__nnUNetPlans__3d_fullres_maxnum_512_patch_192/crossval_results_folds_0_1_2_3_4/PETCT_760c77b289_01202002.nii.gz,/well/papiez/users/hri611/python/nnUnet_raw/Dataset219_PETCT/labelsTr/PETCT_760c77b289_01202002.nii.gz,0.05740482359976081,0.0,58.311065265655515
402,,0,0,,45440000,0,0,0,/well/papiez/users/hri611/python/nnUNet_results/Dataset219_PETCT/nnUNetTrainer_1500epochs_1e2lr__nnUNetPlans__3d_fullres_maxnum_512_patch_192/crossval_results_folds_0_1_2_3_4/PETCT_777fa0ba88_04072003.nii.gz,/well/papiez/users/hri611/python/nnUnet_raw/Dataset219_PETCT/labelsTr/PETCT_777fa0ba88_04072003.nii.gz,,0.0,0.0
403,0.0,0,79,0.0,45439921,0,79,0,/well/papiez/users/hri611/python/nnUNet_results/Dataset219_PETCT/nnUNetTrainer_1500epochs_1e2lr__nnUNetPlans__3d_fullres_maxnum_512_patch_192/crossval_results_folds_0_1_2_3_4/PETCT_777fa0ba88_11042002.nii.gz,/well/papiez/users/hri611/python/nnUnet_raw/Dataset219_PETCT/labelsTr/PETCT_777fa0ba88_11042002.nii.gz,0.0,0.9828406562805175,0.0
404,0.0,338,11,0.0,97279651,0,11,338,/well/papiez/users/hri611/python/nnUNet_results/Dataset219_PETCT/nnUNetTrainer_1500epochs_1e2lr__nnUNetPlans__3d_fullres_maxnum_512_patch_192/crossval_results_folds_0_1_2_3_4/PETCT_7785c10e91_12152006.nii.gz,/well/papiez/users/hri611/python/nnUnet_raw/Dataset219_PETCT/labelsTr/PETCT_7785c10e91_12152006.nii.gz,0.0,0.1368512306213379,4.205065086364746
405,0.8536398467432951,375,7,0.7446524064171123,45438504,1114,1121,1489,/well/papiez/users/hri611/python/nnUNet_results/Dataset219_PETCT/nnUNetTrainer_1500epochs_1e2lr__nnUNetPlans__3d_fullres_maxnum_512_patch_192/crossval_results_folds_0_1_2_3_4/PETCT_77bceab232_11212002.nii.gz,/well/papiez/users/hri611/python/nnUnet_raw/Dataset219_PETCT/labelsTr/PETCT_77bceab232_11212002.nii.gz,0.8536398467432951,0.0,2.2145017318725584
406,0.0,0,19,0.0,52959981,0,19,0,/well/papiez/users/hri611/python/nnUNet_results/Dataset219_PETCT/nnUNetTrainer_1500epochs_1e2lr__nnUNetPlans__3d_fullres_maxnum_512_patch_192/crossval_results_folds_0_1_2_3_4/PETCT_78355d1d4f_01232006.nii.gz,/well/papiez/users/hri611/python/nnUnet_raw/Dataset219_PETCT/labelsTr/PETCT_78355d1d4f_01232006.nii.gz,0.0,0.23637939834594726,0.0
407,,0,0,,52160000,0,0,0,/well/papiez/users/hri611/python/nnUNet_results/Dataset219_PETCT/nnUNetTrainer_1500epochs_1e2lr__nnUNetPlans__3d_fullres_maxnum_512_patch_192/crossval_results_folds_0_1_2_3_4/PETCT_78b89bc739_11082004.nii.gz,/well/papiez/users/hri611/python/nnUnet_raw/Dataset219_PETCT/labelsTr/PETCT_78b89bc739_11082004.nii.gz,,0.0,0.0
408,0.7099651027530051,0,4488,0.5503456567478209,45430019,5493,9981,5493,/well/papiez/users/hri611/python/nnUNet_results/Dataset219_PETCT/nnUNetTrainer_1500epochs_1e2lr__nnUNetPlans__3d_fullres_maxnum_512_patch_192/crossval_results_folds_0_1_2_3_4/PETCT_790246c76c_02072004.nii.gz,/well/papiez/users/hri611/python/nnUnet_raw/Dataset219_PETCT/labelsTr/PETCT_790246c76c_02072004.nii.gz,0.7099651027530051,2.6623784866333007,0.0
409,0.8870755461963674,72,2502,0.7970671712393567,72147316,10110,12612,10182,/well/papiez/users/hri611/python/nnUNet_results/Dataset219_PETCT/nnUNetTrainer_1500epochs_1e2lr__nnUNetPlans__3d_fullres_maxnum_512_patch_192/crossval_results_folds_0_1_2_3_4/PETCT_791ec15924_04162001.nii.gz,/well/papiez/users/hri611/python/nnUnet_raw/Dataset219_PETCT/labelsTr/PETCT_791ec15924_04162001.nii.gz,0.8870755461963674,0.5598459434509278,0.49764083862304687
410,0.0,0,39,0.0,31999961,0,39,0,/well/papiez/users/hri611/python/nnUNet_results/Dataset219_PETCT/nnUNetTrainer_1500epochs_1e2lr__nnUNetPlans__3d_fullres_maxnum_512_patch_192/crossval_results_folds_0_1_2_3_4/PETCT_792d7b6ad0_04042005.nii.gz,/well/papiez/users/hri611/python/nnUnet_raw/Dataset219_PETCT/labelsTr/PETCT_792d7b6ad0_04042005.nii.gz,0.0,0.48519981765747067,0.0
411,0.61688368434851,8391,377,0.4460099829405446,45424173,7059,7436,15450,/well/papiez/users/hri611/python/nnUNet_results/Dataset219_PETCT/nnUNetTrainer_1500epochs_1e2lr__nnUNetPlans__3d_fullres_maxnum_512_patch_192/crossval_results_folds_0_1_2_3_4/PETCT_7948aa0e26_08102001.nii.gz,/well/papiez/users/hri611/python/nnUnet_raw/Dataset219_PETCT/labelsTr/PETCT_7948aa0e26_08102001.nii.gz,0.61688368434851,0.0,40.097410572052
412,0.9411764705882353,32,10,0.8888888888888888,52159622,336,346,368,/well/papiez/users/hri611/python/nnUNet_results/Dataset219_PETCT/nnUNetTrainer_1500epochs_1e2lr__nnUNetPlans__3d_fullres_maxnum_512_patch_192/crossval_results_folds_0_1_2_3_4/PETCT_7958ce0f7c_08312003.nii.gz,/well/papiez/users/hri611/python/nnUnet_raw/Dataset219_PETCT/labelsTr/PETCT_7958ce0f7c_08312003.nii.gz,0.9411764705882353,0.0,0.0
413,,0,0,,45440000,0,0,0,/well/papiez/users/hri611/python/nnUNet_results/Dataset219_PETCT/nnUNetTrainer_1500epochs_1e2lr__nnUNetPlans__3d_fullres_maxnum_512_patch_192/crossval_results_folds_0_1_2_3_4/PETCT_7978e9fe62_03232003.nii.gz,/well/papiez/users/hri611/python/nnUnet_raw/Dataset219_PETCT/labelsTr/PETCT_7978e9fe62_03232003.nii.gz,,0.0,0.0
414,0.0,0,2,0.0,49119998,0,2,0,/well/papiez/users/hri611/python/nnUNet_results/Dataset219_PETCT/nnUNetTrainer_1500epochs_1e2lr__nnUNetPlans__3d_fullres_maxnum_512_patch_192/crossval_results_folds_0_1_2_3_4/PETCT_7a262070a9_11252005.nii.gz,/well/papiez/users/hri611/python/nnUnet_raw/Dataset219_PETCT/labelsTr/PETCT_7a262070a9_11252005.nii.gz,0.0,0.024882041931152343,0.0
415,,0,0,,46240000,0,0,0,/well/papiez/users/hri611/python/nnUNet_results/Dataset219_PETCT/nnUNetTrainer_1500epochs_1e2lr__nnUNetPlans__3d_fullres_maxnum_512_patch_192/crossval_results_folds_0_1_2_3_4/PETCT_7a3a27371a_04132006.nii.gz,/well/papiez/users/hri611/python/nnUnet_raw/Dataset219_PETCT/labelsTr/PETCT_7a3a27371a_04132006.nii.gz,,0.0,0.0
416,0.6860987977166183,9093,750,0.5221844660194175,45419400,10757,11507,19850,/well/papiez/users/hri611/python/nnUNet_results/Dataset219_PETCT/nnUNetTrainer_1500epochs_1e2lr__nnUNetPlans__3d_fullres_maxnum_512_patch_192/crossval_results_folds_0_1_2_3_4/PETCT_7a77b26403_10202000.nii.gz,/well/papiez/users/hri611/python/nnUnet_raw/Dataset219_PETCT/labelsTr/PETCT_7a77b26403_10202000.nii.gz,0.6860987977166183,0.2861434822082519,17.39254730987549
417,0.7817134880474612,4108,896,0.6416499570323689,52146036,8960,9856,13068,/well/papiez/users/hri611/python/nnUNet_results/Dataset219_PETCT/nnUNetTrainer_1500epochs_1e2lr__nnUNetPlans__3d_fullres_maxnum_512_patch_192/crossval_results_folds_0_1_2_3_4/PETCT_7a8a062ed5_03122005.nii.gz,/well/papiez/users/hri611/python/nnUnet_raw/Dataset219_PETCT/labelsTr/PETCT_7a8a062ed5_03122005.nii.gz,0.7817134880474612,9.604468185424805,0.012441020965576172
418,0.0,0,37,0.0,43519963,0,37,0,/well/papiez/users/hri611/python/nnUNet_results/Dataset219_PETCT/nnUNetTrainer_1500epochs_1e2lr__nnUNetPlans__3d_fullres_maxnum_512_patch_192/crossval_results_folds_0_1_2_3_4/PETCT_7abe274c10_09212006.nii.gz,/well/papiez/users/hri611/python/nnUnet_raw/Dataset219_PETCT/labelsTr/PETCT_7abe274c10_09212006.nii.gz,0.0,0.4603177757263184,0.0
419,0.8505135169163803,7451,860,0.7399073668398323,45408046,23643,24503,31094,/well/papiez/users/hri611/python/nnUNet_results/Dataset219_PETCT/nnUNetTrainer_1500epochs_1e2lr__nnUNetPlans__3d_fullres_maxnum_512_patch_192/crossval_results_folds_0_1_2_3_4/PETCT_7b42056ee3_10132002.nii.gz,/well/papiez/users/hri611/python/nnUnet_raw/Dataset219_PETCT/labelsTr/PETCT_7b42056ee3_10132002.nii.gz,0.8505135169163803,0.0,0.0
420,,0,0,,92320000,0,0,0,/well/papiez/users/hri611/python/nnUNet_results/Dataset219_PETCT/nnUNetTrainer_1500epochs_1e2lr__nnUNetPlans__3d_fullres_maxnum_512_patch_192/crossval_results_folds_0_1_2_3_4/PETCT_7b477e7e0d_06192003.nii.gz,/well/papiez/users/hri611/python/nnUnet_raw/Dataset219_PETCT/labelsTr/PETCT_7b477e7e0d_06192003.nii.gz,,0.0,0.0
421,0.8306525434811037,5790,685,0.7103556251397898,99017645,15880,16565,21670,/well/papiez/users/hri611/python/nnUNet_results/Dataset219_PETCT/nnUNetTrainer_1500epochs_1e2lr__nnUNetPlans__3d_fullres_maxnum_512_patch_192/crossval_results_folds_0_1_2_3_4/PETCT_7b477e7e0d_07262002.nii.gz,/well/papiez/users/hri611/python/nnUnet_raw/Dataset219_PETCT/labelsTr/PETCT_7b477e7e0d_07262002.nii.gz,0.8306525434811037,0.9579586143493652,5.138141658782959
422,0.0,0,11,0.0,52159989,0,11,0,/well/papiez/users/hri611/python/nnUNet_results/Dataset219_PETCT/nnUNetTrainer_1500epochs_1e2lr__nnUNetPlans__3d_fullres_maxnum_512_patch_192/crossval_results_folds_0_1_2_3_4/PETCT_7b9d625330_11172002.nii.gz,/well/papiez/users/hri611/python/nnUnet_raw/Dataset219_PETCT/labelsTr/PETCT_7b9d625330_11172002.nii.gz,0.0,0.1368512306213379,0.0
423,0.0,0,6,0.0,99039994,0,6,0,/well/papiez/users/hri611/python/nnUNet_results/Dataset219_PETCT/nnUNetTrainer_1500epochs_1e2lr__nnUNetPlans__3d_fullres_maxnum_512_patch_192/crossval_results_folds_0_1_2_3_4/PETCT_7c1e6175e0_01302005.nii.gz,/well/papiez/users/hri611/python/nnUnet_raw/Dataset219_PETCT/labelsTr/PETCT_7c1e6175e0_01302005.nii.gz,0.0,0.07464612579345703,0.0
424,0.0,0,46,0.0,52159954,0,46,0,/well/papiez/users/hri611/python/nnUNet_results/Dataset219_PETCT/nnUNetTrainer_1500epochs_1e2lr__nnUNetPlans__3d_fullres_maxnum_512_patch_192/crossval_results_folds_0_1_2_3_4/PETCT_7c96c4626d_06302003.nii.gz,/well/papiez/users/hri611/python/nnUnet_raw/Dataset219_PETCT/labelsTr/PETCT_7c96c4626d_06302003.nii.gz,0.0,0.5722869644165038,0.0
425,0.876604146100691,38,87,0.7803163444639719,89279431,444,531,482,/well/papiez/users/hri611/python/nnUNet_results/Dataset219_PETCT/nnUNetTrainer_1500epochs_1e2lr__nnUNetPlans__3d_fullres_maxnum_512_patch_192/crossval_results_folds_0_1_2_3_4/PETCT_7ce196485f_01192006.nii.gz,/well/papiez/users/hri611/python/nnUnet_raw/Dataset219_PETCT/labelsTr/PETCT_7ce196485f_01192006.nii.gz,0.876604146100691,0.3981126708984375,0.0
426,0.7012307257037771,347,3877,0.5399193987583052,92150819,4957,8834,5304,/well/papiez/users/hri611/python/nnUNet_results/Dataset219_PETCT/nnUNetTrainer_1500epochs_1e2lr__nnUNetPlans__3d_fullres_maxnum_512_patch_192/crossval_results_folds_0_1_2_3_4/PETCT_7cfd708a53_06172005.nii.gz,/well/papiez/users/hri611/python/nnUnet_raw/Dataset219_PETCT/labelsTr/PETCT_7cfd708a53_06172005.nii.gz,0.7012307257037771,34.34965888595581,0.06220510482788086
427,0.12021371326803205,1705,271,0.06395073424917101,52157889,135,406,1840,/well/papiez/users/hri611/python/nnUNet_results/Dataset219_PETCT/nnUNetTrainer_1500epochs_1e2lr__nnUNetPlans__3d_fullres_maxnum_512_patch_192/crossval_results_folds_0_1_2_3_4/PETCT_7d01eb835d_03312002.nii.gz,/well/papiez/users/hri611/python/nnUnet_raw/Dataset219_PETCT/labelsTr/PETCT_7d01eb835d_03312002.nii.gz,0.12021371326803205,3.2222244300842284,21.211940746307373
428,,0,0,,52160000,0,0,0,/well/papiez/users/hri611/python/nnUNet_results/Dataset219_PETCT/nnUNetTrainer_1500epochs_1e2lr__nnUNetPlans__3d_fullres_maxnum_512_patch_192/crossval_results_folds_0_1_2_3_4/PETCT_7d8aa1e94d_10042002.nii.gz,/well/papiez/users/hri611/python/nnUnet_raw/Dataset219_PETCT/labelsTr/PETCT_7d8aa1e94d_10042002.nii.gz,,0.0,0.0
429,0.8459399648187028,2509,206,0.7330120955846199,52149831,7454,7660,9963,/well/papiez/users/hri611/python/nnUNet_results/Dataset219_PETCT/nnUNetTrainer_1500epochs_1e2lr__nnUNetPlans__3d_fullres_maxnum_512_patch_192/crossval_results_folds_0_1_2_3_4/PETCT_7d97f7a102_04212002.nii.gz,/well/papiez/users/hri611/python/nnUnet_raw/Dataset219_PETCT/labelsTr/PETCT_7d97f7a102_04212002.nii.gz,0.8459399648187028,0.0,0.0
430,0.0,0,4,0.0,46239996,0,4,0,/well/papiez/users/hri611/python/nnUNet_results/Dataset219_PETCT/nnUNetTrainer_1500epochs_1e2lr__nnUNetPlans__3d_fullres_maxnum_512_patch_192/crossval_results_folds_0_1_2_3_4/PETCT_7e56b0b62c_05272006.nii.gz,/well/papiez/users/hri611/python/nnUnet_raw/Dataset219_PETCT/labelsTr/PETCT_7e56b0b62c_05272006.nii.gz,0.0,0.04976408386230469,0.0
431,0.8276561820553704,571,618,0.7059841740850643,52155956,2855,3473,3426,/well/papiez/users/hri611/python/nnUNet_results/Dataset219_PETCT/nnUNetTrainer_1500epochs_1e2lr__nnUNetPlans__3d_fullres_maxnum_512_patch_192/crossval_results_folds_0_1_2_3_4/PETCT_7e5729ea40_02212003.nii.gz,/well/papiez/users/hri611/python/nnUnet_raw/Dataset219_PETCT/labelsTr/PETCT_7e5729ea40_02212003.nii.gz,0.8276561820553704,1.1943380126953125,0.0
432,0.8469852104664392,33,505,0.734583127775037,52157973,1489,1994,1522,/well/papiez/users/hri611/python/nnUNet_results/Dataset219_PETCT/nnUNetTrainer_1500epochs_1e2lr__nnUNetPlans__3d_fullres_maxnum_512_patch_192/crossval_results_folds_0_1_2_3_4/PETCT_7ed037687a_01272003.nii.gz,/well/papiez/users/hri611/python/nnUnet_raw/Dataset219_PETCT/labelsTr/PETCT_7ed037687a_01272003.nii.gz,0.8469852104664392,0.0,0.0
433,,0,0,,51040000,0,0,0,/well/papiez/users/hri611/python/nnUNet_results/Dataset219_PETCT/nnUNetTrainer_1500epochs_1e2lr__nnUNetPlans__3d_fullres_maxnum_512_patch_192/crossval_results_folds_0_1_2_3_4/PETCT_7ee7610b9e_01212006.nii.gz,/well/papiez/users/hri611/python/nnUnet_raw/Dataset219_PETCT/labelsTr/PETCT_7ee7610b9e_01212006.nii.gz,,0.0,0.0
434,0.0,0,3513,0.0,52156487,0,3513,0,/well/papiez/users/hri611/python/nnUNet_results/Dataset219_PETCT/nnUNetTrainer_1500epochs_1e2lr__nnUNetPlans__3d_fullres_maxnum_512_patch_192/crossval_results_folds_0_1_2_3_4/PETCT_7ef5343426_05122005.nii.gz,/well/papiez/users/hri611/python/nnUnet_raw/Dataset219_PETCT/labelsTr/PETCT_7ef5343426_05122005.nii.gz,0.0,43.70530665206909,0.0
435,0.6084959816303099,550,132,0.4372937293729373,99038788,530,662,1080,/well/papiez/users/hri611/python/nnUNet_results/Dataset219_PETCT/nnUNetTrainer_1500epochs_1e2lr__nnUNetPlans__3d_fullres_maxnum_512_patch_192/crossval_results_folds_0_1_2_3_4/PETCT_7f2a604e03_05052002.nii.gz,/well/papiez/users/hri611/python/nnUnet_raw/Dataset219_PETCT/labelsTr/PETCT_7f2a604e03_05052002.nii.gz,0.6084959816303099,0.07464612579345703,2.8738758430480957
436,0.9170445452120566,199,112,0.8467980295566503,45437970,1719,1831,1918,/well/papiez/users/hri611/python/nnUNet_results/Dataset219_PETCT/nnUNetTrainer_1500epochs_1e2lr__nnUNetPlans__3d_fullres_maxnum_512_patch_192/crossval_results_folds_0_1_2_3_4/PETCT_7faf36a152_06142002.nii.gz,/well/papiez/users/hri611/python/nnUnet_raw/Dataset219_PETCT/labelsTr/PETCT_7faf36a152_06142002.nii.gz,0.9170445452120566,0.0,0.0
437,,0,0,,45440000,0,0,0,/well/papiez/users/hri611/python/nnUNet_results/Dataset219_PETCT/nnUNetTrainer_1500epochs_1e2lr__nnUNetPlans__3d_fullres_maxnum_512_patch_192/crossval_results_folds_0_1_2_3_4/PETCT_7faf36a152_11272005.nii.gz,/well/papiez/users/hri611/python/nnUnet_raw/Dataset219_PETCT/labelsTr/PETCT_7faf36a152_11272005.nii.gz,,0.0,0.0
438,0.6676267281105991,698,1610,0.5010808473843493,85595374,2318,3928,3016,/well/papiez/users/hri611/python/nnUNet_results/Dataset219_PETCT/nnUNetTrainer_1500epochs_1e2lr__nnUNetPlans__3d_fullres_maxnum_512_patch_192/crossval_results_folds_0_1_2_3_4/PETCT_7fbb39290e_08152002.nii.gz,/well/papiez/users/hri611/python/nnUnet_raw/Dataset219_PETCT/labelsTr/PETCT_7fbb39290e_08152002.nii.gz,0.6676267281105991,13.548271831512452,3.8069524154663084
439,0.87574931880109,991,377,0.7789626757149782,45433811,4821,5198,5812,/well/papiez/users/hri611/python/nnUNet_results/Dataset219_PETCT/nnUNetTrainer_1500epochs_1e2lr__nnUNetPlans__3d_fullres_maxnum_512_patch_192/crossval_results_folds_0_1_2_3_4/PETCT_802f19931c_06302002.nii.gz,/well/papiez/users/hri611/python/nnUnet_raw/Dataset219_PETCT/labelsTr/PETCT_802f19931c_06302002.nii.gz,0.87574931880109,0.0,0.0
440,,0,0,,38720000,0,0,0,/well/papiez/users/hri611/python/nnUNet_results/Dataset219_PETCT/nnUNetTrainer_1500epochs_1e2lr__nnUNetPlans__3d_fullres_maxnum_512_patch_192/crossval_results_folds_0_1_2_3_4/PETCT_80b8393c44_07222002.nii.gz,/well/papiez/users/hri611/python/nnUnet_raw/Dataset219_PETCT/labelsTr/PETCT_80b8393c44_07222002.nii.gz,,0.0,0.0
441,0.8312236286919831,262,218,0.7111913357400722,52158338,1182,1400,1444,/well/papiez/users/hri611/python/nnUNet_results/Dataset219_PETCT/nnUNetTrainer_1500epochs_1e2lr__nnUNetPlans__3d_fullres_maxnum_512_patch_192/crossval_results_folds_0_1_2_3_4/PETCT_80ccbdadf9_05062002.nii.gz,/well/papiez/users/hri611/python/nnUnet_raw/Dataset219_PETCT/labelsTr/PETCT_80ccbdadf9_05062002.nii.gz,0.8312236286919831,0.0,2.1522966270446777
442,0.8621521044079878,2686,2574,0.7577041779906951,52138291,16449,19023,19135,/well/papiez/users/hri611/python/nnUNet_results/Dataset219_PETCT/nnUNetTrainer_1500epochs_1e2lr__nnUNetPlans__3d_fullres_maxnum_512_patch_192/crossval_results_folds_0_1_2_3_4/PETCT_80d7e682f7_02112005.nii.gz,/well/papiez/users/hri611/python/nnUnet_raw/Dataset219_PETCT/labelsTr/PETCT_80d7e682f7_02112005.nii.gz,0.8621521044079878,0.26126144027709963,0.19905633544921875
443,0.0,0,12,0.0,50559988,0,12,0,/well/papiez/users/hri611/python/nnUNet_results/Dataset219_PETCT/nnUNetTrainer_1500epochs_1e2lr__nnUNetPlans__3d_fullres_maxnum_512_patch_192/crossval_results_folds_0_1_2_3_4/PETCT_80f21e1ed0_11122006.nii.gz,/well/papiez/users/hri611/python/nnUnet_raw/Dataset219_PETCT/labelsTr/PETCT_80f21e1ed0_11122006.nii.gz,0.0,0.14929225158691406,0.0
444,0.0,0,165,0.0,92319835,0,165,0,/well/papiez/users/hri611/python/nnUNet_results/Dataset219_PETCT/nnUNetTrainer_1500epochs_1e2lr__nnUNetPlans__3d_fullres_maxnum_512_patch_192/crossval_results_folds_0_1_2_3_4/PETCT_80f7760f65_05022005.nii.gz,/well/papiez/users/hri611/python/nnUnet_raw/Dataset219_PETCT/labelsTr/PETCT_80f7760f65_05022005.nii.gz,0.0,2.052768459320068,0.0
445,0.0,0,265,0.0,92319735,0,265,0,/well/papiez/users/hri611/python/nnUNet_results/Dataset219_PETCT/nnUNetTrainer_1500epochs_1e2lr__nnUNetPlans__3d_fullres_maxnum_512_patch_192/crossval_results_folds_0_1_2_3_4/PETCT_80f7760f65_11142005.nii.gz,/well/papiez/users/hri611/python/nnUnet_raw/Dataset219_PETCT/labelsTr/PETCT_80f7760f65_11142005.nii.gz,0.0,3.2968705558776854,0.0
446,,0,0,,49920000,0,0,0,/well/papiez/users/hri611/python/nnUNet_results/Dataset219_PETCT/nnUNetTrainer_1500epochs_1e2lr__nnUNetPlans__3d_fullres_maxnum_512_patch_192/crossval_results_folds_0_1_2_3_4/PETCT_81debf13a1_03092006.nii.gz,/well/papiez/users/hri611/python/nnUnet_raw/Dataset219_PETCT/labelsTr/PETCT_81debf13a1_03092006.nii.gz,,0.0,0.0
447,0.7383351517874334,35,4042,0.5852070403906806,52150171,5752,9794,5787,/well/papiez/users/hri611/python/nnUNet_results/Dataset219_PETCT/nnUNetTrainer_1500epochs_1e2lr__nnUNetPlans__3d_fullres_maxnum_512_patch_192/crossval_results_folds_0_1_2_3_4/PETCT_82137245b0_01262002.nii.gz,/well/papiez/users/hri611/python/nnUnet_raw/Dataset219_PETCT/labelsTr/PETCT_82137245b0_01262002.nii.gz,0.7383351517874334,2.537968276977539,0.012441020965576172
448,0.0,0,13,0.0,52159987,0,13,0,/well/papiez/users/hri611/python/nnUNet_results/Dataset219_PETCT/nnUNetTrainer_1500epochs_1e2lr__nnUNetPlans__3d_fullres_maxnum_512_patch_192/crossval_results_folds_0_1_2_3_4/PETCT_8311aeddb9_11132003.nii.gz,/well/papiez/users/hri611/python/nnUnet_raw/Dataset219_PETCT/labelsTr/PETCT_8311aeddb9_11132003.nii.gz,0.0,0.16173327255249023,0.0
449,,0,0,,47520000,0,0,0,/well/papiez/users/hri611/python/nnUNet_results/Dataset219_PETCT/nnUNetTrainer_1500epochs_1e2lr__nnUNetPlans__3d_fullres_maxnum_512_patch_192/crossval_results_folds_0_1_2_3_4/PETCT_8311aeddb9_12162005.nii.gz,/well/papiez/users/hri611/python/nnUnet_raw/Dataset219_PETCT/labelsTr/PETCT_8311aeddb9_12162005.nii.gz,,0.0,0.0
450,,0,0,,47200000,0,0,0,/well/papiez/users/hri611/python/nnUNet_results/Dataset219_PETCT/nnUNetTrainer_1500epochs_1e2lr__nnUNetPlans__3d_fullres_maxnum_512_patch_192/crossval_results_folds_0_1_2_3_4/PETCT_83e4c5b578_03112006.nii.gz,/well/papiez/users/hri611/python/nnUnet_raw/Dataset219_PETCT/labelsTr/PETCT_83e4c5b578_03112006.nii.gz,,0.0,0.0
451,0.0,0,10,0.0,52159990,0,10,0,/well/papiez/users/hri611/python/nnUNet_results/Dataset219_PETCT/nnUNetTrainer_1500epochs_1e2lr__nnUNetPlans__3d_fullres_maxnum_512_patch_192/crossval_results_folds_0_1_2_3_4/PETCT_846c1af245_12062002.nii.gz,/well/papiez/users/hri611/python/nnUnet_raw/Dataset219_PETCT/labelsTr/PETCT_846c1af245_12062002.nii.gz,0.0,0.12441020965576172,0.0
452,0.7305825242718447,935,4393,0.5755258126195029,51987448,7224,11617,8159,/well/papiez/users/hri611/python/nnUNet_results/Dataset219_PETCT/nnUNetTrainer_1500epochs_1e2lr__nnUNetPlans__3d_fullres_maxnum_512_patch_192/crossval_results_folds_0_1_2_3_4/PETCT_84e7715ed9_01042002.nii.gz,/well/papiez/users/hri611/python/nnUnet_raw/Dataset219_PETCT/labelsTr/PETCT_84e7715ed9_01042002.nii.gz,0.7305825242718447,42.66026089096069,0.0
453,,0,0,,47360000,0,0,0,/well/papiez/users/hri611/python/nnUNet_results/Dataset219_PETCT/nnUNetTrainer_1500epochs_1e2lr__nnUNetPlans__3d_fullres_maxnum_512_patch_192/crossval_results_folds_0_1_2_3_4/PETCT_855c7fca12_07272006.nii.gz,/well/papiez/users/hri611/python/nnUnet_raw/Dataset219_PETCT/labelsTr/PETCT_855c7fca12_07272006.nii.gz,,0.0,0.0
454,0.0,0,3,0.0,46879997,0,3,0,/well/papiez/users/hri611/python/nnUNet_results/Dataset219_PETCT/nnUNetTrainer_1500epochs_1e2lr__nnUNetPlans__3d_fullres_maxnum_512_patch_192/crossval_results_folds_0_1_2_3_4/PETCT_85b69fed1c_01212006.nii.gz,/well/papiez/users/hri611/python/nnUnet_raw/Dataset219_PETCT/labelsTr/PETCT_85b69fed1c_01212006.nii.gz,0.0,0.037323062896728515,0.0
455,0.0,0,394,0.0,53599606,0,394,0,/well/papiez/users/hri611/python/nnUNet_results/Dataset219_PETCT/nnUNetTrainer_1500epochs_1e2lr__nnUNetPlans__3d_fullres_maxnum_512_patch_192/crossval_results_folds_0_1_2_3_4/PETCT_86153b2974_03192006.nii.gz,/well/papiez/users/hri611/python/nnUnet_raw/Dataset219_PETCT/labelsTr/PETCT_86153b2974_03192006.nii.gz,0.0,4.901762260437011,0.0
456,0.0,0,71,0.0,65439929,0,71,0,/well/papiez/users/hri611/python/nnUNet_results/Dataset219_PETCT/nnUNetTrainer_1500epochs_1e2lr__nnUNetPlans__3d_fullres_maxnum_512_patch_192/crossval_results_folds_0_1_2_3_4/PETCT_86153b2974_04032005.nii.gz,/well/papiez/users/hri611/python/nnUnet_raw/Dataset219_PETCT/labelsTr/PETCT_86153b2974_04032005.nii.gz,0.0,0.8833124885559082,0.0
457,0.83204858677879,1706,451,0.7124,58872500,5343,5794,7049,/well/papiez/users/hri611/python/nnUNet_results/Dataset219_PETCT/nnUNetTrainer_1500epochs_1e2lr__nnUNetPlans__3d_fullres_maxnum_512_patch_192/crossval_results_folds_0_1_2_3_4/PETCT_86153b2974_06052003.nii.gz,/well/papiez/users/hri611/python/nnUnet_raw/Dataset219_PETCT/labelsTr/PETCT_86153b2974_06052003.nii.gz,0.83204858677879,0.5598459434509278,13.983707565307617
458,,0,0,,53120000,0,0,0,/well/papiez/users/hri611/python/nnUNet_results/Dataset219_PETCT/nnUNetTrainer_1500epochs_1e2lr__nnUNetPlans__3d_fullres_maxnum_512_patch_192/crossval_results_folds_0_1_2_3_4/PETCT_86153b2974_10022005.nii.gz,/well/papiez/users/hri611/python/nnUnet_raw/Dataset219_PETCT/labelsTr/PETCT_86153b2974_10022005.nii.gz,,0.0,0.0
459,,0,0,,52960000,0,0,0,/well/papiez/users/hri611/python/nnUNet_results/Dataset219_PETCT/nnUNetTrainer_1500epochs_1e2lr__nnUNetPlans__3d_fullres_maxnum_512_patch_192/crossval_results_folds_0_1_2_3_4/PETCT_86153b2974_10062006.nii.gz,/well/papiez/users/hri611/python/nnUnet_raw/Dataset219_PETCT/labelsTr/PETCT_86153b2974_10062006.nii.gz,,0.0,0.0
460,0.8569036722848532,78,2486,0.7496338248217947,45429759,7677,10163,7755,/well/papiez/users/hri611/python/nnUNet_results/Dataset219_PETCT/nnUNetTrainer_1500epochs_1e2lr__nnUNetPlans__3d_fullres_maxnum_512_patch_192/crossval_results_folds_0_1_2_3_4/PETCT_86e54ea60a_03182002.nii.gz,/well/papiez/users/hri611/python/nnUnet_raw/Dataset219_PETCT/labelsTr/PETCT_86e54ea60a_03182002.nii.gz,0.8569036722848532,6.966971740722656,0.24882041931152343
461,0.63625,0,582,0.4665444546287809,45438909,509,1091,509,/well/papiez/users/hri611/python/nnUNet_results/Dataset219_PETCT/nnUNetTrainer_1500epochs_1e2lr__nnUNetPlans__3d_fullres_maxnum_512_patch_192/crossval_results_folds_0_1_2_3_4/PETCT_870181d7fd_10312004.nii.gz,/well/papiez/users/hri611/python/nnUnet_raw/Dataset219_PETCT/labelsTr/PETCT_870181d7fd_10312004.nii.gz,0.63625,4.4414444847106935,0.0
462,,0,0,,87200000,0,0,0,/well/papiez/users/hri611/python/nnUNet_results/Dataset219_PETCT/nnUNetTrainer_1500epochs_1e2lr__nnUNetPlans__3d_fullres_maxnum_512_patch_192/crossval_results_folds_0_1_2_3_4/PETCT_87afc291ec_01262006.nii.gz,/well/papiez/users/hri611/python/nnUnet_raw/Dataset219_PETCT/labelsTr/PETCT_87afc291ec_01262006.nii.gz,,0.0,0.0
463,0.0,0,94,0.0,85599906,0,94,0,/well/papiez/users/hri611/python/nnUNet_results/Dataset219_PETCT/nnUNetTrainer_1500epochs_1e2lr__nnUNetPlans__3d_fullres_maxnum_512_patch_192/crossval_results_folds_0_1_2_3_4/PETCT_87afc291ec_07202003.nii.gz,/well/papiez/users/hri611/python/nnUnet_raw/Dataset219_PETCT/labelsTr/PETCT_87afc291ec_07202003.nii.gz,0.0,1.16945597076416,0.0
464,,0,0,,43680000,0,0,0,/well/papiez/users/hri611/python/nnUNet_results/Dataset219_PETCT/nnUNetTrainer_1500epochs_1e2lr__nnUNetPlans__3d_fullres_maxnum_512_patch_192/crossval_results_folds_0_1_2_3_4/PETCT_8838c53a63_05222005.nii.gz,/well/papiez/users/hri611/python/nnUnet_raw/Dataset219_PETCT/labelsTr/PETCT_8838c53a63_05222005.nii.gz,,0.0,0.0
465,0.8419067115075304,9482,1330,0.7269765915002147,52120399,28789,30119,38271,/well/papiez/users/hri611/python/nnUNet_results/Dataset219_PETCT/nnUNetTrainer_1500epochs_1e2lr__nnUNetPlans__3d_fullres_maxnum_512_patch_192/crossval_results_folds_0_1_2_3_4/PETCT_88bcc970b3_02282002.nii.gz,/well/papiez/users/hri611/python/nnUnet_raw/Dataset219_PETCT/labelsTr/PETCT_88bcc970b3_02282002.nii.gz,0.8419067115075304,0.1741742935180664,20.776505012512207
466,0.5457025920873124,0,333,0.37523452157598497,92319467,200,533,200,/well/papiez/users/hri611/python/nnUNet_results/Dataset219_PETCT/nnUNetTrainer_1500epochs_1e2lr__nnUNetPlans__3d_fullres_maxnum_512_patch_192/crossval_results_folds_0_1_2_3_4/PETCT_89065bc4ab_02202004.nii.gz,/well/papiez/users/hri611/python/nnUnet_raw/Dataset219_PETCT/labelsTr/PETCT_89065bc4ab_02202004.nii.gz,0.5457025920873124,1.0201637191772461,0.0
467,0.762070204864023,16050,39558,0.6156005032420401,58735338,89054,128612,105104,/well/papiez/users/hri611/python/nnUNet_results/Dataset219_PETCT/nnUNetTrainer_1500epochs_1e2lr__nnUNetPlans__3d_fullres_maxnum_512_patch_192/crossval_results_folds_0_1_2_3_4/PETCT_8a52353a72_02172003.nii.gz,/well/papiez/users/hri611/python/nnUnet_raw/Dataset219_PETCT/labelsTr/PETCT_8a52353a72_02172003.nii.gz,0.762070204864023,10.549985778808594,106.99278030395507
468,0.8751273532668882,2386,433,0.7779790501693313,45427303,9878,10311,12264,/well/papiez/users/hri611/python/nnUNet_results/Dataset219_PETCT/nnUNetTrainer_1500epochs_1e2lr__nnUNetPlans__3d_fullres_maxnum_512_patch_192/crossval_results_folds_0_1_2_3_4/PETCT_8aa48809ea_04162001.nii.gz,/well/papiez/users/hri611/python/nnUnet_raw/Dataset219_PETCT/labelsTr/PETCT_8aa48809ea_04162001.nii.gz,0.8751273532668882,1.0326047401428222,0.04976408386230469
469,0.0,0,18,0.0,40639982,0,18,0,/well/papiez/users/hri611/python/nnUNet_results/Dataset219_PETCT/nnUNetTrainer_1500epochs_1e2lr__nnUNetPlans__3d_fullres_maxnum_512_patch_192/crossval_results_folds_0_1_2_3_4/PETCT_8af3757198_12032006.nii.gz,/well/papiez/users/hri611/python/nnUnet_raw/Dataset219_PETCT/labelsTr/PETCT_8af3757198_12032006.nii.gz,0.0,0.2239383773803711,0.0
470,0.0,0,42,0.0,92799958,0,42,0,/well/papiez/users/hri611/python/nnUNet_results/Dataset219_PETCT/nnUNetTrainer_1500epochs_1e2lr__nnUNetPlans__3d_fullres_maxnum_512_patch_192/crossval_results_folds_0_1_2_3_4/PETCT_8b14e6a819_01292006.nii.gz,/well/papiez/users/hri611/python/nnUnet_raw/Dataset219_PETCT/labelsTr/PETCT_8b14e6a819_01292006.nii.gz,0.0,0.5225228805541993,0.0
471,0.0,0,115,0.0,99039885,0,115,0,/well/papiez/users/hri611/python/nnUNet_results/Dataset219_PETCT/nnUNetTrainer_1500epochs_1e2lr__nnUNetPlans__3d_fullres_maxnum_512_patch_192/crossval_results_folds_0_1_2_3_4/PETCT_8b40e356dc_06182007.nii.gz,/well/papiez/users/hri611/python/nnUnet_raw/Dataset219_PETCT/labelsTr/PETCT_8b40e356dc_06182007.nii.gz,0.0,1.4307174110412597,0.0
472,,0,0,,44800000,0,0,0,/well/papiez/users/hri611/python/nnUNet_results/Dataset219_PETCT/nnUNetTrainer_1500epochs_1e2lr__nnUNetPlans__3d_fullres_maxnum_512_patch_192/crossval_results_folds_0_1_2_3_4/PETCT_8b714a64e7_05172007.nii.gz,/well/papiez/users/hri611/python/nnUnet_raw/Dataset219_PETCT/labelsTr/PETCT_8b714a64e7_05172007.nii.gz,,0.0,0.0
473,,0,0,,38720000,0,0,0,/well/papiez/users/hri611/python/nnUNet_results/Dataset219_PETCT/nnUNetTrainer_1500epochs_1e2lr__nnUNetPlans__3d_fullres_maxnum_512_patch_192/crossval_results_folds_0_1_2_3_4/PETCT_8b73608326_04042003.nii.gz,/well/papiez/users/hri611/python/nnUnet_raw/Dataset219_PETCT/labelsTr/PETCT_8b73608326_04042003.nii.gz,,0.0,0.0
474,0.8573022069954586,408,8547,0.7502440384883559,52124145,26900,35447,27308,/well/papiez/users/hri611/python/nnUNet_results/Dataset219_PETCT/nnUNetTrainer_1500epochs_1e2lr__nnUNetPlans__3d_fullres_maxnum_512_patch_192/crossval_results_folds_0_1_2_3_4/PETCT_8b74860ce6_03102005.nii.gz,/well/papiez/users/hri611/python/nnUnet_raw/Dataset219_PETCT/labelsTr/PETCT_8b74860ce6_03102005.nii.gz,0.8573022069954586,2.2891478576660154,0.07464612579345703
475,,0,0,,45440000,0,0,0,/well/papiez/users/hri611/python/nnUNet_results/Dataset219_PETCT/nnUNetTrainer_1500epochs_1e2lr__nnUNetPlans__3d_fullres_maxnum_512_patch_192/crossval_results_folds_0_1_2_3_4/PETCT_8bebb676bf_12202002.nii.gz,/well/papiez/users/hri611/python/nnUnet_raw/Dataset219_PETCT/labelsTr/PETCT_8bebb676bf_12202002.nii.gz,,0.0,0.0
476,0.0,0,11848,0.0,49268152,0,11848,0,/well/papiez/users/hri611/python/nnUNet_results/Dataset219_PETCT/nnUNetTrainer_1500epochs_1e2lr__nnUNetPlans__3d_fullres_maxnum_512_patch_192/crossval_results_folds_0_1_2_3_4/PETCT_8bf08c9a42_06092006.nii.gz,/well/papiez/users/hri611/python/nnUnet_raw/Dataset219_PETCT/labelsTr/PETCT_8bf08c9a42_06092006.nii.gz,0.0,147.4012164001465,0.0
477,0.0,0,158,0.0,49919842,0,158,0,/well/papiez/users/hri611/python/nnUNet_results/Dataset219_PETCT/nnUNetTrainer_1500epochs_1e2lr__nnUNetPlans__3d_fullres_maxnum_512_patch_192/crossval_results_folds_0_1_2_3_4/PETCT_8c5d99b459_05042007.nii.gz,/well/papiez/users/hri611/python/nnUnet_raw/Dataset219_PETCT/labelsTr/PETCT_8c5d99b459_05042007.nii.gz,0.0,1.965681312561035,0.0
478,0.9284591194968553,99,83,0.8664710198092443,52158637,1181,1264,1280,/well/papiez/users/hri611/python/nnUNet_results/Dataset219_PETCT/nnUNetTrainer_1500epochs_1e2lr__nnUNetPlans__3d_fullres_maxnum_512_patch_192/crossval_results_folds_0_1_2_3_4/PETCT_8c8cd2699c_01182004.nii.gz,/well/papiez/users/hri611/python/nnUnet_raw/Dataset219_PETCT/labelsTr/PETCT_8c8cd2699c_01182004.nii.gz,0.9284591194968553,0.32346654510498046,0.0
479,0.8219206251285215,1665,8727,0.6976784779193577,52125626,23982,32709,25647,/well/papiez/users/hri611/python/nnUNet_results/Dataset219_PETCT/nnUNetTrainer_1500epochs_1e2lr__nnUNetPlans__3d_fullres_maxnum_512_patch_192/crossval_results_folds_0_1_2_3_4/PETCT_8de6953d23_01192001.nii.gz,/well/papiez/users/hri611/python/nnUnet_raw/Dataset219_PETCT/labelsTr/PETCT_8de6953d23_01192001.nii.gz,0.8219206251285215,2.60017338180542,0.024882041931152343
480,0.5051837888784166,403,122,0.3379571248423707,52159207,268,390,671,/well/papiez/users/hri611/python/nnUNet_results/Dataset219_PETCT/nnUNetTrainer_1500epochs_1e2lr__nnUNetPlans__3d_fullres_maxnum_512_patch_192/crossval_results_folds_0_1_2_3_4/PETCT_8e02f36295_11082004.nii.gz,/well/papiez/users/hri611/python/nnUnet_raw/Dataset219_PETCT/labelsTr/PETCT_8e02f36295_11082004.nii.gz,0.5051837888784166,1.1196918869018555,1.0450457611083985
481,0.7837259100642399,0,101,0.6443661971830986,52159716,183,284,183,/well/papiez/users/hri611/python/nnUNet_results/Dataset219_PETCT/nnUNetTrainer_1500epochs_1e2lr__nnUNetPlans__3d_fullres_maxnum_512_patch_192/crossval_results_folds_0_1_2_3_4/PETCT_8e905366fe_04272001.nii.gz,/well/papiez/users/hri611/python/nnUnet_raw/Dataset219_PETCT/labelsTr/PETCT_8e905366fe_04272001.nii.gz,0.7837259100642399,0.0,0.0
482,0.0,0,327,0.0,52159673,0,327,0,/well/papiez/users/hri611/python/nnUNet_results/Dataset219_PETCT/nnUNetTrainer_1500epochs_1e2lr__nnUNetPlans__3d_fullres_maxnum_512_patch_192/crossval_results_folds_0_1_2_3_4/PETCT_8eb3998417_07032004.nii.gz,/well/papiez/users/hri611/python/nnUnet_raw/Dataset219_PETCT/labelsTr/PETCT_8eb3998417_07032004.nii.gz,0.0,4.068213855743408,0.0
483,0.7528666960149257,46556,600,0.603677805419216,52041016,71828,72428,118384,/well/papiez/users/hri611/python/nnUNet_results/Dataset219_PETCT/nnUNetTrainer_1500epochs_1e2lr__nnUNetPlans__3d_fullres_maxnum_512_patch_192/crossval_results_folds_0_1_2_3_4/PETCT_8ec13728df_10141999.nii.gz,/well/papiez/users/hri611/python/nnUnet_raw/Dataset219_PETCT/labelsTr/PETCT_8ec13728df_10141999.nii.gz,0.7528666960149257,0.7589022789001465,86.97517757034302
484,,0,0,,52160000,0,0,0,/well/papiez/users/hri611/python/nnUNet_results/Dataset219_PETCT/nnUNetTrainer_1500epochs_1e2lr__nnUNetPlans__3d_fullres_maxnum_512_patch_192/crossval_results_folds_0_1_2_3_4/PETCT_8f2878df50_02212003.nii.gz,/well/papiez/users/hri611/python/nnUnet_raw/Dataset219_PETCT/labelsTr/PETCT_8f2878df50_02212003.nii.gz,,0.0,0.0
485,0.8231481481481482,346,36,0.6994492525570417,52158729,889,925,1235,/well/papiez/users/hri611/python/nnUNet_results/Dataset219_PETCT/nnUNetTrainer_1500epochs_1e2lr__nnUNetPlans__3d_fullres_maxnum_512_patch_192/crossval_results_folds_0_1_2_3_4/PETCT_8f2878df50_08222002.nii.gz,/well/papiez/users/hri611/python/nnUnet_raw/Dataset219_PETCT/labelsTr/PETCT_8f2878df50_08222002.nii.gz,0.8231481481481482,0.0,0.6469330902099609
486,,0,0,,37760000,0,0,0,/well/papiez/users/hri611/python/nnUNet_results/Dataset219_PETCT/nnUNetTrainer_1500epochs_1e2lr__nnUNetPlans__3d_fullres_maxnum_512_patch_192/crossval_results_folds_0_1_2_3_4/PETCT_8fea5f0537_09262005.nii.gz,/well/papiez/users/hri611/python/nnUnet_raw/Dataset219_PETCT/labelsTr/PETCT_8fea5f0537_09262005.nii.gz,,0.0,0.0
487,0.6897568165070007,4394,4868,0.5264341957255343,52140442,10296,15164,14690,/well/papiez/users/hri611/python/nnUNet_results/Dataset219_PETCT/nnUNetTrainer_1500epochs_1e2lr__nnUNetPlans__3d_fullres_maxnum_512_patch_192/crossval_results_folds_0_1_2_3_4/PETCT_901573a747_05132005.nii.gz,/well/papiez/users/hri611/python/nnUnet_raw/Dataset219_PETCT/labelsTr/PETCT_901573a747_05132005.nii.gz,0.6897568165070007,15.227809661865233,15.339778850555419
488,,0,0,,45440000,0,0,0,/well/papiez/users/hri611/python/nnUNet_results/Dataset219_PETCT/nnUNetTrainer_1500epochs_1e2lr__nnUNetPlans__3d_fullres_maxnum_512_patch_192/crossval_results_folds_0_1_2_3_4/PETCT_90d668ed29_06072003.nii.gz,/well/papiez/users/hri611/python/nnUnet_raw/Dataset219_PETCT/labelsTr/PETCT_90d668ed29_06072003.nii.gz,,0.0,0.0
489,0.8808622196329741,2840,432,0.7870900572618428,52144632,12096,12528,14936,/well/papiez/users/hri611/python/nnUNet_results/Dataset219_PETCT/nnUNetTrainer_1500epochs_1e2lr__nnUNetPlans__3d_fullres_maxnum_512_patch_192/crossval_results_folds_0_1_2_3_4/PETCT_90ea6a6aaf_07272001.nii.gz,/well/papiez/users/hri611/python/nnUnet_raw/Dataset219_PETCT/labelsTr/PETCT_90ea6a6aaf_07272001.nii.gz,0.8808622196329741,2.090091522216797,0.19905633544921875
490,0.8067226890756303,33,174,0.676056338028169,90079361,432,606,465,/well/papiez/users/hri611/python/nnUNet_results/Dataset219_PETCT/nnUNetTrainer_1500epochs_1e2lr__nnUNetPlans__3d_fullres_maxnum_512_patch_192/crossval_results_folds_0_1_2_3_4/PETCT_912a25778f_05172007.nii.gz,/well/papiez/users/hri611/python/nnUnet_raw/Dataset219_PETCT/labelsTr/PETCT_912a25778f_05172007.nii.gz,0.8067226890756303,1.5053635368347167,0.0
491,0.8197674418604651,26,36,0.6945812807881774,47999797,141,177,167,/well/papiez/users/hri611/python/nnUNet_results/Dataset219_PETCT/nnUNetTrainer_1500epochs_1e2lr__nnUNetPlans__3d_fullres_maxnum_512_patch_192/crossval_results_folds_0_1_2_3_4/PETCT_91cfa804b0_09222006.nii.gz,/well/papiez/users/hri611/python/nnUnet_raw/Dataset219_PETCT/labelsTr/PETCT_91cfa804b0_09222006.nii.gz,0.8197674418604651,0.2737024612426758,0.32346654510498046
492,,0,0,,49920000,0,0,0,/well/papiez/users/hri611/python/nnUNet_results/Dataset219_PETCT/nnUNetTrainer_1500epochs_1e2lr__nnUNetPlans__3d_fullres_maxnum_512_patch_192/crossval_results_folds_0_1_2_3_4/PETCT_92c3de23f5_10082005.nii.gz,/well/papiez/users/hri611/python/nnUnet_raw/Dataset219_PETCT/labelsTr/PETCT_92c3de23f5_10082005.nii.gz,,0.0,0.0
493,0.7068916378958913,80025,1222,0.546660789313633,45260781,97972,99194,177997,/well/papiez/users/hri611/python/nnUNet_results/Dataset219_PETCT/nnUNetTrainer_1500epochs_1e2lr__nnUNetPlans__3d_fullres_maxnum_512_patch_192/crossval_results_folds_0_1_2_3_4/PETCT_92c5c944a5_07152002.nii.gz,/well/papiez/users/hri611/python/nnUnet_raw/Dataset219_PETCT/labelsTr/PETCT_92c5c944a5_07152002.nii.gz,0.7068916378958913,0.0,16.720732177734376
494,0.0,0,7,0.0,52159993,0,7,0,/well/papiez/users/hri611/python/nnUNet_results/Dataset219_PETCT/nnUNetTrainer_1500epochs_1e2lr__nnUNetPlans__3d_fullres_maxnum_512_patch_192/crossval_results_folds_0_1_2_3_4/PETCT_93132553f6_08122002.nii.gz,/well/papiez/users/hri611/python/nnUnet_raw/Dataset219_PETCT/labelsTr/PETCT_93132553f6_08122002.nii.gz,0.0,0.0870871467590332,0.0
495,0.7694834823872969,1,1262,0.6253337288638386,52156629,2108,3370,2109,/well/papiez/users/hri611/python/nnUNet_results/Dataset219_PETCT/nnUNetTrainer_1500epochs_1e2lr__nnUNetPlans__3d_fullres_maxnum_512_patch_192/crossval_results_folds_0_1_2_3_4/PETCT_93bea242d1_07252002.nii.gz,/well/papiez/users/hri611/python/nnUnet_raw/Dataset219_PETCT/labelsTr/PETCT_93bea242d1_07252002.nii.gz,0.7694834823872969,0.11196918869018554,0.0
496,0.8858603066439523,0,134,0.7951070336391437,49759346,520,654,520,/well/papiez/users/hri611/python/nnUNet_results/Dataset219_PETCT/nnUNetTrainer_1500epochs_1e2lr__nnUNetPlans__3d_fullres_maxnum_512_patch_192/crossval_results_folds_0_1_2_3_4/PETCT_94962fe878_06012007.nii.gz,/well/papiez/users/hri611/python/nnUnet_raw/Dataset219_PETCT/labelsTr/PETCT_94962fe878_06012007.nii.gz,0.8858603066439523,0.18661531448364257,0.0
497,0.7605388961321164,3270,587,0.6136044880785414,52150018,6125,6712,9395,/well/papiez/users/hri611/python/nnUNet_results/Dataset219_PETCT/nnUNetTrainer_1500epochs_1e2lr__nnUNetPlans__3d_fullres_maxnum_512_patch_192/crossval_results_folds_0_1_2_3_4/PETCT_94986389d4_11112002.nii.gz,/well/papiez/users/hri611/python/nnUnet_raw/Dataset219_PETCT/labelsTr/PETCT_94986389d4_11112002.nii.gz,0.7605388961321164,0.0,10.276283317565918
498,0.0,84,0,0.0,102719916,0,0,84,/well/papiez/users/hri611/python/nnUNet_results/Dataset219_PETCT/nnUNetTrainer_1500epochs_1e2lr__nnUNetPlans__3d_fullres_maxnum_512_patch_192/crossval_results_folds_0_1_2_3_4/PETCT_94cc0dac49_03092007.nii.gz,/well/papiez/users/hri611/python/nnUnet_raw/Dataset219_PETCT/labelsTr/PETCT_94cc0dac49_03092007.nii.gz,0.0,0.0,1.0450457611083985
499,,0,0,,50880000,0,0,0,/well/papiez/users/hri611/python/nnUNet_results/Dataset219_PETCT/nnUNetTrainer_1500epochs_1e2lr__nnUNetPlans__3d_fullres_maxnum_512_patch_192/crossval_results_folds_0_1_2_3_4/PETCT_94cc0dac49_03102006.nii.gz,/well/papiez/users/hri611/python/nnUnet_raw/Dataset219_PETCT/labelsTr/PETCT_94cc0dac49_03102006.nii.gz,,0.0,0.0
500,0.7452459016393442,1481,73,0.5939378102952705,100956173,2273,2346,3754,/well/papiez/users/hri611/python/nnUNet_results/Dataset219_PETCT/nnUNetTrainer_1500epochs_1e2lr__nnUNetPlans__3d_fullres_maxnum_512_patch_192/crossval_results_folds_0_1_2_3_4/PETCT_9521502dbb_05172007.nii.gz,/well/papiez/users/hri611/python/nnUnet_raw/Dataset219_PETCT/labelsTr/PETCT_9521502dbb_05172007.nii.gz,0.7452459016393442,0.0,13.996148586273193
501,0.0,0,9,0.0,45439991,0,9,0,/well/papiez/users/hri611/python/nnUNet_results/Dataset219_PETCT/nnUNetTrainer_1500epochs_1e2lr__nnUNetPlans__3d_fullres_maxnum_512_patch_192/crossval_results_folds_0_1_2_3_4/PETCT_956520090b_11012003.nii.gz,/well/papiez/users/hri611/python/nnUnet_raw/Dataset219_PETCT/labelsTr/PETCT_956520090b_11012003.nii.gz,0.0,0.11196918869018554,0.0
502,0.5327102803738317,73,27,0.3630573248407643,85599843,57,84,130,/well/papiez/users/hri611/python/nnUNet_results/Dataset219_PETCT/nnUNetTrainer_1500epochs_1e2lr__nnUNetPlans__3d_fullres_maxnum_512_patch_192/crossval_results_folds_0_1_2_3_4/PETCT_95efdaba3c_10112003.nii.gz,/well/papiez/users/hri611/python/nnUnet_raw/Dataset219_PETCT/labelsTr/PETCT_95efdaba3c_10112003.nii.gz,0.5327102803738317,0.3110255241394043,0.0
503,,0,0,,58880000,0,0,0,/well/papiez/users/hri611/python/nnUNet_results/Dataset219_PETCT/nnUNetTrainer_1500epochs_1e2lr__nnUNetPlans__3d_fullres_maxnum_512_patch_192/crossval_results_folds_0_1_2_3_4/PETCT_960c5f4262_01162003.nii.gz,/well/papiez/users/hri611/python/nnUnet_raw/Dataset219_PETCT/labelsTr/PETCT_960c5f4262_01162003.nii.gz,,0.0,0.0
504,,0,0,,52160000,0,0,0,/well/papiez/users/hri611/python/nnUNet_results/Dataset219_PETCT/nnUNetTrainer_1500epochs_1e2lr__nnUNetPlans__3d_fullres_maxnum_512_patch_192/crossval_results_folds_0_1_2_3_4/PETCT_960c5f4262_02252005.nii.gz,/well/papiez/users/hri611/python/nnUnet_raw/Dataset219_PETCT/labelsTr/PETCT_960c5f4262_02252005.nii.gz,,0.0,0.0
505,0.8953692453084919,466,309,0.810559765338548,45435909,3316,3625,3782,/well/papiez/users/hri611/python/nnUNet_results/Dataset219_PETCT/nnUNetTrainer_1500epochs_1e2lr__nnUNetPlans__3d_fullres_maxnum_512_patch_192/crossval_results_folds_0_1_2_3_4/PETCT_963a71819a_10292001.nii.gz,/well/papiez/users/hri611/python/nnUnet_raw/Dataset219_PETCT/labelsTr/PETCT_963a71819a_10292001.nii.gz,0.8953692453084919,0.0,0.0
506,0.0,0,66,0.0,46079934,0,66,0,/well/papiez/users/hri611/python/nnUNet_results/Dataset219_PETCT/nnUNetTrainer_1500epochs_1e2lr__nnUNetPlans__3d_fullres_maxnum_512_patch_192/crossval_results_folds_0_1_2_3_4/PETCT_96e7a3ab28_06142007.nii.gz,/well/papiez/users/hri611/python/nnUnet_raw/Dataset219_PETCT/labelsTr/PETCT_96e7a3ab28_06142007.nii.gz,0.0,0.8211073837280274,0.0
507,0.9468304668304668,1980,2348,0.8990294886151549,45397136,38536,40884,40516,/well/papiez/users/hri611/python/nnUNet_results/Dataset219_PETCT/nnUNetTrainer_1500epochs_1e2lr__nnUNetPlans__3d_fullres_maxnum_512_patch_192/crossval_results_folds_0_1_2_3_4/PETCT_97320b0b58_04172005.nii.gz,/well/papiez/users/hri611/python/nnUnet_raw/Dataset219_PETCT/labelsTr/PETCT_97320b0b58_04172005.nii.gz,0.9468304668304668,4.0060087509155275,0.870871467590332
508,0.0,0,888,0.0,42879112,0,888,0,/well/papiez/users/hri611/python/nnUNet_results/Dataset219_PETCT/nnUNetTrainer_1500epochs_1e2lr__nnUNetPlans__3d_fullres_maxnum_512_patch_192/crossval_results_folds_0_1_2_3_4/PETCT_97320b0b58_07282005.nii.gz,/well/papiez/users/hri611/python/nnUnet_raw/Dataset219_PETCT/labelsTr/PETCT_97320b0b58_07282005.nii.gz,0.0,11.047626617431641,0.0
509,0.9042528400815614,2610,3964,0.8252385889358534,45402383,31043,35007,33653,/well/papiez/users/hri611/python/nnUNet_results/Dataset219_PETCT/nnUNetTrainer_1500epochs_1e2lr__nnUNetPlans__3d_fullres_maxnum_512_patch_192/crossval_results_folds_0_1_2_3_4/PETCT_9775598501_05042001.nii.gz,/well/papiez/users/hri611/python/nnUnet_raw/Dataset219_PETCT/labelsTr/PETCT_9775598501_05042001.nii.gz,0.9042528400815614,2.6499374656677244,1.9159172286987305
510,0.883177570093458,2,48,0.7907949790794979,45439761,189,237,191,/well/papiez/users/hri611/python/nnUNet_results/Dataset219_PETCT/nnUNetTrainer_1500epochs_1e2lr__nnUNetPlans__3d_fullres_maxnum_512_patch_192/crossval_results_folds_0_1_2_3_4/PETCT_978c395243_01132005.nii.gz,/well/papiez/users/hri611/python/nnUnet_raw/Dataset219_PETCT/labelsTr/PETCT_978c395243_01132005.nii.gz,0.883177570093458,0.0,0.0
511,0.9148017275225756,154,63,0.8429811866859623,88158618,1165,1228,1319,/well/papiez/users/hri611/python/nnUNet_results/Dataset219_PETCT/nnUNetTrainer_1500epochs_1e2lr__nnUNetPlans__3d_fullres_maxnum_512_patch_192/crossval_results_folds_0_1_2_3_4/PETCT_979f9c3dba_06222006.nii.gz,/well/papiez/users/hri611/python/nnUnet_raw/Dataset219_PETCT/labelsTr/PETCT_979f9c3dba_06222006.nii.gz,0.9148017275225756,0.0,0.0
512,0.8569098050341789,15051,1088,0.7496432117150658,52095536,48325,49413,63376,/well/papiez/users/hri611/python/nnUNet_results/Dataset219_PETCT/nnUNetTrainer_1500epochs_1e2lr__nnUNetPlans__3d_fullres_maxnum_512_patch_192/crossval_results_folds_0_1_2_3_4/PETCT_983a76fd43_11012001.nii.gz,/well/papiez/users/hri611/python/nnUnet_raw/Dataset219_PETCT/labelsTr/PETCT_983a76fd43_11012001.nii.gz,0.8569098050341789,2.3762350044250486,8.80824284362793
513,0.0,0,158,0.0,52159842,0,158,0,/well/papiez/users/hri611/python/nnUNet_results/Dataset219_PETCT/nnUNetTrainer_1500epochs_1e2lr__nnUNetPlans__3d_fullres_maxnum_512_patch_192/crossval_results_folds_0_1_2_3_4/PETCT_9860ffe82d_11192004.nii.gz,/well/papiez/users/hri611/python/nnUnet_raw/Dataset219_PETCT/labelsTr/PETCT_9860ffe82d_11192004.nii.gz,0.0,1.965681312561035,0.0
514,0.8092643051771117,69,71,0.6796338672768879,52159563,297,368,366,/well/papiez/users/hri611/python/nnUNet_results/Dataset219_PETCT/nnUNetTrainer_1500epochs_1e2lr__nnUNetPlans__3d_fullres_maxnum_512_patch_192/crossval_results_folds_0_1_2_3_4/PETCT_987c8a1160_01222005.nii.gz,/well/papiez/users/hri611/python/nnUnet_raw/Dataset219_PETCT/labelsTr/PETCT_987c8a1160_01222005.nii.gz,0.8092643051771117,0.8833124885559082,0.0
515,0.9236730840277493,7968,1329,0.8581715000533935,45374449,56254,57583,64222,/well/papiez/users/hri611/python/nnUNet_results/Dataset219_PETCT/nnUNetTrainer_1500epochs_1e2lr__nnUNetPlans__3d_fullres_maxnum_512_patch_192/crossval_results_folds_0_1_2_3_4/PETCT_98c6af8b90_05262003.nii.gz,/well/papiez/users/hri611/python/nnUnet_raw/Dataset219_PETCT/labelsTr/PETCT_98c6af8b90_05262003.nii.gz,0.9236730840277493,0.26126144027709963,0.0
516,,0,0,,52160000,0,0,0,/well/papiez/users/hri611/python/nnUNet_results/Dataset219_PETCT/nnUNetTrainer_1500epochs_1e2lr__nnUNetPlans__3d_fullres_maxnum_512_patch_192/crossval_results_folds_0_1_2_3_4/PETCT_98cd91d44e_09062003.nii.gz,/well/papiez/users/hri611/python/nnUnet_raw/Dataset219_PETCT/labelsTr/PETCT_98cd91d44e_09062003.nii.gz,,0.0,0.0
517,0.0,0,89,0.0,58879911,0,89,0,/well/papiez/users/hri611/python/nnUNet_results/Dataset219_PETCT/nnUNetTrainer_1500epochs_1e2lr__nnUNetPlans__3d_fullres_maxnum_512_patch_192/crossval_results_folds_0_1_2_3_4/PETCT_9902caa7ec_08132006.nii.gz,/well/papiez/users/hri611/python/nnUnet_raw/Dataset219_PETCT/labelsTr/PETCT_9902caa7ec_08132006.nii.gz,0.0,1.1072508659362792,0.0
518,0.0,0,258,0.0,94239742,0,258,0,/well/papiez/users/hri611/python/nnUNet_results/Dataset219_PETCT/nnUNetTrainer_1500epochs_1e2lr__nnUNetPlans__3d_fullres_maxnum_512_patch_192/crossval_results_folds_0_1_2_3_4/PETCT_993d40ea7e_12252005.nii.gz,/well/papiez/users/hri611/python/nnUnet_raw/Dataset219_PETCT/labelsTr/PETCT_993d40ea7e_12252005.nii.gz,0.0,3.209783409118652,0.0
519,0.0,0,201,0.0,47359799,0,201,0,/well/papiez/users/hri611/python/nnUNet_results/Dataset219_PETCT/nnUNetTrainer_1500epochs_1e2lr__nnUNetPlans__3d_fullres_maxnum_512_patch_192/crossval_results_folds_0_1_2_3_4/PETCT_997d4ef9a7_07222005.nii.gz,/well/papiez/users/hri611/python/nnUnet_raw/Dataset219_PETCT/labelsTr/PETCT_997d4ef9a7_07222005.nii.gz,0.0,2.5006452140808104,0.0
520,0.7098337517642798,12708,10523,0.5501878170623088,45388354,28415,38938,41123,/well/papiez/users/hri611/python/nnUNet_results/Dataset219_PETCT/nnUNetTrainer_1500epochs_1e2lr__nnUNetPlans__3d_fullres_maxnum_512_patch_192/crossval_results_folds_0_1_2_3_4/PETCT_99a7bfad23_08262000.nii.gz,/well/papiez/users/hri611/python/nnUnet_raw/Dataset219_PETCT/labelsTr/PETCT_99a7bfad23_08262000.nii.gz,0.7098337517642798,2.363793983459473,5.125700637817383
521,,0,0,,48160000,0,0,0,/well/papiez/users/hri611/python/nnUNet_results/Dataset219_PETCT/nnUNetTrainer_1500epochs_1e2lr__nnUNetPlans__3d_fullres_maxnum_512_patch_192/crossval_results_folds_0_1_2_3_4/PETCT_9a2bfe901f_08062005.nii.gz,/well/papiez/users/hri611/python/nnUnet_raw/Dataset219_PETCT/labelsTr/PETCT_9a2bfe901f_08062005.nii.gz,,0.0,0.0
522,0.8521355316110606,303,3114,0.7423659805473874,45426737,9846,12960,10149,/well/papiez/users/hri611/python/nnUNet_results/Dataset219_PETCT/nnUNetTrainer_1500epochs_1e2lr__nnUNetPlans__3d_fullres_maxnum_512_patch_192/crossval_results_folds_0_1_2_3_4/PETCT_9a2c6e618a_02142000.nii.gz,/well/papiez/users/hri611/python/nnUnet_raw/Dataset219_PETCT/labelsTr/PETCT_9a2c6e618a_02142000.nii.gz,0.8521355316110606,0.7091381950378418,0.4105536918640137
523,,0,0,,45440000,0,0,0,/well/papiez/users/hri611/python/nnUNet_results/Dataset219_PETCT/nnUNetTrainer_1500epochs_1e2lr__nnUNetPlans__3d_fullres_maxnum_512_patch_192/crossval_results_folds_0_1_2_3_4/PETCT_9a418f3b3a_05112003.nii.gz,/well/papiez/users/hri611/python/nnUnet_raw/Dataset219_PETCT/labelsTr/PETCT_9a418f3b3a_05112003.nii.gz,,0.0,0.0
524,0.9405306495882891,208,897,0.8877374784110535,53590157,8738,9635,8946,/well/papiez/users/hri611/python/nnUNet_results/Dataset219_PETCT/nnUNetTrainer_1500epochs_1e2lr__nnUNetPlans__3d_fullres_maxnum_512_patch_192/crossval_results_folds_0_1_2_3_4/PETCT_9a583160ea_06212007.nii.gz,/well/papiez/users/hri611/python/nnUnet_raw/Dataset219_PETCT/labelsTr/PETCT_9a583160ea_06212007.nii.gz,0.9405306495882891,1.953240291595459,0.6469330902099609
525,0.0,0,902,0.0,52159098,0,902,0,/well/papiez/users/hri611/python/nnUNet_results/Dataset219_PETCT/nnUNetTrainer_1500epochs_1e2lr__nnUNetPlans__3d_fullres_maxnum_512_patch_192/crossval_results_folds_0_1_2_3_4/PETCT_9a66a81ad1_02262005.nii.gz,/well/papiez/users/hri611/python/nnUnet_raw/Dataset219_PETCT/labelsTr/PETCT_9a66a81ad1_02262005.nii.gz,0.0,11.221800910949707,0.0
526,0.0,0,77,0.0,51679923,0,77,0,/well/papiez/users/hri611/python/nnUNet_results/Dataset219_PETCT/nnUNetTrainer_1500epochs_1e2lr__nnUNetPlans__3d_fullres_maxnum_512_patch_192/crossval_results_folds_0_1_2_3_4/PETCT_9a66a81ad1_05132006.nii.gz,/well/papiez/users/hri611/python/nnUnet_raw/Dataset219_PETCT/labelsTr/PETCT_9a66a81ad1_05132006.nii.gz,0.0,0.9579586143493652,0.0
527,,0,0,,52960000,0,0,0,/well/papiez/users/hri611/python/nnUNet_results/Dataset219_PETCT/nnUNetTrainer_1500epochs_1e2lr__nnUNetPlans__3d_fullres_maxnum_512_patch_192/crossval_results_folds_0_1_2_3_4/PETCT_9a66a81ad1_10212005.nii.gz,/well/papiez/users/hri611/python/nnUnet_raw/Dataset219_PETCT/labelsTr/PETCT_9a66a81ad1_10212005.nii.gz,,0.0,0.0
528,0.0,0,87,0.0,105759913,0,87,0,/well/papiez/users/hri611/python/nnUNet_results/Dataset219_PETCT/nnUNetTrainer_1500epochs_1e2lr__nnUNetPlans__3d_fullres_maxnum_512_patch_192/crossval_results_folds_0_1_2_3_4/PETCT_9a66a81ad1_10312004.nii.gz,/well/papiez/users/hri611/python/nnUnet_raw/Dataset219_PETCT/labelsTr/PETCT_9a66a81ad1_10312004.nii.gz,0.0,1.082368824005127,0.0
529,0.0,0,257,0.0,52159743,0,257,0,/well/papiez/users/hri611/python/nnUNet_results/Dataset219_PETCT/nnUNetTrainer_1500epochs_1e2lr__nnUNetPlans__3d_fullres_maxnum_512_patch_192/crossval_results_folds_0_1_2_3_4/PETCT_9a83943958_08032003.nii.gz,/well/papiez/users/hri611/python/nnUnet_raw/Dataset219_PETCT/labelsTr/PETCT_9a83943958_08032003.nii.gz,0.0,3.1973423881530763,0.0
530,0.8534165598776404,3465,3627,0.7443126509716264,52132263,20645,24272,24110,/well/papiez/users/hri611/python/nnUNet_results/Dataset219_PETCT/nnUNetTrainer_1500epochs_1e2lr__nnUNetPlans__3d_fullres_maxnum_512_patch_192/crossval_results_folds_0_1_2_3_4/PETCT_9aa97cf103_07182004.nii.gz,/well/papiez/users/hri611/python/nnUnet_raw/Dataset219_PETCT/labelsTr/PETCT_9aa97cf103_07182004.nii.gz,0.8534165598776404,0.1741742935180664,0.945517593383789
531,0.8180473372781065,64,182,0.6921151439299124,52159201,553,735,617,/well/papiez/users/hri611/python/nnUNet_results/Dataset219_PETCT/nnUNetTrainer_1500epochs_1e2lr__nnUNetPlans__3d_fullres_maxnum_512_patch_192/crossval_results_folds_0_1_2_3_4/PETCT_9abb9583ec_05302002.nii.gz,/well/papiez/users/hri611/python/nnUnet_raw/Dataset219_PETCT/labelsTr/PETCT_9abb9583ec_05302002.nii.gz,0.8180473372781065,0.0,0.3483485870361328
532,0.0,0,3,0.0,52159997,0,3,0,/well/papiez/users/hri611/python/nnUNet_results/Dataset219_PETCT/nnUNetTrainer_1500epochs_1e2lr__nnUNetPlans__3d_fullres_maxnum_512_patch_192/crossval_results_folds_0_1_2_3_4/PETCT_9ad7dffae6_05222003.nii.gz,/well/papiez/users/hri611/python/nnUnet_raw/Dataset219_PETCT/labelsTr/PETCT_9ad7dffae6_05222003.nii.gz,0.0,0.037323062896728515,0.0
533,0.8084953741760952,10693,2120,0.678549924736578,52120140,27047,29167,37740,/well/papiez/users/hri611/python/nnUNet_results/Dataset219_PETCT/nnUNetTrainer_1500epochs_1e2lr__nnUNetPlans__3d_fullres_maxnum_512_patch_192/crossval_results_folds_0_1_2_3_4/PETCT_9afd440677_03172003.nii.gz,/well/papiez/users/hri611/python/nnUnet_raw/Dataset219_PETCT/labelsTr/PETCT_9afd440677_03172003.nii.gz,0.8084953741760952,0.0,41.82671248626709
534,,0,0,,52160000,0,0,0,/well/papiez/users/hri611/python/nnUNet_results/Dataset219_PETCT/nnUNetTrainer_1500epochs_1e2lr__nnUNetPlans__3d_fullres_maxnum_512_patch_192/crossval_results_folds_0_1_2_3_4/PETCT_9b1bb2165a_10132002.nii.gz,/well/papiez/users/hri611/python/nnUnet_raw/Dataset219_PETCT/labelsTr/PETCT_9b1bb2165a_10132002.nii.gz,,0.0,0.0
535,0.8681339457499694,10677,1180,0.7669935346945193,45389113,39030,40210,49707,/well/papiez/users/hri611/python/nnUNet_results/Dataset219_PETCT/nnUNetTrainer_1500epochs_1e2lr__nnUNetPlans__3d_fullres_maxnum_512_patch_192/crossval_results_folds_0_1_2_3_4/PETCT_9b982e72cb_09152001.nii.gz,/well/papiez/users/hri611/python/nnUnet_raw/Dataset219_PETCT/labelsTr/PETCT_9b982e72cb_09152001.nii.gz,0.8681339457499694,1.7790659980773926,12.217082588195801
536,0.0,0,95,0.0,45439905,0,95,0,/well/papiez/users/hri611/python/nnUNet_results/Dataset219_PETCT/nnUNetTrainer_1500epochs_1e2lr__nnUNetPlans__3d_fullres_maxnum_512_patch_192/crossval_results_folds_0_1_2_3_4/PETCT_9b9d67b3ff_07122003.nii.gz,/well/papiez/users/hri611/python/nnUnet_raw/Dataset219_PETCT/labelsTr/PETCT_9b9d67b3ff_07122003.nii.gz,0.0,1.1818969917297364,0.0
537,,0,0,,54720000,0,0,0,/well/papiez/users/hri611/python/nnUNet_results/Dataset219_PETCT/nnUNetTrainer_1500epochs_1e2lr__nnUNetPlans__3d_fullres_maxnum_512_patch_192/crossval_results_folds_0_1_2_3_4/PETCT_9c36b318e8_11042006.nii.gz,/well/papiez/users/hri611/python/nnUnet_raw/Dataset219_PETCT/labelsTr/PETCT_9c36b318e8_11042006.nii.gz,,0.0,0.0
538,,0,0,,99040000,0,0,0,/well/papiez/users/hri611/python/nnUNet_results/Dataset219_PETCT/nnUNetTrainer_1500epochs_1e2lr__nnUNetPlans__3d_fullres_maxnum_512_patch_192/crossval_results_folds_0_1_2_3_4/PETCT_9c68e484a7_08142003.nii.gz,/well/papiez/users/hri611/python/nnUnet_raw/Dataset219_PETCT/labelsTr/PETCT_9c68e484a7_08142003.nii.gz,,0.0,0.0
539,0.9206728787004206,103,1821,0.8530063412025365,45426911,11165,12986,11268,/well/papiez/users/hri611/python/nnUNet_results/Dataset219_PETCT/nnUNetTrainer_1500epochs_1e2lr__nnUNetPlans__3d_fullres_maxnum_512_patch_192/crossval_results_folds_0_1_2_3_4/PETCT_9c8842d12e_01252004.nii.gz,/well/papiez/users/hri611/python/nnUnet_raw/Dataset219_PETCT/labelsTr/PETCT_9c8842d12e_01252004.nii.gz,0.9206728787004206,2.4259990882873534,0.04976408386230469
540,0.6382781456953642,5377,85,0.4687287228868787,52149719,4819,4904,10196,/well/papiez/users/hri611/python/nnUNet_results/Dataset219_PETCT/nnUNetTrainer_1500epochs_1e2lr__nnUNetPlans__3d_fullres_maxnum_512_patch_192/crossval_results_folds_0_1_2_3_4/PETCT_9c9a347388_09092000.nii.gz,/well/papiez/users/hri611/python/nnUnet_raw/Dataset219_PETCT/labelsTr/PETCT_9c9a347388_09092000.nii.gz,0.6382781456953642,0.0,11.694559707641602
541,,0,0,,52160000,0,0,0,/well/papiez/users/hri611/python/nnUNet_results/Dataset219_PETCT/nnUNetTrainer_1500epochs_1e2lr__nnUNetPlans__3d_fullres_maxnum_512_patch_192/crossval_results_folds_0_1_2_3_4/PETCT_9d6e9223cc_11162002.nii.gz,/well/papiez/users/hri611/python/nnUnet_raw/Dataset219_PETCT/labelsTr/PETCT_9d6e9223cc_11162002.nii.gz,,0.0,0.0
542,0.0,0,97,0.0,52159903,0,97,0,/well/papiez/users/hri611/python/nnUNet_results/Dataset219_PETCT/nnUNetTrainer_1500epochs_1e2lr__nnUNetPlans__3d_fullres_maxnum_512_patch_192/crossval_results_folds_0_1_2_3_4/PETCT_9d97ac5d4d_12122004.nii.gz,/well/papiez/users/hri611/python/nnUnet_raw/Dataset219_PETCT/labelsTr/PETCT_9d97ac5d4d_12122004.nii.gz,0.0,1.2067790336608886,0.0
543,0.3545989847715736,15857,36,0.21550915642430524,52139741,4366,4402,20223,/well/papiez/users/hri611/python/nnUNet_results/Dataset219_PETCT/nnUNetTrainer_1500epochs_1e2lr__nnUNetPlans__3d_fullres_maxnum_512_patch_192/crossval_results_folds_0_1_2_3_4/PETCT_9da159b835_03232002.nii.gz,/well/papiez/users/hri611/python/nnUnet_raw/Dataset219_PETCT/labelsTr/PETCT_9da159b835_03232002.nii.gz,0.3545989847715736,0.0,83.46680965805054
544,0.0,0,235,0.0,52159765,0,235,0,/well/papiez/users/hri611/python/nnUNet_results/Dataset219_PETCT/nnUNetTrainer_1500epochs_1e2lr__nnUNetPlans__3d_fullres_maxnum_512_patch_192/crossval_results_folds_0_1_2_3_4/PETCT_9e864bb710_09142003.nii.gz,/well/papiez/users/hri611/python/nnUnet_raw/Dataset219_PETCT/labelsTr/PETCT_9e864bb710_09142003.nii.gz,0.0,2.9236399269104005,0.0
545,0.9534102526654009,1479,2987,0.9109684621825286,52109838,45696,48683,47175,/well/papiez/users/hri611/python/nnUNet_results/Dataset219_PETCT/nnUNetTrainer_1500epochs_1e2lr__nnUNetPlans__3d_fullres_maxnum_512_patch_192/crossval_results_folds_0_1_2_3_4/PETCT_9f206193d3_04072003.nii.gz,/well/papiez/users/hri611/python/nnUnet_raw/Dataset219_PETCT/labelsTr/PETCT_9f206193d3_04072003.nii.gz,0.9534102526654009,0.48519981765747067,0.9206355514526368
546,,0,0,,52160000,0,0,0,/well/papiez/users/hri611/python/nnUNet_results/Dataset219_PETCT/nnUNetTrainer_1500epochs_1e2lr__nnUNetPlans__3d_fullres_maxnum_512_patch_192/crossval_results_folds_0_1_2_3_4/PETCT_9f206193d3_08042003.nii.gz,/well/papiez/users/hri611/python/nnUnet_raw/Dataset219_PETCT/labelsTr/PETCT_9f206193d3_08042003.nii.gz,,0.0,0.0
547,,0,0,,48160000,0,0,0,/well/papiez/users/hri611/python/nnUNet_results/Dataset219_PETCT/nnUNetTrainer_1500epochs_1e2lr__nnUNetPlans__3d_fullres_maxnum_512_patch_192/crossval_results_folds_0_1_2_3_4/PETCT_9f491f1481_02122006.nii.gz,/well/papiez/users/hri611/python/nnUnet_raw/Dataset219_PETCT/labelsTr/PETCT_9f491f1481_02122006.nii.gz,,0.0,0.0
548,0.0,0,1,0.0,52159999,0,1,0,/well/papiez/users/hri611/python/nnUNet_results/Dataset219_PETCT/nnUNetTrainer_1500epochs_1e2lr__nnUNetPlans__3d_fullres_maxnum_512_patch_192/crossval_results_folds_0_1_2_3_4/PETCT_9f6e8b1b43_11162002.nii.gz,/well/papiez/users/hri611/python/nnUnet_raw/Dataset219_PETCT/labelsTr/PETCT_9f6e8b1b43_11162002.nii.gz,0.0,0.012441020965576172,0.0
549,0.8256880733944955,30,46,0.703125,52159744,180,226,210,/well/papiez/users/hri611/python/nnUNet_results/Dataset219_PETCT/nnUNetTrainer_1500epochs_1e2lr__nnUNetPlans__3d_fullres_maxnum_512_patch_192/crossval_results_folds_0_1_2_3_4/PETCT_9f7c68f5ca_12212001.nii.gz,/well/papiez/users/hri611/python/nnUnet_raw/Dataset219_PETCT/labelsTr/PETCT_9f7c68f5ca_12212001.nii.gz,0.8256880733944955,0.0,0.0
550,0.8295792605184871,393,8,0.7087872185911401,49758623,976,984,1369,/well/papiez/users/hri611/python/nnUNet_results/Dataset219_PETCT/nnUNetTrainer_1500epochs_1e2lr__nnUNetPlans__3d_fullres_maxnum_512_patch_192/crossval_results_folds_0_1_2_3_4/PETCT_9ffd8409b3_07152005.nii.gz,/well/papiez/users/hri611/python/nnUnet_raw/Dataset219_PETCT/labelsTr/PETCT_9ffd8409b3_07152005.nii.gz,0.8295792605184871,0.04976408386230469,1.9283582496643066
551,,0,0,,51040000,0,0,0,/well/papiez/users/hri611/python/nnUNet_results/Dataset219_PETCT/nnUNetTrainer_1500epochs_1e2lr__nnUNetPlans__3d_fullres_maxnum_512_patch_192/crossval_results_folds_0_1_2_3_4/PETCT_a09210d96b_12112005.nii.gz,/well/papiez/users/hri611/python/nnUnet_raw/Dataset219_PETCT/labelsTr/PETCT_a09210d96b_12112005.nii.gz,,0.0,0.0
552,0.8504453820909517,735,5326,0.7398042414355628,52136706,17233,22559,17968,/well/papiez/users/hri611/python/nnUNet_results/Dataset219_PETCT/nnUNetTrainer_1500epochs_1e2lr__nnUNetPlans__3d_fullres_maxnum_512_patch_192/crossval_results_folds_0_1_2_3_4/PETCT_a0c4dc1ef1_01192003.nii.gz,/well/papiez/users/hri611/python/nnUnet_raw/Dataset219_PETCT/labelsTr/PETCT_a0c4dc1ef1_01192003.nii.gz,0.8504453820909517,14.804814949035645,8.58430446624756
553,,0,0,,47200000,0,0,0,/well/papiez/users/hri611/python/nnUNet_results/Dataset219_PETCT/nnUNetTrainer_1500epochs_1e2lr__nnUNetPlans__3d_fullres_maxnum_512_patch_192/crossval_results_folds_0_1_2_3_4/PETCT_a19c2a0c65_03052006.nii.gz,/well/papiez/users/hri611/python/nnUnet_raw/Dataset219_PETCT/labelsTr/PETCT_a19c2a0c65_03052006.nii.gz,,0.0,0.0
554,0.0,126834,42,0.0,52033124,0,42,126834,/well/papiez/users/hri611/python/nnUNet_results/Dataset219_PETCT/nnUNetTrainer_1500epochs_1e2lr__nnUNetPlans__3d_fullres_maxnum_512_patch_192/crossval_results_folds_0_1_2_3_4/PETCT_a19ef8e0d2_12261999.nii.gz,/well/papiez/users/hri611/python/nnUnet_raw/Dataset219_PETCT/labelsTr/PETCT_a19ef8e0d2_12261999.nii.gz,0.0,0.5225228805541993,1577.9444531478882
555,0.9381443298969072,5,43,0.883495145631068,105759588,364,407,369,/well/papiez/users/hri611/python/nnUNet_results/Dataset219_PETCT/nnUNetTrainer_1500epochs_1e2lr__nnUNetPlans__3d_fullres_maxnum_512_patch_192/crossval_results_folds_0_1_2_3_4/PETCT_a1bc00ad60_03062003.nii.gz,/well/papiez/users/hri611/python/nnUnet_raw/Dataset219_PETCT/labelsTr/PETCT_a1bc00ad60_03062003.nii.gz,0.9381443298969072,0.0,0.024882041931152343
556,0.0,0,30,0.0,104479970,0,30,0,/well/papiez/users/hri611/python/nnUNet_results/Dataset219_PETCT/nnUNetTrainer_1500epochs_1e2lr__nnUNetPlans__3d_fullres_maxnum_512_patch_192/crossval_results_folds_0_1_2_3_4/PETCT_a1bc00ad60_08102006.nii.gz,/well/papiez/users/hri611/python/nnUnet_raw/Dataset219_PETCT/labelsTr/PETCT_a1bc00ad60_08102006.nii.gz,0.0,0.37323062896728515,0.0
557,0.0,0,16096,0.0,85583904,0,16096,0,/well/papiez/users/hri611/python/nnUNet_results/Dataset219_PETCT/nnUNetTrainer_1500epochs_1e2lr__nnUNetPlans__3d_fullres_maxnum_512_patch_192/crossval_results_folds_0_1_2_3_4/PETCT_a1d93ebc74_09012003.nii.gz,/well/papiez/users/hri611/python/nnUnet_raw/Dataset219_PETCT/labelsTr/PETCT_a1d93ebc74_09012003.nii.gz,0.0,200.25067346191406,0.0
558,0.9514335868929198,56,27,0.9073660714285714,52159104,813,840,869,/well/papiez/users/hri611/python/nnUNet_results/Dataset219_PETCT/nnUNetTrainer_1500epochs_1e2lr__nnUNetPlans__3d_fullres_maxnum_512_patch_192/crossval_results_folds_0_1_2_3_4/PETCT_a1db71e797_03252005.nii.gz,/well/papiez/users/hri611/python/nnUnet_raw/Dataset219_PETCT/labelsTr/PETCT_a1db71e797_03252005.nii.gz,0.9514335868929198,0.0,0.0
559,0.0,0,5,0.0,72159995,0,5,0,/well/papiez/users/hri611/python/nnUNet_results/Dataset219_PETCT/nnUNetTrainer_1500epochs_1e2lr__nnUNetPlans__3d_fullres_maxnum_512_patch_192/crossval_results_folds_0_1_2_3_4/PETCT_a21200dcba_03102005.nii.gz,/well/papiez/users/hri611/python/nnUnet_raw/Dataset219_PETCT/labelsTr/PETCT_a21200dcba_03102005.nii.gz,0.0,0.06220510482788086,0.0
560,,0,0,,91680000,0,0,0,/well/papiez/users/hri611/python/nnUNet_results/Dataset219_PETCT/nnUNetTrainer_1500epochs_1e2lr__nnUNetPlans__3d_fullres_maxnum_512_patch_192/crossval_results_folds_0_1_2_3_4/PETCT_a22ec7f62b_06302007.nii.gz,/well/papiez/users/hri611/python/nnUnet_raw/Dataset219_PETCT/labelsTr/PETCT_a22ec7f62b_06302007.nii.gz,,0.0,0.0
561,0.0,0,2904,0.0,52157096,0,2904,0,/well/papiez/users/hri611/python/nnUNet_results/Dataset219_PETCT/nnUNetTrainer_1500epochs_1e2lr__nnUNetPlans__3d_fullres_maxnum_512_patch_192/crossval_results_folds_0_1_2_3_4/PETCT_a25083ff81_08282003.nii.gz,/well/papiez/users/hri611/python/nnUnet_raw/Dataset219_PETCT/labelsTr/PETCT_a25083ff81_08282003.nii.gz,0.0,36.128724884033204,0.0
562,,0,0,,72160000,0,0,0,/well/papiez/users/hri611/python/nnUNet_results/Dataset219_PETCT/nnUNetTrainer_1500epochs_1e2lr__nnUNetPlans__3d_fullres_maxnum_512_patch_192/crossval_results_folds_0_1_2_3_4/PETCT_a2676f03c0_05092003.nii.gz,/well/papiez/users/hri611/python/nnUnet_raw/Dataset219_PETCT/labelsTr/PETCT_a2676f03c0_05092003.nii.gz,,0.0,0.0
563,,0,0,,48480000,0,0,0,/well/papiez/users/hri611/python/nnUNet_results/Dataset219_PETCT/nnUNetTrainer_1500epochs_1e2lr__nnUNetPlans__3d_fullres_maxnum_512_patch_192/crossval_results_folds_0_1_2_3_4/PETCT_a29cae0316_06292006.nii.gz,/well/papiez/users/hri611/python/nnUnet_raw/Dataset219_PETCT/labelsTr/PETCT_a29cae0316_06292006.nii.gz,,0.0,0.0
564,0.9618074233458849,20,51,0.9264248704663213,52159035,894,945,914,/well/papiez/users/hri611/python/nnUNet_results/Dataset219_PETCT/nnUNetTrainer_1500epochs_1e2lr__nnUNetPlans__3d_fullres_maxnum_512_patch_192/crossval_results_folds_0_1_2_3_4/PETCT_a2a68bbe97_08212003.nii.gz,/well/papiez/users/hri611/python/nnUnet_raw/Dataset219_PETCT/labelsTr/PETCT_a2a68bbe97_08212003.nii.gz,0.9618074233458849,0.0,0.0
565,,0,0,,52160000,0,0,0,/well/papiez/users/hri611/python/nnUNet_results/Dataset219_PETCT/nnUNetTrainer_1500epochs_1e2lr__nnUNetPlans__3d_fullres_maxnum_512_patch_192/crossval_results_folds_0_1_2_3_4/PETCT_a37b4bca43_06232002.nii.gz,/well/papiez/users/hri611/python/nnUnet_raw/Dataset219_PETCT/labelsTr/PETCT_a37b4bca43_06232002.nii.gz,,0.0,0.0
566,,0,0,,45440000,0,0,0,/well/papiez/users/hri611/python/nnUNet_results/Dataset219_PETCT/nnUNetTrainer_1500epochs_1e2lr__nnUNetPlans__3d_fullres_maxnum_512_patch_192/crossval_results_folds_0_1_2_3_4/PETCT_a37c4e231f_12132002.nii.gz,/well/papiez/users/hri611/python/nnUnet_raw/Dataset219_PETCT/labelsTr/PETCT_a37c4e231f_12132002.nii.gz,,0.0,0.0
567,0.8644668807138344,10157,354,0.7612872456395349,45395968,33521,33875,43678,/well/papiez/users/hri611/python/nnUNet_results/Dataset219_PETCT/nnUNetTrainer_1500epochs_1e2lr__nnUNetPlans__3d_fullres_maxnum_512_patch_192/crossval_results_folds_0_1_2_3_4/PETCT_a37da9e85d_03022002.nii.gz,/well/papiez/users/hri611/python/nnUnet_raw/Dataset219_PETCT/labelsTr/PETCT_a37da9e85d_03022002.nii.gz,0.8644668807138344,0.0,6.95453071975708
568,0.8380411883571951,7179,355,0.7212314067934581,52132974,19492,19847,26671,/well/papiez/users/hri611/python/nnUNet_results/Dataset219_PETCT/nnUNetTrainer_1500epochs_1e2lr__nnUNetPlans__3d_fullres_maxnum_512_patch_192/crossval_results_folds_0_1_2_3_4/PETCT_a3df01d3a3_10052002.nii.gz,/well/papiez/users/hri611/python/nnUnet_raw/Dataset219_PETCT/labelsTr/PETCT_a3df01d3a3_10052002.nii.gz,0.8380411883571951,0.0,6.170746398925781
569,0.6814268142681427,504,1050,0.5167910447761194,52156784,1662,2712,2166,/well/papiez/users/hri611/python/nnUNet_results/Dataset219_PETCT/nnUNetTrainer_1500epochs_1e2lr__nnUNetPlans__3d_fullres_maxnum_512_patch_192/crossval_results_folds_0_1_2_3_4/PETCT_a471649d35_05062002.nii.gz,/well/papiez/users/hri611/python/nnUnet_raw/Dataset219_PETCT/labelsTr/PETCT_a471649d35_05062002.nii.gz,0.6814268142681427,11.769205833435059,0.6469330902099609
570,,0,0,,49120000,0,0,0,/well/papiez/users/hri611/python/nnUNet_results/Dataset219_PETCT/nnUNetTrainer_1500epochs_1e2lr__nnUNetPlans__3d_fullres_maxnum_512_patch_192/crossval_results_folds_0_1_2_3_4/PETCT_a4a66c4fa7_07072006.nii.gz,/well/papiez/users/hri611/python/nnUnet_raw/Dataset219_PETCT/labelsTr/PETCT_a4a66c4fa7_07072006.nii.gz,,0.0,0.0
571,0.0,0,987,0.0,49119013,0,987,0,/well/papiez/users/hri611/python/nnUNet_results/Dataset219_PETCT/nnUNetTrainer_1500epochs_1e2lr__nnUNetPlans__3d_fullres_maxnum_512_patch_192/crossval_results_folds_0_1_2_3_4/PETCT_a4cb97ffc7_07112005.nii.gz,/well/papiez/users/hri611/python/nnUnet_raw/Dataset219_PETCT/labelsTr/PETCT_a4cb97ffc7_07112005.nii.gz,0.0,12.279287693023681,0.0
572,0.0,0,38613,0.0,45401387,0,38613,0,/well/papiez/users/hri611/python/nnUNet_results/Dataset219_PETCT/nnUNetTrainer_1500epochs_1e2lr__nnUNetPlans__3d_fullres_maxnum_512_patch_192/crossval_results_folds_0_1_2_3_4/PETCT_a4ccc397a9_11302002.nii.gz,/well/papiez/users/hri611/python/nnUnet_raw/Dataset219_PETCT/labelsTr/PETCT_a4ccc397a9_11302002.nii.gz,0.0,480.3851425437927,0.0
573,0.0,0,21,0.0,50879979,0,21,0,/well/papiez/users/hri611/python/nnUNet_results/Dataset219_PETCT/nnUNetTrainer_1500epochs_1e2lr__nnUNetPlans__3d_fullres_maxnum_512_patch_192/crossval_results_folds_0_1_2_3_4/PETCT_a4cd2b10de_10152005.nii.gz,/well/papiez/users/hri611/python/nnUnet_raw/Dataset219_PETCT/labelsTr/PETCT_a4cd2b10de_10152005.nii.gz,0.0,0.26126144027709963,0.0
574,,0,0,,53120000,0,0,0,/well/papiez/users/hri611/python/nnUNet_results/Dataset219_PETCT/nnUNetTrainer_1500epochs_1e2lr__nnUNetPlans__3d_fullres_maxnum_512_patch_192/crossval_results_folds_0_1_2_3_4/PETCT_a4cd2b10de_10152006.nii.gz,/well/papiez/users/hri611/python/nnUnet_raw/Dataset219_PETCT/labelsTr/PETCT_a4cd2b10de_10152006.nii.gz,,0.0,0.0
575,0.7769164513350559,213,46,0.6352112676056338,58879290,451,497,664,/well/papiez/users/hri611/python/nnUNet_results/Dataset219_PETCT/nnUNetTrainer_1500epochs_1e2lr__nnUNetPlans__3d_fullres_maxnum_512_patch_192/crossval_results_folds_0_1_2_3_4/PETCT_a4cd2b10de_12292001.nii.gz,/well/papiez/users/hri611/python/nnUnet_raw/Dataset219_PETCT/labelsTr/PETCT_a4cd2b10de_12292001.nii.gz,0.7769164513350559,0.19905633544921875,0.09952816772460937
576,0.5778526534050411,7610,11935,0.40632403863677785,85727078,13377,25312,20987,/well/papiez/users/hri611/python/nnUNet_results/Dataset219_PETCT/nnUNetTrainer_1500epochs_1e2lr__nnUNetPlans__3d_fullres_maxnum_512_patch_192/crossval_results_folds_0_1_2_3_4/PETCT_a4ff5d0d9d_05302005.nii.gz,/well/papiez/users/hri611/python/nnUnet_raw/Dataset219_PETCT/labelsTr/PETCT_a4ff5d0d9d_05302005.nii.gz,0.5778526534050411,106.73151886367798,32.45862369918823
577,0.0,0,19,0.0,52159981,0,19,0,/well/papiez/users/hri611/python/nnUNet_results/Dataset219_PETCT/nnUNetTrainer_1500epochs_1e2lr__nnUNetPlans__3d_fullres_maxnum_512_patch_192/crossval_results_folds_0_1_2_3_4/PETCT_a57bd6b006_11092002.nii.gz,/well/papiez/users/hri611/python/nnUnet_raw/Dataset219_PETCT/labelsTr/PETCT_a57bd6b006_11092002.nii.gz,0.0,0.23637939834594726,0.0
578,0.9503105590062112,213,955,0.9053254437869822,92307663,11169,12124,11382,/well/papiez/users/hri611/python/nnUNet_results/Dataset219_PETCT/nnUNetTrainer_1500epochs_1e2lr__nnUNetPlans__3d_fullres_maxnum_512_patch_192/crossval_results_folds_0_1_2_3_4/PETCT_a61d8768d0_03262004.nii.gz,/well/papiez/users/hri611/python/nnUnet_raw/Dataset219_PETCT/labelsTr/PETCT_a61d8768d0_03262004.nii.gz,0.9503105590062112,0.3856716499328613,0.2737024612426758
579,0.0,0,119,0.0,52159881,0,119,0,/well/papiez/users/hri611/python/nnUNet_results/Dataset219_PETCT/nnUNetTrainer_1500epochs_1e2lr__nnUNetPlans__3d_fullres_maxnum_512_patch_192/crossval_results_folds_0_1_2_3_4/PETCT_a627fc68a1_02142003.nii.gz,/well/papiez/users/hri611/python/nnUnet_raw/Dataset219_PETCT/labelsTr/PETCT_a627fc68a1_02142003.nii.gz,0.0,1.4804814949035645,0.0
580,0.5938009787928222,0,249,0.4222737819025522,99039569,182,431,182,/well/papiez/users/hri611/python/nnUNet_results/Dataset219_PETCT/nnUNetTrainer_1500epochs_1e2lr__nnUNetPlans__3d_fullres_maxnum_512_patch_192/crossval_results_folds_0_1_2_3_4/PETCT_a86b2dc6ce_10142002.nii.gz,/well/papiez/users/hri611/python/nnUnet_raw/Dataset219_PETCT/labelsTr/PETCT_a86b2dc6ce_10142002.nii.gz,0.5938009787928222,1.5053635368347167,0.0
581,0.8924788702257409,26,979,0.8058346213292118,99034824,4171,5150,4197,/well/papiez/users/hri611/python/nnUNet_results/Dataset219_PETCT/nnUNetTrainer_1500epochs_1e2lr__nnUNetPlans__3d_fullres_maxnum_512_patch_192/crossval_results_folds_0_1_2_3_4/PETCT_a86b3fad40_07182003.nii.gz,/well/papiez/users/hri611/python/nnUnet_raw/Dataset219_PETCT/labelsTr/PETCT_a86b3fad40_07182003.nii.gz,0.8924788702257409,0.0,0.0
582,0.0,0,3,0.0,45439997,0,3,0,/well/papiez/users/hri611/python/nnUNet_results/Dataset219_PETCT/nnUNetTrainer_1500epochs_1e2lr__nnUNetPlans__3d_fullres_maxnum_512_patch_192/crossval_results_folds_0_1_2_3_4/PETCT_a87dda9193_01262003.nii.gz,/well/papiez/users/hri611/python/nnUnet_raw/Dataset219_PETCT/labelsTr/PETCT_a87dda9193_01262003.nii.gz,0.0,0.037323062896728515,0.0
583,0.0,0,110,0.0,52159890,0,110,0,/well/papiez/users/hri611/python/nnUNet_results/Dataset219_PETCT/nnUNetTrainer_1500epochs_1e2lr__nnUNetPlans__3d_fullres_maxnum_512_patch_192/crossval_results_folds_0_1_2_3_4/PETCT_a8a5e96821_03112005.nii.gz,/well/papiez/users/hri611/python/nnUnet_raw/Dataset219_PETCT/labelsTr/PETCT_a8a5e96821_03112005.nii.gz,0.0,1.3685123062133788,0.0
584,,0,0,,46720000,0,0,0,/well/papiez/users/hri611/python/nnUNet_results/Dataset219_PETCT/nnUNetTrainer_1500epochs_1e2lr__nnUNetPlans__3d_fullres_maxnum_512_patch_192/crossval_results_folds_0_1_2_3_4/PETCT_a8a5e96821_09302005.nii.gz,/well/papiez/users/hri611/python/nnUnet_raw/Dataset219_PETCT/labelsTr/PETCT_a8a5e96821_09302005.nii.gz,,0.0,0.0
585,0.0,0,30,0.0,52159970,0,30,0,/well/papiez/users/hri611/python/nnUNet_results/Dataset219_PETCT/nnUNetTrainer_1500epochs_1e2lr__nnUNetPlans__3d_fullres_maxnum_512_patch_192/crossval_results_folds_0_1_2_3_4/PETCT_a90955352e_05162003.nii.gz,/well/papiez/users/hri611/python/nnUnet_raw/Dataset219_PETCT/labelsTr/PETCT_a90955352e_05162003.nii.gz,0.0,0.37323062896728515,0.0
586,0.0,0,220,0.0,92319780,0,220,0,/well/papiez/users/hri611/python/nnUNet_results/Dataset219_PETCT/nnUNetTrainer_1500epochs_1e2lr__nnUNetPlans__3d_fullres_maxnum_512_patch_192/crossval_results_folds_0_1_2_3_4/PETCT_a933c9af60_09192002.nii.gz,/well/papiez/users/hri611/python/nnUnet_raw/Dataset219_PETCT/labelsTr/PETCT_a933c9af60_09192002.nii.gz,0.0,2.7370246124267577,0.0
587,0.779452088034748,10,18168,0.6386083499005965,45389700,32122,50290,32132,/well/papiez/users/hri611/python/nnUNet_results/Dataset219_PETCT/nnUNetTrainer_1500epochs_1e2lr__nnUNetPlans__3d_fullres_maxnum_512_patch_192/crossval_results_folds_0_1_2_3_4/PETCT_aa27cb9156_12142003.nii.gz,/well/papiez/users/hri611/python/nnUnet_raw/Dataset219_PETCT/labelsTr/PETCT_aa27cb9156_12142003.nii.gz,0.779452088034748,11.682118686676025,0.0
588,0.634718826405868,4020,462,0.4648997134670487,45431624,3894,4356,7914,/well/papiez/users/hri611/python/nnUNet_results/Dataset219_PETCT/nnUNetTrainer_1500epochs_1e2lr__nnUNetPlans__3d_fullres_maxnum_512_patch_192/crossval_results_folds_0_1_2_3_4/PETCT_ab1fa26e5e_06232001.nii.gz,/well/papiez/users/hri611/python/nnUnet_raw/Dataset219_PETCT/labelsTr/PETCT_ab1fa26e5e_06232001.nii.gz,0.634718826405868,0.0,4.652941841125489
589,0.8861468638088147,1280,1931,0.7955688546507926,105744293,12496,14427,13776,/well/papiez/users/hri611/python/nnUNet_results/Dataset219_PETCT/nnUNetTrainer_1500epochs_1e2lr__nnUNetPlans__3d_fullres_maxnum_512_patch_192/crossval_results_folds_0_1_2_3_4/PETCT_ab953a5230_11032003.nii.gz,/well/papiez/users/hri611/python/nnUnet_raw/Dataset219_PETCT/labelsTr/PETCT_ab953a5230_11032003.nii.gz,0.8861468638088147,1.2441020965576173,1.9781223335266114
590,0.5509567563011043,10467,187,0.38022105875509016,45422810,6536,6723,17003,/well/papiez/users/hri611/python/nnUNet_results/Dataset219_PETCT/nnUNetTrainer_1500epochs_1e2lr__nnUNetPlans__3d_fullres_maxnum_512_patch_192/crossval_results_folds_0_1_2_3_4/PETCT_ac11b344b6_11032002.nii.gz,/well/papiez/users/hri611/python/nnUnet_raw/Dataset219_PETCT/labelsTr/PETCT_ac11b344b6_11032002.nii.gz,0.5509567563011043,0.0,2.0652094802856444
591,0.0,0,1343,0.0,45438657,0,1343,0,/well/papiez/users/hri611/python/nnUNet_results/Dataset219_PETCT/nnUNetTrainer_1500epochs_1e2lr__nnUNetPlans__3d_fullres_maxnum_512_patch_192/crossval_results_folds_0_1_2_3_4/PETCT_ac700ab4db_12042004.nii.gz,/well/papiez/users/hri611/python/nnUnet_raw/Dataset219_PETCT/labelsTr/PETCT_ac700ab4db_12042004.nii.gz,0.0,16.708291156768798,0.0
592,0.09433962264150944,2229,1323,0.04950495049504951,45436263,185,1508,2414,/well/papiez/users/hri611/python/nnUNet_results/Dataset219_PETCT/nnUNetTrainer_1500epochs_1e2lr__nnUNetPlans__3d_fullres_maxnum_512_patch_192/crossval_results_folds_0_1_2_3_4/PETCT_ac75e49284_11132004.nii.gz,/well/papiez/users/hri611/python/nnUnet_raw/Dataset219_PETCT/labelsTr/PETCT_ac75e49284_11132004.nii.gz,0.09433962264150944,16.459470737457274,11.08494968032837
593,0.578484081804765,15541,453,0.4069487188994772,52133031,10975,11428,26516,/well/papiez/users/hri611/python/nnUNet_results/Dataset219_PETCT/nnUNetTrainer_1500epochs_1e2lr__nnUNetPlans__3d_fullres_maxnum_512_patch_192/crossval_results_folds_0_1_2_3_4/PETCT_ad7c6a4a58_03282003.nii.gz,/well/papiez/users/hri611/python/nnUnet_raw/Dataset219_PETCT/labelsTr/PETCT_ad7c6a4a58_03282003.nii.gz,0.578484081804765,0.12441020965576172,35.91722752761841
594,0.8271450762998386,18525,4175,0.7052407417025918,52082988,54312,58487,72837,/well/papiez/users/hri611/python/nnUNet_results/Dataset219_PETCT/nnUNetTrainer_1500epochs_1e2lr__nnUNetPlans__3d_fullres_maxnum_512_patch_192/crossval_results_folds_0_1_2_3_4/PETCT_ad7cd4a9d2_10022003.nii.gz,/well/papiez/users/hri611/python/nnUnet_raw/Dataset219_PETCT/labelsTr/PETCT_ad7cd4a9d2_10022003.nii.gz,0.8271450762998386,3.782070373535156,9.952816772460938
595,0.0,0,72,0.0,52799928,0,72,0,/well/papiez/users/hri611/python/nnUNet_results/Dataset219_PETCT/nnUNetTrainer_1500epochs_1e2lr__nnUNetPlans__3d_fullres_maxnum_512_patch_192/crossval_results_folds_0_1_2_3_4/PETCT_ad99263bec_01292006.nii.gz,/well/papiez/users/hri611/python/nnUnet_raw/Dataset219_PETCT/labelsTr/PETCT_ad99263bec_01292006.nii.gz,0.0,0.8957535095214844,0.0
596,0.0,0,159031,0.0,52000969,0,159031,0,/well/papiez/users/hri611/python/nnUNet_results/Dataset219_PETCT/nnUNetTrainer_1500epochs_1e2lr__nnUNetPlans__3d_fullres_maxnum_512_patch_192/crossval_results_folds_0_1_2_3_4/PETCT_adc49adb3d_09222002.nii.gz,/well/papiez/users/hri611/python/nnUnet_raw/Dataset219_PETCT/labelsTr/PETCT_adc49adb3d_09222002.nii.gz,0.0,1978.5080051765442,0.0
597,0.904525153787815,1,2265,0.8256923076923077,45427000,10734,12999,10735,/well/papiez/users/hri611/python/nnUNet_results/Dataset219_PETCT/nnUNetTrainer_1500epochs_1e2lr__nnUNetPlans__3d_fullres_maxnum_512_patch_192/crossval_results_folds_0_1_2_3_4/PETCT_ae3074834a_07262003.nii.gz,/well/papiez/users/hri611/python/nnUnet_raw/Dataset219_PETCT/labelsTr/PETCT_ae3074834a_07262003.nii.gz,0.904525153787815,0.0,0.0
598,0.0,0,14,0.0,52159986,0,14,0,/well/papiez/users/hri611/python/nnUNet_results/Dataset219_PETCT/nnUNetTrainer_1500epochs_1e2lr__nnUNetPlans__3d_fullres_maxnum_512_patch_192/crossval_results_folds_0_1_2_3_4/PETCT_ae46202abb_02282003.nii.gz,/well/papiez/users/hri611/python/nnUnet_raw/Dataset219_PETCT/labelsTr/PETCT_ae46202abb_02282003.nii.gz,0.0,0.1741742935180664,0.0
599,,0,0,,38720000,0,0,0,/well/papiez/users/hri611/python/nnUNet_results/Dataset219_PETCT/nnUNetTrainer_1500epochs_1e2lr__nnUNetPlans__3d_fullres_maxnum_512_patch_192/crossval_results_folds_0_1_2_3_4/PETCT_ae4dcc5dd3_10082004.nii.gz,/well/papiez/users/hri611/python/nnUnet_raw/Dataset219_PETCT/labelsTr/PETCT_ae4dcc5dd3_10082004.nii.gz,,0.0,0.0
600,0.0,0,146,0.0,52159854,0,146,0,/well/papiez/users/hri611/python/nnUNet_results/Dataset219_PETCT/nnUNetTrainer_1500epochs_1e2lr__nnUNetPlans__3d_fullres_maxnum_512_patch_192/crossval_results_folds_0_1_2_3_4/PETCT_ae6a37a9d6_02102005.nii.gz,/well/papiez/users/hri611/python/nnUnet_raw/Dataset219_PETCT/labelsTr/PETCT_ae6a37a9d6_02102005.nii.gz,0.0,1.8163890609741211,0.0
601,0.0,0,82,0.0,49439918,0,82,0,/well/papiez/users/hri611/python/nnUNet_results/Dataset219_PETCT/nnUNetTrainer_1500epochs_1e2lr__nnUNetPlans__3d_fullres_maxnum_512_patch_192/crossval_results_folds_0_1_2_3_4/PETCT_ae6a37a9d6_02182006.nii.gz,/well/papiez/users/hri611/python/nnUnet_raw/Dataset219_PETCT/labelsTr/PETCT_ae6a37a9d6_02182006.nii.gz,0.0,1.0201637191772461,0.0
602,0.0,0,48,0.0,48159952,0,48,0,/well/papiez/users/hri611/python/nnUNet_results/Dataset219_PETCT/nnUNetTrainer_1500epochs_1e2lr__nnUNetPlans__3d_fullres_maxnum_512_patch_192/crossval_results_folds_0_1_2_3_4/PETCT_ae6a37a9d6_08182005.nii.gz,/well/papiez/users/hri611/python/nnUnet_raw/Dataset219_PETCT/labelsTr/PETCT_ae6a37a9d6_08182005.nii.gz,0.0,0.5971690063476562,0.0
603,,0,0,,52160000,0,0,0,/well/papiez/users/hri611/python/nnUNet_results/Dataset219_PETCT/nnUNetTrainer_1500epochs_1e2lr__nnUNetPlans__3d_fullres_maxnum_512_patch_192/crossval_results_folds_0_1_2_3_4/PETCT_ae6a37a9d6_09132003.nii.gz,/well/papiez/users/hri611/python/nnUnet_raw/Dataset219_PETCT/labelsTr/PETCT_ae6a37a9d6_09132003.nii.gz,,0.0,0.0
604,0.0,0,80,0.0,52159920,0,80,0,/well/papiez/users/hri611/python/nnUNet_results/Dataset219_PETCT/nnUNetTrainer_1500epochs_1e2lr__nnUNetPlans__3d_fullres_maxnum_512_patch_192/crossval_results_folds_0_1_2_3_4/PETCT_ae6a37a9d6_09152002.nii.gz,/well/papiez/users/hri611/python/nnUnet_raw/Dataset219_PETCT/labelsTr/PETCT_ae6a37a9d6_09152002.nii.gz,0.0,0.9952816772460937,0.0
605,0.0,2869,236,0.0,52156895,0,236,2869,/well/papiez/users/hri611/python/nnUNet_results/Dataset219_PETCT/nnUNetTrainer_1500epochs_1e2lr__nnUNetPlans__3d_fullres_maxnum_512_patch_192/crossval_results_folds_0_1_2_3_4/PETCT_ae96f738c0_05012003.nii.gz,/well/papiez/users/hri611/python/nnUnet_raw/Dataset219_PETCT/labelsTr/PETCT_ae96f738c0_05012003.nii.gz,0.0,2.9360809478759764,35.69328915023804
606,,0,0,,52160000,0,0,0,/well/papiez/users/hri611/python/nnUNet_results/Dataset219_PETCT/nnUNetTrainer_1500epochs_1e2lr__nnUNetPlans__3d_fullres_maxnum_512_patch_192/crossval_results_folds_0_1_2_3_4/PETCT_ae96f738c0_09112003.nii.gz,/well/papiez/users/hri611/python/nnUnet_raw/Dataset219_PETCT/labelsTr/PETCT_ae96f738c0_09112003.nii.gz,,0.0,0.0
607,0.7686949395615652,784,1474,0.6242928452579035,45433990,3752,5226,4536,/well/papiez/users/hri611/python/nnUNet_results/Dataset219_PETCT/nnUNetTrainer_1500epochs_1e2lr__nnUNetPlans__3d_fullres_maxnum_512_patch_192/crossval_results_folds_0_1_2_3_4/PETCT_aea7906fd2_12162001.nii.gz,/well/papiez/users/hri611/python/nnUnet_raw/Dataset219_PETCT/labelsTr/PETCT_aea7906fd2_12162001.nii.gz,0.7686949395615652,0.360789608001709,5.78507474899292
608,0.93968191923387,1703,766,0.8862264411778259,52138299,19232,19998,20935,/well/papiez/users/hri611/python/nnUNet_results/Dataset219_PETCT/nnUNetTrainer_1500epochs_1e2lr__nnUNetPlans__3d_fullres_maxnum_512_patch_192/crossval_results_folds_0_1_2_3_4/PETCT_aee7d68f86_04152002.nii.gz,/well/papiez/users/hri611/python/nnUnet_raw/Dataset219_PETCT/labelsTr/PETCT_aee7d68f86_04152002.nii.gz,0.93968191923387,0.0,0.0
609,,0,0,,99040000,0,0,0,/well/papiez/users/hri611/python/nnUNet_results/Dataset219_PETCT/nnUNetTrainer_1500epochs_1e2lr__nnUNetPlans__3d_fullres_maxnum_512_patch_192/crossval_results_folds_0_1_2_3_4/PETCT_af119148fe_02112005.nii.gz,/well/papiez/users/hri611/python/nnUnet_raw/Dataset219_PETCT/labelsTr/PETCT_af119148fe_02112005.nii.gz,,0.0,0.0
610,,0,0,,99040000,0,0,0,/well/papiez/users/hri611/python/nnUNet_results/Dataset219_PETCT/nnUNetTrainer_1500epochs_1e2lr__nnUNetPlans__3d_fullres_maxnum_512_patch_192/crossval_results_folds_0_1_2_3_4/PETCT_af119148fe_10052003.nii.gz,/well/papiez/users/hri611/python/nnUnet_raw/Dataset219_PETCT/labelsTr/PETCT_af119148fe_10052003.nii.gz,,0.0,0.0
611,,0,0,,99040000,0,0,0,/well/papiez/users/hri611/python/nnUNet_results/Dataset219_PETCT/nnUNetTrainer_1500epochs_1e2lr__nnUNetPlans__3d_fullres_maxnum_512_patch_192/crossval_results_folds_0_1_2_3_4/PETCT_af119148fe_12052002.nii.gz,/well/papiez/users/hri611/python/nnUnet_raw/Dataset219_PETCT/labelsTr/PETCT_af119148fe_12052002.nii.gz,,0.0,0.0
612,0.0,0,1620,0.0,45438380,0,1620,0,/well/papiez/users/hri611/python/nnUNet_results/Dataset219_PETCT/nnUNetTrainer_1500epochs_1e2lr__nnUNetPlans__3d_fullres_maxnum_512_patch_192/crossval_results_folds_0_1_2_3_4/PETCT_af547fa618_03112006.nii.gz,/well/papiez/users/hri611/python/nnUnet_raw/Dataset219_PETCT/labelsTr/PETCT_af547fa618_03112006.nii.gz,0.0,20.154453964233397,0.0
613,0.9482614410323814,357,76,0.9016132697114292,99035599,3968,4044,4325,/well/papiez/users/hri611/python/nnUNet_results/Dataset219_PETCT/nnUNetTrainer_1500epochs_1e2lr__nnUNetPlans__3d_fullres_maxnum_512_patch_192/crossval_results_folds_0_1_2_3_4/PETCT_af73b85f2c_06192003.nii.gz,/well/papiez/users/hri611/python/nnUnet_raw/Dataset219_PETCT/labelsTr/PETCT_af73b85f2c_06192003.nii.gz,0.9482614410323814,0.0,0.0
614,0.7974692645049968,1745,1072,0.6631591534138467,52151637,5546,6618,7291,/well/papiez/users/hri611/python/nnUNet_results/Dataset219_PETCT/nnUNetTrainer_1500epochs_1e2lr__nnUNetPlans__3d_fullres_maxnum_512_patch_192/crossval_results_folds_0_1_2_3_4/PETCT_b04be2846e_11152004.nii.gz,/well/papiez/users/hri611/python/nnUnet_raw/Dataset219_PETCT/labelsTr/PETCT_b04be2846e_11152004.nii.gz,0.7974692645049968,6.145864356994629,7.613904830932617
615,,0,0,,49440000,0,0,0,/well/papiez/users/hri611/python/nnUNet_results/Dataset219_PETCT/nnUNetTrainer_1500epochs_1e2lr__nnUNetPlans__3d_fullres_maxnum_512_patch_192/crossval_results_folds_0_1_2_3_4/PETCT_b0e002e974_03112007.nii.gz,/well/papiez/users/hri611/python/nnUnet_raw/Dataset219_PETCT/labelsTr/PETCT_b0e002e974_03112007.nii.gz,,0.0,0.0
616,,0,0,,58880000,0,0,0,/well/papiez/users/hri611/python/nnUNet_results/Dataset219_PETCT/nnUNetTrainer_1500epochs_1e2lr__nnUNetPlans__3d_fullres_maxnum_512_patch_192/crossval_results_folds_0_1_2_3_4/PETCT_b0e002e974_04022005.nii.gz,/well/papiez/users/hri611/python/nnUnet_raw/Dataset219_PETCT/labelsTr/PETCT_b0e002e974_04022005.nii.gz,,0.0,0.0
617,,0,0,,52800000,0,0,0,/well/papiez/users/hri611/python/nnUNet_results/Dataset219_PETCT/nnUNetTrainer_1500epochs_1e2lr__nnUNetPlans__3d_fullres_maxnum_512_patch_192/crossval_results_folds_0_1_2_3_4/PETCT_b0e002e974_09232005.nii.gz,/well/papiez/users/hri611/python/nnUnet_raw/Dataset219_PETCT/labelsTr/PETCT_b0e002e974_09232005.nii.gz,,0.0,0.0
618,0.8585723001830384,963,196,0.7521915757964507,52155323,3518,3714,4481,/well/papiez/users/hri611/python/nnUNet_results/Dataset219_PETCT/nnUNetTrainer_1500epochs_1e2lr__nnUNetPlans__3d_fullres_maxnum_512_patch_192/crossval_results_folds_0_1_2_3_4/PETCT_b1aa7ce13e_03092003.nii.gz,/well/papiez/users/hri611/python/nnUnet_raw/Dataset219_PETCT/labelsTr/PETCT_b1aa7ce13e_03092003.nii.gz,0.8585723001830384,0.0,2.749465633392334
619,,0,0,,50080000,0,0,0,/well/papiez/users/hri611/python/nnUNet_results/Dataset219_PETCT/nnUNetTrainer_1500epochs_1e2lr__nnUNetPlans__3d_fullres_maxnum_512_patch_192/crossval_results_folds_0_1_2_3_4/PETCT_b1d6679284_05282007.nii.gz,/well/papiez/users/hri611/python/nnUnet_raw/Dataset219_PETCT/labelsTr/PETCT_b1d6679284_05282007.nii.gz,,0.0,0.0
620,0.0,0,59,0.0,45439941,0,59,0,/well/papiez/users/hri611/python/nnUNet_results/Dataset219_PETCT/nnUNetTrainer_1500epochs_1e2lr__nnUNetPlans__3d_fullres_maxnum_512_patch_192/crossval_results_folds_0_1_2_3_4/PETCT_b1de3d4248_11202003.nii.gz,/well/papiez/users/hri611/python/nnUnet_raw/Dataset219_PETCT/labelsTr/PETCT_b1de3d4248_11202003.nii.gz,0.0,0.7340202369689941,0.0
621,0.612774058028095,9324,2474,0.4417262101925898,52138867,9335,11809,18659,/well/papiez/users/hri611/python/nnUNet_results/Dataset219_PETCT/nnUNetTrainer_1500epochs_1e2lr__nnUNetPlans__3d_fullres_maxnum_512_patch_192/crossval_results_folds_0_1_2_3_4/PETCT_b258dfa7c2_12152002.nii.gz,/well/papiez/users/hri611/python/nnUnet_raw/Dataset219_PETCT/labelsTr/PETCT_b258dfa7c2_12152002.nii.gz,0.612774058028095,22.281868549346925,12.577872196197509
622,0.0,0,1,0.0,45439999,0,1,0,/well/papiez/users/hri611/python/nnUNet_results/Dataset219_PETCT/nnUNetTrainer_1500epochs_1e2lr__nnUNetPlans__3d_fullres_maxnum_512_patch_192/crossval_results_folds_0_1_2_3_4/PETCT_b2f82ed4b9_04172003.nii.gz,/well/papiez/users/hri611/python/nnUnet_raw/Dataset219_PETCT/labelsTr/PETCT_b2f82ed4b9_04172003.nii.gz,0.0,0.012441020965576172,0.0
623,0.8751896173942356,5104,820,0.7780774705926425,45413306,20770,21590,25874,/well/papiez/users/hri611/python/nnUNet_results/Dataset219_PETCT/nnUNetTrainer_1500epochs_1e2lr__nnUNetPlans__3d_fullres_maxnum_512_patch_192/crossval_results_folds_0_1_2_3_4/PETCT_b2f82ed4b9_11112002.nii.gz,/well/papiez/users/hri611/python/nnUnet_raw/Dataset219_PETCT/labelsTr/PETCT_b2f82ed4b9_11112002.nii.gz,0.8751896173942356,0.4478767547607422,5.038613491058349
624,0.8200439245215365,4622,7423,0.6949783484008205,45400511,27444,34867,32066,/well/papiez/users/hri611/python/nnUNet_results/Dataset219_PETCT/nnUNetTrainer_1500epochs_1e2lr__nnUNetPlans__3d_fullres_maxnum_512_patch_192/crossval_results_folds_0_1_2_3_4/PETCT_b327726c24_08272000.nii.gz,/well/papiez/users/hri611/python/nnUnet_raw/Dataset219_PETCT/labelsTr/PETCT_b327726c24_08272000.nii.gz,0.8200439245215365,8.758478759765625,0.012441020965576172
625,0.46485431726462373,11857,210,0.30280795008088746,52142692,5241,5451,17098,/well/papiez/users/hri611/python/nnUNet_results/Dataset219_PETCT/nnUNetTrainer_1500epochs_1e2lr__nnUNetPlans__3d_fullres_maxnum_512_patch_192/crossval_results_folds_0_1_2_3_4/PETCT_b3d4773f85_11042000.nii.gz,/well/papiez/users/hri611/python/nnUnet_raw/Dataset219_PETCT/labelsTr/PETCT_b3d4773f85_11042000.nii.gz,0.46485431726462373,0.0,15.377101913452147
626,,0,0,,52160000,0,0,0,/well/papiez/users/hri611/python/nnUNet_results/Dataset219_PETCT/nnUNetTrainer_1500epochs_1e2lr__nnUNetPlans__3d_fullres_maxnum_512_patch_192/crossval_results_folds_0_1_2_3_4/PETCT_b3e923029c_07192003.nii.gz,/well/papiez/users/hri611/python/nnUnet_raw/Dataset219_PETCT/labelsTr/PETCT_b3e923029c_07192003.nii.gz,,0.0,0.0
627,,0,0,,52160000,0,0,0,/well/papiez/users/hri611/python/nnUNet_results/Dataset219_PETCT/nnUNetTrainer_1500epochs_1e2lr__nnUNetPlans__3d_fullres_maxnum_512_patch_192/crossval_results_folds_0_1_2_3_4/PETCT_b3e923029c_11212003.nii.gz,/well/papiez/users/hri611/python/nnUnet_raw/Dataset219_PETCT/labelsTr/PETCT_b3e923029c_11212003.nii.gz,,0.0,0.0
628,0.864406779661017,0,48,0.7611940298507462,58879799,153,201,153,/well/papiez/users/hri611/python/nnUNet_results/Dataset219_PETCT/nnUNetTrainer_1500epochs_1e2lr__nnUNetPlans__3d_fullres_maxnum_512_patch_192/crossval_results_folds_0_1_2_3_4/PETCT_b41bc7c1e5_03122005.nii.gz,/well/papiez/users/hri611/python/nnUnet_raw/Dataset219_PETCT/labelsTr/PETCT_b41bc7c1e5_03122005.nii.gz,0.864406779661017,0.0,0.0
629,,0,0,,59200000,0,0,0,/well/papiez/users/hri611/python/nnUNet_results/Dataset219_PETCT/nnUNetTrainer_1500epochs_1e2lr__nnUNetPlans__3d_fullres_maxnum_512_patch_192/crossval_results_folds_0_1_2_3_4/PETCT_b41bc7c1e5_08062006.nii.gz,/well/papiez/users/hri611/python/nnUnet_raw/Dataset219_PETCT/labelsTr/PETCT_b41bc7c1e5_08062006.nii.gz,,0.0,0.0
630,0.0,0,8,0.0,58879992,0,8,0,/well/papiez/users/hri611/python/nnUNet_results/Dataset219_PETCT/nnUNetTrainer_1500epochs_1e2lr__nnUNetPlans__3d_fullres_maxnum_512_patch_192/crossval_results_folds_0_1_2_3_4/PETCT_b41bc7c1e5_11052006.nii.gz,/well/papiez/users/hri611/python/nnUnet_raw/Dataset219_PETCT/labelsTr/PETCT_b41bc7c1e5_11052006.nii.gz,0.0,0.09952816772460937,0.0
631,,0,0,,45120000,0,0,0,/well/papiez/users/hri611/python/nnUNet_results/Dataset219_PETCT/nnUNetTrainer_1500epochs_1e2lr__nnUNetPlans__3d_fullres_maxnum_512_patch_192/crossval_results_folds_0_1_2_3_4/PETCT_b4247b8ecd_05272007.nii.gz,/well/papiez/users/hri611/python/nnUnet_raw/Dataset219_PETCT/labelsTr/PETCT_b4247b8ecd_05272007.nii.gz,,0.0,0.0
632,0.0,0,256,0.0,45119744,0,256,0,/well/papiez/users/hri611/python/nnUNet_results/Dataset219_PETCT/nnUNetTrainer_1500epochs_1e2lr__nnUNetPlans__3d_fullres_maxnum_512_patch_192/crossval_results_folds_0_1_2_3_4/PETCT_b4247b8ecd_10202006.nii.gz,/well/papiez/users/hri611/python/nnUnet_raw/Dataset219_PETCT/labelsTr/PETCT_b4247b8ecd_10202006.nii.gz,0.0,3.1849013671875,0.0
633,0.0,0,24,0.0,52159976,0,24,0,/well/papiez/users/hri611/python/nnUNet_results/Dataset219_PETCT/nnUNetTrainer_1500epochs_1e2lr__nnUNetPlans__3d_fullres_maxnum_512_patch_192/crossval_results_folds_0_1_2_3_4/PETCT_b42adab18e_09052003.nii.gz,/well/papiez/users/hri611/python/nnUnet_raw/Dataset219_PETCT/labelsTr/PETCT_b42adab18e_09052003.nii.gz,0.0,0.2985845031738281,0.0
634,0.0,0,5,0.0,52159995,0,5,0,/well/papiez/users/hri611/python/nnUNet_results/Dataset219_PETCT/nnUNetTrainer_1500epochs_1e2lr__nnUNetPlans__3d_fullres_maxnum_512_patch_192/crossval_results_folds_0_1_2_3_4/PETCT_b4e5c1047c_10102004.nii.gz,/well/papiez/users/hri611/python/nnUnet_raw/Dataset219_PETCT/labelsTr/PETCT_b4e5c1047c_10102004.nii.gz,0.0,0.06220510482788086,0.0
635,0.8218722422103047,67,5181,0.6976087582829156,52142645,12107,17288,12174,/well/papiez/users/hri611/python/nnUNet_results/Dataset219_PETCT/nnUNetTrainer_1500epochs_1e2lr__nnUNetPlans__3d_fullres_maxnum_512_patch_192/crossval_results_folds_0_1_2_3_4/PETCT_b509ace2a2_05272002.nii.gz,/well/papiez/users/hri611/python/nnUnet_raw/Dataset219_PETCT/labelsTr/PETCT_b509ace2a2_05272002.nii.gz,0.8218722422103047,0.2239383773803711,0.5349639015197754
636,0.45849802371541504,4,544,0.29743589743589743,52159220,232,776,236,/well/papiez/users/hri611/python/nnUNet_results/Dataset219_PETCT/nnUNetTrainer_1500epochs_1e2lr__nnUNetPlans__3d_fullres_maxnum_512_patch_192/crossval_results_folds_0_1_2_3_4/PETCT_b510436d83_11102002.nii.gz,/well/papiez/users/hri611/python/nnUnet_raw/Dataset219_PETCT/labelsTr/PETCT_b510436d83_11102002.nii.gz,0.45849802371541504,6.332479671478271,0.0
637,0.0,137,0,0.0,45439863,0,0,137,/well/papiez/users/hri611/python/nnUNet_results/Dataset219_PETCT/nnUNetTrainer_1500epochs_1e2lr__nnUNetPlans__3d_fullres_maxnum_512_patch_192/crossval_results_folds_0_1_2_3_4/PETCT_b510436d83_11142003.nii.gz,/well/papiez/users/hri611/python/nnUnet_raw/Dataset219_PETCT/labelsTr/PETCT_b510436d83_11142003.nii.gz,0.0,0.0,1.7044198722839354
638,0.8390332079652468,4296,1225,0.7227021597187343,52140090,14389,15614,18685,/well/papiez/users/hri611/python/nnUNet_results/Dataset219_PETCT/nnUNetTrainer_1500epochs_1e2lr__nnUNetPlans__3d_fullres_maxnum_512_patch_192/crossval_results_folds_0_1_2_3_4/PETCT_b52920038c_06072003.nii.gz,/well/papiez/users/hri611/python/nnUnet_raw/Dataset219_PETCT/labelsTr/PETCT_b52920038c_06072003.nii.gz,0.8390332079652468,0.0,2.625055423736572
639,0.6777539046359805,2335,13263,0.5125777319458767,52127999,16403,29666,18738,/well/papiez/users/hri611/python/nnUNet_results/Dataset219_PETCT/nnUNetTrainer_1500epochs_1e2lr__nnUNetPlans__3d_fullres_maxnum_512_patch_192/crossval_results_folds_0_1_2_3_4/PETCT_b53ba7c6bf_11212003.nii.gz,/well/papiez/users/hri611/python/nnUnet_raw/Dataset219_PETCT/labelsTr/PETCT_b53ba7c6bf_11212003.nii.gz,0.6777539046359805,67.13174913024902,7.054058887481689
640,,0,0,,55520000,0,0,0,/well/papiez/users/hri611/python/nnUNet_results/Dataset219_PETCT/nnUNetTrainer_1500epochs_1e2lr__nnUNetPlans__3d_fullres_maxnum_512_patch_192/crossval_results_folds_0_1_2_3_4/PETCT_b57e1c1f5f_06252006.nii.gz,/well/papiez/users/hri611/python/nnUnet_raw/Dataset219_PETCT/labelsTr/PETCT_b57e1c1f5f_06252006.nii.gz,,0.0,0.0
641,0.9273743016759777,5,125,0.8645833333333334,52799040,830,955,835,/well/papiez/users/hri611/python/nnUNet_results/Dataset219_PETCT/nnUNetTrainer_1500epochs_1e2lr__nnUNetPlans__3d_fullres_maxnum_512_patch_192/crossval_results_folds_0_1_2_3_4/PETCT_b5923963ac_02172007.nii.gz,/well/papiez/users/hri611/python/nnUnet_raw/Dataset219_PETCT/labelsTr/PETCT_b5923963ac_02172007.nii.gz,0.9273743016759777,0.0,0.0
642,0.0,0,33,0.0,52959967,0,33,0,/well/papiez/users/hri611/python/nnUNet_results/Dataset219_PETCT/nnUNetTrainer_1500epochs_1e2lr__nnUNetPlans__3d_fullres_maxnum_512_patch_192/crossval_results_folds_0_1_2_3_4/PETCT_b5923963ac_06022007.nii.gz,/well/papiez/users/hri611/python/nnUnet_raw/Dataset219_PETCT/labelsTr/PETCT_b5923963ac_06022007.nii.gz,0.0,0.4105536918640137,0.0
643,,0,0,,38720000,0,0,0,/well/papiez/users/hri611/python/nnUNet_results/Dataset219_PETCT/nnUNetTrainer_1500epochs_1e2lr__nnUNetPlans__3d_fullres_maxnum_512_patch_192/crossval_results_folds_0_1_2_3_4/PETCT_b621742469_11042004.nii.gz,/well/papiez/users/hri611/python/nnUnet_raw/Dataset219_PETCT/labelsTr/PETCT_b621742469_11042004.nii.gz,,0.0,0.0
644,,0,0,,52160000,0,0,0,/well/papiez/users/hri611/python/nnUNet_results/Dataset219_PETCT/nnUNetTrainer_1500epochs_1e2lr__nnUNetPlans__3d_fullres_maxnum_512_patch_192/crossval_results_folds_0_1_2_3_4/PETCT_b62864161e_07282002.nii.gz,/well/papiez/users/hri611/python/nnUnet_raw/Dataset219_PETCT/labelsTr/PETCT_b62864161e_07282002.nii.gz,,0.0,0.0
645,0.0,0,207,0.0,94239793,0,207,0,/well/papiez/users/hri611/python/nnUNet_results/Dataset219_PETCT/nnUNetTrainer_1500epochs_1e2lr__nnUNetPlans__3d_fullres_maxnum_512_patch_192/crossval_results_folds_0_1_2_3_4/PETCT_b663adb148_06212007.nii.gz,/well/papiez/users/hri611/python/nnUnet_raw/Dataset219_PETCT/labelsTr/PETCT_b663adb148_06212007.nii.gz,0.0,2.5752913398742674,0.0
646,0.0,0,20,0.0,52159980,0,20,0,/well/papiez/users/hri611/python/nnUNet_results/Dataset219_PETCT/nnUNetTrainer_1500epochs_1e2lr__nnUNetPlans__3d_fullres_maxnum_512_patch_192/crossval_results_folds_0_1_2_3_4/PETCT_b66ba83594_03132003.nii.gz,/well/papiez/users/hri611/python/nnUnet_raw/Dataset219_PETCT/labelsTr/PETCT_b66ba83594_03132003.nii.gz,0.0,0.24882041931152343,0.0
647,0.7622969572180279,80,959,0.6158964879852126,49437295,1666,2625,1746,/well/papiez/users/hri611/python/nnUNet_results/Dataset219_PETCT/nnUNetTrainer_1500epochs_1e2lr__nnUNetPlans__3d_fullres_maxnum_512_patch_192/crossval_results_folds_0_1_2_3_4/PETCT_b6a1ee33ef_10242005.nii.gz,/well/papiez/users/hri611/python/nnUnet_raw/Dataset219_PETCT/labelsTr/PETCT_b6a1ee33ef_10242005.nii.gz,0.7622969572180279,5.36208003616333,0.0
648,0.44086021505376344,722,6,0.2827586206896552,52158985,287,293,1009,/well/papiez/users/hri611/python/nnUNet_results/Dataset219_PETCT/nnUNetTrainer_1500epochs_1e2lr__nnUNetPlans__3d_fullres_maxnum_512_patch_192/crossval_results_folds_0_1_2_3_4/PETCT_b6a3c72db6_07132002.nii.gz,/well/papiez/users/hri611/python/nnUnet_raw/Dataset219_PETCT/labelsTr/PETCT_b6a3c72db6_07132002.nii.gz,0.44086021505376344,0.0,7.825402187347412
649,0.8821106900411827,10211,1268,0.7890858980248048,45385575,42946,44214,53157,/well/papiez/users/hri611/python/nnUNet_results/Dataset219_PETCT/nnUNetTrainer_1500epochs_1e2lr__nnUNetPlans__3d_fullres_maxnum_512_patch_192/crossval_results_folds_0_1_2_3_4/PETCT_b6fc20942c_12282001.nii.gz,/well/papiez/users/hri611/python/nnUnet_raw/Dataset219_PETCT/labelsTr/PETCT_b6fc20942c_12282001.nii.gz,0.8821106900411827,0.04976408386230469,0.58472798538208
650,,0,0,,46880000,0,0,0,/well/papiez/users/hri611/python/nnUNet_results/Dataset219_PETCT/nnUNetTrainer_1500epochs_1e2lr__nnUNetPlans__3d_fullres_maxnum_512_patch_192/crossval_results_folds_0_1_2_3_4/PETCT_b79961f3f6_07072007.nii.gz,/well/papiez/users/hri611/python/nnUnet_raw/Dataset219_PETCT/labelsTr/PETCT_b79961f3f6_07072007.nii.gz,,0.0,0.0
651,0.8858178622432166,200,4997,0.7950386496292791,52134644,20159,25156,20359,/well/papiez/users/hri611/python/nnUNet_results/Dataset219_PETCT/nnUNetTrainer_1500epochs_1e2lr__nnUNetPlans__3d_fullres_maxnum_512_patch_192/crossval_results_folds_0_1_2_3_4/PETCT_b7c1533a39_02122005.nii.gz,/well/papiez/users/hri611/python/nnUnet_raw/Dataset219_PETCT/labelsTr/PETCT_b7c1533a39_02122005.nii.gz,0.8858178622432166,12.465903007507324,2.0030043754577638
652,0.806146572104019,2580,1356,0.6752475247524753,38707880,8184,9540,10764,/well/papiez/users/hri611/python/nnUNet_results/Dataset219_PETCT/nnUNetTrainer_1500epochs_1e2lr__nnUNetPlans__3d_fullres_maxnum_512_patch_192/crossval_results_folds_0_1_2_3_4/PETCT_b899150306_08112002.nii.gz,/well/papiez/users/hri611/python/nnUnet_raw/Dataset219_PETCT/labelsTr/PETCT_b899150306_08112002.nii.gz,0.806146572104019,0.0,11.806528896331788
653,0.0,0,53,0.0,52159947,0,53,0,/well/papiez/users/hri611/python/nnUNet_results/Dataset219_PETCT/nnUNetTrainer_1500epochs_1e2lr__nnUNetPlans__3d_fullres_maxnum_512_patch_192/crossval_results_folds_0_1_2_3_4/PETCT_b926177c87_10102004.nii.gz,/well/papiez/users/hri611/python/nnUnet_raw/Dataset219_PETCT/labelsTr/PETCT_b926177c87_10102004.nii.gz,0.0,0.6593741111755371,0.0
654,,0,0,,44320000,0,0,0,/well/papiez/users/hri611/python/nnUNet_results/Dataset219_PETCT/nnUNetTrainer_1500epochs_1e2lr__nnUNetPlans__3d_fullres_maxnum_512_patch_192/crossval_results_folds_0_1_2_3_4/PETCT_b92d7f441e_03222007.nii.gz,/well/papiez/users/hri611/python/nnUnet_raw/Dataset219_PETCT/labelsTr/PETCT_b92d7f441e_03222007.nii.gz,,0.0,0.0
655,0.8633723377388669,5760,2355,0.7595911716782698,52126245,25640,27995,31400,/well/papiez/users/hri611/python/nnUNet_results/Dataset219_PETCT/nnUNetTrainer_1500epochs_1e2lr__nnUNetPlans__3d_fullres_maxnum_512_patch_192/crossval_results_folds_0_1_2_3_4/PETCT_ba717a1f22_03282003.nii.gz,/well/papiez/users/hri611/python/nnUnet_raw/Dataset219_PETCT/labelsTr/PETCT_ba717a1f22_03282003.nii.gz,0.8633723377388669,0.3981126708984375,7.141146034240722
656,,0,0,,51520000,0,0,0,/well/papiez/users/hri611/python/nnUNet_results/Dataset219_PETCT/nnUNetTrainer_1500epochs_1e2lr__nnUNetPlans__3d_fullres_maxnum_512_patch_192/crossval_results_folds_0_1_2_3_4/PETCT_ba81e4b04b_12022005.nii.gz,/well/papiez/users/hri611/python/nnUnet_raw/Dataset219_PETCT/labelsTr/PETCT_ba81e4b04b_12022005.nii.gz,,0.0,0.0
657,0.8452217364147407,1007,232,0.7319342276070965,52155378,3383,3615,4390,/well/papiez/users/hri611/python/nnUNet_results/Dataset219_PETCT/nnUNetTrainer_1500epochs_1e2lr__nnUNetPlans__3d_fullres_maxnum_512_patch_192/crossval_results_folds_0_1_2_3_4/PETCT_bacc741e2c_01282002.nii.gz,/well/papiez/users/hri611/python/nnUnet_raw/Dataset219_PETCT/labelsTr/PETCT_bacc741e2c_01282002.nii.gz,0.8452217364147407,0.0,6.20806946182251
658,0.3017147818537009,2232,985,0.17765848670756645,52156088,695,1680,2927,/well/papiez/users/hri611/python/nnUNet_results/Dataset219_PETCT/nnUNetTrainer_1500epochs_1e2lr__nnUNetPlans__3d_fullres_maxnum_512_patch_192/crossval_results_folds_0_1_2_3_4/PETCT_bb45bfcffd_01032003.nii.gz,/well/papiez/users/hri611/python/nnUnet_raw/Dataset219_PETCT/labelsTr/PETCT_bb45bfcffd_01032003.nii.gz,0.3017147818537009,0.3981126708984375,26.399846488952637
659,,0,0,,48000000,0,0,0,/well/papiez/users/hri611/python/nnUNet_results/Dataset219_PETCT/nnUNetTrainer_1500epochs_1e2lr__nnUNetPlans__3d_fullres_maxnum_512_patch_192/crossval_results_folds_0_1_2_3_4/PETCT_bb564e29d2_05052006.nii.gz,/well/papiez/users/hri611/python/nnUnet_raw/Dataset219_PETCT/labelsTr/PETCT_bb564e29d2_05052006.nii.gz,,0.0,0.0
660,,0,0,,52160000,0,0,0,/well/papiez/users/hri611/python/nnUNet_results/Dataset219_PETCT/nnUNetTrainer_1500epochs_1e2lr__nnUNetPlans__3d_fullres_maxnum_512_patch_192/crossval_results_folds_0_1_2_3_4/PETCT_bbb2df1e31_01292005.nii.gz,/well/papiez/users/hri611/python/nnUnet_raw/Dataset219_PETCT/labelsTr/PETCT_bbb2df1e31_01292005.nii.gz,,0.0,0.0
661,0.4655619884208425,2988,13074,0.3034087952120739,52136942,6996,20070,9984,/well/papiez/users/hri611/python/nnUNet_results/Dataset219_PETCT/nnUNetTrainer_1500epochs_1e2lr__nnUNetPlans__3d_fullres_maxnum_512_patch_192/crossval_results_folds_0_1_2_3_4/PETCT_bbb83facb4_08232001.nii.gz,/well/papiez/users/hri611/python/nnUnet_raw/Dataset219_PETCT/labelsTr/PETCT_bbb83facb4_08232001.nii.gz,0.4655619884208425,156.74442314529418,0.0
662,0.8515194457565738,0,943,0.7414313134082807,92316353,2704,3647,2704,/well/papiez/users/hri611/python/nnUNet_results/Dataset219_PETCT/nnUNetTrainer_1500epochs_1e2lr__nnUNetPlans__3d_fullres_maxnum_512_patch_192/crossval_results_folds_0_1_2_3_4/PETCT_bc80d06f97_02182002.nii.gz,/well/papiez/users/hri611/python/nnUnet_raw/Dataset219_PETCT/labelsTr/PETCT_bc80d06f97_02182002.nii.gz,0.8515194457565738,2.164737648010254,0.0
663,0.9297768589469899,1861,1264,0.8687691597026834,45416187,20688,21952,22549,/well/papiez/users/hri611/python/nnUNet_results/Dataset219_PETCT/nnUNetTrainer_1500epochs_1e2lr__nnUNetPlans__3d_fullres_maxnum_512_patch_192/crossval_results_folds_0_1_2_3_4/PETCT_bca97006e4_05062001.nii.gz,/well/papiez/users/hri611/python/nnUnet_raw/Dataset219_PETCT/labelsTr/PETCT_bca97006e4_05062001.nii.gz,0.9297768589469899,0.0,0.0
664,0.6424759871931697,580,90,0.47327044025157233,45438728,602,692,1182,/well/papiez/users/hri611/python/nnUNet_results/Dataset219_PETCT/nnUNetTrainer_1500epochs_1e2lr__nnUNetPlans__3d_fullres_maxnum_512_patch_192/crossval_results_folds_0_1_2_3_4/PETCT_bd52fdf529_12032000.nii.gz,/well/papiez/users/hri611/python/nnUnet_raw/Dataset219_PETCT/labelsTr/PETCT_bd52fdf529_12032000.nii.gz,0.6424759871931697,0.0,6.979412761688232
665,0.8422628951747089,11,937,0.7275079045702788,52156521,2531,3468,2542,/well/papiez/users/hri611/python/nnUNet_results/Dataset219_PETCT/nnUNetTrainer_1500epochs_1e2lr__nnUNetPlans__3d_fullres_maxnum_512_patch_192/crossval_results_folds_0_1_2_3_4/PETCT_bd7603e9df_05062005.nii.gz,/well/papiez/users/hri611/python/nnUnet_raw/Dataset219_PETCT/labelsTr/PETCT_bd7603e9df_05062005.nii.gz,0.8422628951747089,0.0,0.0
666,0.0,0,2688,0.0,45437312,0,2688,0,/well/papiez/users/hri611/python/nnUNet_results/Dataset219_PETCT/nnUNetTrainer_1500epochs_1e2lr__nnUNetPlans__3d_fullres_maxnum_512_patch_192/crossval_results_folds_0_1_2_3_4/PETCT_bd76c8d299_10252002.nii.gz,/well/papiez/users/hri611/python/nnUnet_raw/Dataset219_PETCT/labelsTr/PETCT_bd76c8d299_10252002.nii.gz,0.0,33.44146435546875,0.0
667,0.8350456072971676,2240,1196,0.7168054067419435,45427867,8697,9893,10937,/well/papiez/users/hri611/python/nnUNet_results/Dataset219_PETCT/nnUNetTrainer_1500epochs_1e2lr__nnUNetPlans__3d_fullres_maxnum_512_patch_192/crossval_results_folds_0_1_2_3_4/PETCT_bd7c02faa9_05042002.nii.gz,/well/papiez/users/hri611/python/nnUnet_raw/Dataset219_PETCT/labelsTr/PETCT_bd7c02faa9_05042002.nii.gz,0.8350456072971676,0.4478767547607422,3.3839577026367187
668,,0,0,,50400000,0,0,0,/well/papiez/users/hri611/python/nnUNet_results/Dataset219_PETCT/nnUNetTrainer_1500epochs_1e2lr__nnUNetPlans__3d_fullres_maxnum_512_patch_192/crossval_results_folds_0_1_2_3_4/PETCT_be0d3c767e_05292006.nii.gz,/well/papiez/users/hri611/python/nnUnet_raw/Dataset219_PETCT/labelsTr/PETCT_be0d3c767e_05292006.nii.gz,,0.0,0.0
669,0.8578083148946082,991,230,0.7510195758564437,45435096,3683,3913,4674,/well/papiez/users/hri611/python/nnUNet_results/Dataset219_PETCT/nnUNetTrainer_1500epochs_1e2lr__nnUNetPlans__3d_fullres_maxnum_512_patch_192/crossval_results_folds_0_1_2_3_4/PETCT_be3e55a32f_04052001.nii.gz,/well/papiez/users/hri611/python/nnUnet_raw/Dataset219_PETCT/labelsTr/PETCT_be3e55a32f_04052001.nii.gz,0.8578083148946082,0.32346654510498046,0.012441020965576172
670,0.0,0,533,0.0,51679467,0,533,0,/well/papiez/users/hri611/python/nnUNet_results/Dataset219_PETCT/nnUNetTrainer_1500epochs_1e2lr__nnUNetPlans__3d_fullres_maxnum_512_patch_192/crossval_results_folds_0_1_2_3_4/PETCT_bef465b4ad_05042007.nii.gz,/well/papiez/users/hri611/python/nnUnet_raw/Dataset219_PETCT/labelsTr/PETCT_bef465b4ad_05042007.nii.gz,0.0,6.631064174652099,0.0
671,0.32905125117088185,19865,191,0.19692480179386562,45415026,4918,5109,24783,/well/papiez/users/hri611/python/nnUNet_results/Dataset219_PETCT/nnUNetTrainer_1500epochs_1e2lr__nnUNetPlans__3d_fullres_maxnum_512_patch_192/crossval_results_folds_0_1_2_3_4/PETCT_bf178a41b2_06082002.nii.gz,/well/papiez/users/hri611/python/nnUnet_raw/Dataset219_PETCT/labelsTr/PETCT_bf178a41b2_06082002.nii.gz,0.32905125117088185,0.0,65.22827292251587
672,0.8326678218940706,1194,1027,0.713308377436427,45432253,5526,6553,6720,/well/papiez/users/hri611/python/nnUNet_results/Dataset219_PETCT/nnUNetTrainer_1500epochs_1e2lr__nnUNetPlans__3d_fullres_maxnum_512_patch_192/crossval_results_folds_0_1_2_3_4/PETCT_bf7652bccc_11252002.nii.gz,/well/papiez/users/hri611/python/nnUnet_raw/Dataset219_PETCT/labelsTr/PETCT_bf7652bccc_11252002.nii.gz,0.8326678218940706,1.7044198722839354,7.315320327758789
673,0.9045035268583831,182,170,0.8256562654779593,46237981,1667,1837,1849,/well/papiez/users/hri611/python/nnUNet_results/Dataset219_PETCT/nnUNetTrainer_1500epochs_1e2lr__nnUNetPlans__3d_fullres_maxnum_512_patch_192/crossval_results_folds_0_1_2_3_4/PETCT_bfd89440db_02052006.nii.gz,/well/papiez/users/hri611/python/nnUnet_raw/Dataset219_PETCT/labelsTr/PETCT_bfd89440db_02052006.nii.gz,0.9045035268583831,0.23637939834594726,0.5474049224853516
674,,0,0,,47360000,0,0,0,/well/papiez/users/hri611/python/nnUNet_results/Dataset219_PETCT/nnUNetTrainer_1500epochs_1e2lr__nnUNetPlans__3d_fullres_maxnum_512_patch_192/crossval_results_folds_0_1_2_3_4/PETCT_bfd89440db_03112007.nii.gz,/well/papiez/users/hri611/python/nnUnet_raw/Dataset219_PETCT/labelsTr/PETCT_bfd89440db_03112007.nii.gz,,0.0,0.0
675,0.0,0,50,0.0,48159950,0,50,0,/well/papiez/users/hri611/python/nnUNet_results/Dataset219_PETCT/nnUNetTrainer_1500epochs_1e2lr__nnUNetPlans__3d_fullres_maxnum_512_patch_192/crossval_results_folds_0_1_2_3_4/PETCT_c018b45a49_11262006.nii.gz,/well/papiez/users/hri611/python/nnUnet_raw/Dataset219_PETCT/labelsTr/PETCT_c018b45a49_11262006.nii.gz,0.0,0.6220510482788086,0.0
676,0.0,0,125,0.0,52799875,0,125,0,/well/papiez/users/hri611/python/nnUNet_results/Dataset219_PETCT/nnUNetTrainer_1500epochs_1e2lr__nnUNetPlans__3d_fullres_maxnum_512_patch_192/crossval_results_folds_0_1_2_3_4/PETCT_c08293f2b2_07132006.nii.gz,/well/papiez/users/hri611/python/nnUnet_raw/Dataset219_PETCT/labelsTr/PETCT_c08293f2b2_07132006.nii.gz,0.0,1.5551276206970215,0.0
677,,0,0,,50400000,0,0,0,/well/papiez/users/hri611/python/nnUNet_results/Dataset219_PETCT/nnUNetTrainer_1500epochs_1e2lr__nnUNetPlans__3d_fullres_maxnum_512_patch_192/crossval_results_folds_0_1_2_3_4/PETCT_c094a24c03_01292006.nii.gz,/well/papiez/users/hri611/python/nnUnet_raw/Dataset219_PETCT/labelsTr/PETCT_c094a24c03_01292006.nii.gz,,0.0,0.0
678,0.0,0,19,0.0,52159981,0,19,0,/well/papiez/users/hri611/python/nnUNet_results/Dataset219_PETCT/nnUNetTrainer_1500epochs_1e2lr__nnUNetPlans__3d_fullres_maxnum_512_patch_192/crossval_results_folds_0_1_2_3_4/PETCT_c094a24c03_03042007.nii.gz,/well/papiez/users/hri611/python/nnUnet_raw/Dataset219_PETCT/labelsTr/PETCT_c094a24c03_03042007.nii.gz,0.0,0.23637939834594726,0.0
679,0.0,0,504,0.0,52159496,0,504,0,/well/papiez/users/hri611/python/nnUNet_results/Dataset219_PETCT/nnUNetTrainer_1500epochs_1e2lr__nnUNetPlans__3d_fullres_maxnum_512_patch_192/crossval_results_folds_0_1_2_3_4/PETCT_c10f48b173_11272004.nii.gz,/well/papiez/users/hri611/python/nnUnet_raw/Dataset219_PETCT/labelsTr/PETCT_c10f48b173_11272004.nii.gz,0.0,6.27027456665039,0.0
680,0.7675411836485662,183,198,0.6227722772277228,45438990,629,827,812,/well/papiez/users/hri611/python/nnUNet_results/Dataset219_PETCT/nnUNetTrainer_1500epochs_1e2lr__nnUNetPlans__3d_fullres_maxnum_512_patch_192/crossval_results_folds_0_1_2_3_4/PETCT_c16c13211c_10262003.nii.gz,/well/papiez/users/hri611/python/nnUnet_raw/Dataset219_PETCT/labelsTr/PETCT_c16c13211c_10262003.nii.gz,0.7675411836485662,0.012441020965576172,0.6096100273132324
681,0.9084119654687813,536,1745,0.8321930405355698,72146407,11312,13057,11848,/well/papiez/users/hri611/python/nnUNet_results/Dataset219_PETCT/nnUNetTrainer_1500epochs_1e2lr__nnUNetPlans__3d_fullres_maxnum_512_patch_192/crossval_results_folds_0_1_2_3_4/PETCT_c16d325d12_02152003.nii.gz,/well/papiez/users/hri611/python/nnUnet_raw/Dataset219_PETCT/labelsTr/PETCT_c16d325d12_02152003.nii.gz,0.9084119654687813,0.24882041931152343,0.024882041931152343
682,,0,0,,51040000,0,0,0,/well/papiez/users/hri611/python/nnUNet_results/Dataset219_PETCT/nnUNetTrainer_1500epochs_1e2lr__nnUNetPlans__3d_fullres_maxnum_512_patch_192/crossval_results_folds_0_1_2_3_4/PETCT_c1c9e78e0e_05142007.nii.gz,/well/papiez/users/hri611/python/nnUnet_raw/Dataset219_PETCT/labelsTr/PETCT_c1c9e78e0e_05142007.nii.gz,,0.0,0.0
683,,0,0,,45440000,0,0,0,/well/papiez/users/hri611/python/nnUNet_results/Dataset219_PETCT/nnUNetTrainer_1500epochs_1e2lr__nnUNetPlans__3d_fullres_maxnum_512_patch_192/crossval_results_folds_0_1_2_3_4/PETCT_c227131152_10262003.nii.gz,/well/papiez/users/hri611/python/nnUnet_raw/Dataset219_PETCT/labelsTr/PETCT_c227131152_10262003.nii.gz,,0.0,0.0
684,0.9183673469387755,5,587,0.8490566037735849,92316078,3330,3917,3335,/well/papiez/users/hri611/python/nnUNet_results/Dataset219_PETCT/nnUNetTrainer_1500epochs_1e2lr__nnUNetPlans__3d_fullres_maxnum_512_patch_192/crossval_results_folds_0_1_2_3_4/PETCT_c252d734a0_08092003.nii.gz,/well/papiez/users/hri611/python/nnUnet_raw/Dataset219_PETCT/labelsTr/PETCT_c252d734a0_08092003.nii.gz,0.9183673469387755,0.6469330902099609,0.0
685,0.720954356846473,10851,447,0.5636658556366586,52134107,14595,15042,25446,/well/papiez/users/hri611/python/nnUNet_results/Dataset219_PETCT/nnUNetTrainer_1500epochs_1e2lr__nnUNetPlans__3d_fullres_maxnum_512_patch_192/crossval_results_folds_0_1_2_3_4/PETCT_c29aba73da_08232002.nii.gz,/well/papiez/users/hri611/python/nnUnet_raw/Dataset219_PETCT/labelsTr/PETCT_c29aba73da_08232002.nii.gz,0.720954356846473,0.0,4.553413673400879
686,0.8697084299133829,4805,1603,0.7694549379384782,52132205,21387,22990,26192,/well/papiez/users/hri611/python/nnUNet_results/Dataset219_PETCT/nnUNetTrainer_1500epochs_1e2lr__nnUNetPlans__3d_fullres_maxnum_512_patch_192/crossval_results_folds_0_1_2_3_4/PETCT_c2a51a65c6_09152002.nii.gz,/well/papiez/users/hri611/python/nnUnet_raw/Dataset219_PETCT/labelsTr/PETCT_c2a51a65c6_09152002.nii.gz,0.8697084299133829,0.0,0.024882041931152343
687,0.0,0,209,0.0,72159791,0,209,0,/well/papiez/users/hri611/python/nnUNet_results/Dataset219_PETCT/nnUNetTrainer_1500epochs_1e2lr__nnUNetPlans__3d_fullres_maxnum_512_patch_192/crossval_results_folds_0_1_2_3_4/PETCT_c2b776974a_05092005.nii.gz,/well/papiez/users/hri611/python/nnUnet_raw/Dataset219_PETCT/labelsTr/PETCT_c2b776974a_05092005.nii.gz,0.0,2.60017338180542,0.0
688,,0,0,,38720000,0,0,0,/well/papiez/users/hri611/python/nnUNet_results/Dataset219_PETCT/nnUNetTrainer_1500epochs_1e2lr__nnUNetPlans__3d_fullres_maxnum_512_patch_192/crossval_results_folds_0_1_2_3_4/PETCT_c2ffda4725_04112003.nii.gz,/well/papiez/users/hri611/python/nnUnet_raw/Dataset219_PETCT/labelsTr/PETCT_c2ffda4725_04112003.nii.gz,,0.0,0.0
689,,0,0,,38720000,0,0,0,/well/papiez/users/hri611/python/nnUNet_results/Dataset219_PETCT/nnUNetTrainer_1500epochs_1e2lr__nnUNetPlans__3d_fullres_maxnum_512_patch_192/crossval_results_folds_0_1_2_3_4/PETCT_c2ffda4725_09192003.nii.gz,/well/papiez/users/hri611/python/nnUnet_raw/Dataset219_PETCT/labelsTr/PETCT_c2ffda4725_09192003.nii.gz,,0.0,0.0
690,0.0,0,431,0.0,65439569,0,431,0,/well/papiez/users/hri611/python/nnUNet_results/Dataset219_PETCT/nnUNetTrainer_1500epochs_1e2lr__nnUNetPlans__3d_fullres_maxnum_512_patch_192/crossval_results_folds_0_1_2_3_4/PETCT_c32e1daf9b_02022003.nii.gz,/well/papiez/users/hri611/python/nnUnet_raw/Dataset219_PETCT/labelsTr/PETCT_c32e1daf9b_02022003.nii.gz,0.0,5.36208003616333,0.0
691,0.0,0,20,0.0,41759980,0,20,0,/well/papiez/users/hri611/python/nnUNet_results/Dataset219_PETCT/nnUNetTrainer_1500epochs_1e2lr__nnUNetPlans__3d_fullres_maxnum_512_patch_192/crossval_results_folds_0_1_2_3_4/PETCT_c38b168f1a_04152006.nii.gz,/well/papiez/users/hri611/python/nnUnet_raw/Dataset219_PETCT/labelsTr/PETCT_c38b168f1a_04152006.nii.gz,0.0,0.24882041931152343,0.0
692,0.0,0,43,0.0,58879957,0,43,0,/well/papiez/users/hri611/python/nnUNet_results/Dataset219_PETCT/nnUNetTrainer_1500epochs_1e2lr__nnUNetPlans__3d_fullres_maxnum_512_patch_192/crossval_results_folds_0_1_2_3_4/PETCT_c395306306_08242002.nii.gz,/well/papiez/users/hri611/python/nnUnet_raw/Dataset219_PETCT/labelsTr/PETCT_c395306306_08242002.nii.gz,0.0,0.5349639015197754,0.0
693,0.8312926644273486,222,1335,0.7112924160949379,51194607,3836,5171,4058,/well/papiez/users/hri611/python/nnUNet_results/Dataset219_PETCT/nnUNetTrainer_1500epochs_1e2lr__nnUNetPlans__3d_fullres_maxnum_512_patch_192/crossval_results_folds_0_1_2_3_4/PETCT_c3cc732d95_07212005.nii.gz,/well/papiez/users/hri611/python/nnUnet_raw/Dataset219_PETCT/labelsTr/PETCT_c3cc732d95_07212005.nii.gz,0.8312926644273486,0.0,0.3359075660705566
694,0.7994588195501438,3667,2262,0.6659153659773482,52142253,11818,14080,15485,/well/papiez/users/hri611/python/nnUNet_results/Dataset219_PETCT/nnUNetTrainer_1500epochs_1e2lr__nnUNetPlans__3d_fullres_maxnum_512_patch_192/crossval_results_folds_0_1_2_3_4/PETCT_c4a686881e_04231999.nii.gz,/well/papiez/users/hri611/python/nnUnet_raw/Dataset219_PETCT/labelsTr/PETCT_c4a686881e_04231999.nii.gz,0.7994588195501438,0.4105536918640137,11.532826435089111
695,0.9089557304714648,3513,2120,0.8331061863000712,52126248,28119,30239,31632,/well/papiez/users/hri611/python/nnUNet_results/Dataset219_PETCT/nnUNetTrainer_1500epochs_1e2lr__nnUNetPlans__3d_fullres_maxnum_512_patch_192/crossval_results_folds_0_1_2_3_4/PETCT_c517c47bed_02062003.nii.gz,/well/papiez/users/hri611/python/nnUnet_raw/Dataset219_PETCT/labelsTr/PETCT_c517c47bed_02062003.nii.gz,0.9089557304714648,0.9703996353149413,0.9703996353149413
696,0.28308823529411764,1946,4,0.16488222698072805,45437665,385,389,2331,/well/papiez/users/hri611/python/nnUNet_results/Dataset219_PETCT/nnUNetTrainer_1500epochs_1e2lr__nnUNetPlans__3d_fullres_maxnum_512_patch_192/crossval_results_folds_0_1_2_3_4/PETCT_c58477f3b4_12072002.nii.gz,/well/papiez/users/hri611/python/nnUnet_raw/Dataset219_PETCT/labelsTr/PETCT_c58477f3b4_12072002.nii.gz,0.28308823529411764,0.0,20.017602733612062
697,0.0,0,1058,0.0,65438942,0,1058,0,/well/papiez/users/hri611/python/nnUNet_results/Dataset219_PETCT/nnUNetTrainer_1500epochs_1e2lr__nnUNetPlans__3d_fullres_maxnum_512_patch_192/crossval_results_folds_0_1_2_3_4/PETCT_c596a50286_05162003.nii.gz,/well/papiez/users/hri611/python/nnUnet_raw/Dataset219_PETCT/labelsTr/PETCT_c596a50286_05162003.nii.gz,0.0,13.16260018157959,0.0
698,,0,0,,43680000,0,0,0,/well/papiez/users/hri611/python/nnUNet_results/Dataset219_PETCT/nnUNetTrainer_1500epochs_1e2lr__nnUNetPlans__3d_fullres_maxnum_512_patch_192/crossval_results_folds_0_1_2_3_4/PETCT_c5a143a604_08122006.nii.gz,/well/papiez/users/hri611/python/nnUnet_raw/Dataset219_PETCT/labelsTr/PETCT_c5a143a604_08122006.nii.gz,,0.0,0.0
699,,0,0,,42880000,0,0,0,/well/papiez/users/hri611/python/nnUNet_results/Dataset219_PETCT/nnUNetTrainer_1500epochs_1e2lr__nnUNetPlans__3d_fullres_maxnum_512_patch_192/crossval_results_folds_0_1_2_3_4/PETCT_c6730783de_01052006.nii.gz,/well/papiez/users/hri611/python/nnUnet_raw/Dataset219_PETCT/labelsTr/PETCT_c6730783de_01052006.nii.gz,,0.0,0.0
700,0.6143966125617502,4583,881,0.4434144850769074,52150183,4353,5234,8936,/well/papiez/users/hri611/python/nnUNet_results/Dataset219_PETCT/nnUNetTrainer_1500epochs_1e2lr__nnUNetPlans__3d_fullres_maxnum_512_patch_192/crossval_results_folds_0_1_2_3_4/PETCT_c73c2685c0_02012001.nii.gz,/well/papiez/users/hri611/python/nnUnet_raw/Dataset219_PETCT/labelsTr/PETCT_c73c2685c0_02012001.nii.gz,0.6143966125617502,0.435435733795166,52.37669826507568
701,0.0,0,45,0.0,45439955,0,45,0,/well/papiez/users/hri611/python/nnUNet_results/Dataset219_PETCT/nnUNetTrainer_1500epochs_1e2lr__nnUNetPlans__3d_fullres_maxnum_512_patch_192/crossval_results_folds_0_1_2_3_4/PETCT_c787334539_01052003.nii.gz,/well/papiez/users/hri611/python/nnUnet_raw/Dataset219_PETCT/labelsTr/PETCT_c787334539_01052003.nii.gz,0.0,0.5598459434509278,0.0
702,0.9121528621164278,857,228,0.8384935992855016,45433282,5633,5861,6490,/well/papiez/users/hri611/python/nnUNet_results/Dataset219_PETCT/nnUNetTrainer_1500epochs_1e2lr__nnUNetPlans__3d_fullres_maxnum_512_patch_192/crossval_results_folds_0_1_2_3_4/PETCT_c799ccc2f6_08262002.nii.gz,/well/papiez/users/hri611/python/nnUnet_raw/Dataset219_PETCT/labelsTr/PETCT_c799ccc2f6_08262002.nii.gz,0.9121528621164278,0.14929225158691406,0.0
703,0.0,0,64,0.0,45439936,0,64,0,/well/papiez/users/hri611/python/nnUNet_results/Dataset219_PETCT/nnUNetTrainer_1500epochs_1e2lr__nnUNetPlans__3d_fullres_maxnum_512_patch_192/crossval_results_folds_0_1_2_3_4/PETCT_c7fd7e3e30_11132003.nii.gz,/well/papiez/users/hri611/python/nnUnet_raw/Dataset219_PETCT/labelsTr/PETCT_c7fd7e3e30_11132003.nii.gz,0.0,0.796225341796875,0.0
704,0.0,0,62,0.0,52159938,0,62,0,/well/papiez/users/hri611/python/nnUNet_results/Dataset219_PETCT/nnUNetTrainer_1500epochs_1e2lr__nnUNetPlans__3d_fullres_maxnum_512_patch_192/crossval_results_folds_0_1_2_3_4/PETCT_c852dfc0a5_07262002.nii.gz,/well/papiez/users/hri611/python/nnUnet_raw/Dataset219_PETCT/labelsTr/PETCT_c852dfc0a5_07262002.nii.gz,0.0,0.7713432998657226,0.0
705,0.861038961038961,369,59,0.7559863169897377,52158246,1326,1385,1695,/well/papiez/users/hri611/python/nnUNet_results/Dataset219_PETCT/nnUNetTrainer_1500epochs_1e2lr__nnUNetPlans__3d_fullres_maxnum_512_patch_192/crossval_results_folds_0_1_2_3_4/PETCT_c898e2abcb_12102004.nii.gz,/well/papiez/users/hri611/python/nnUnet_raw/Dataset219_PETCT/labelsTr/PETCT_c898e2abcb_12102004.nii.gz,0.861038961038961,0.4603177757263184,0.14929225158691406
706,,0,0,,52160000,0,0,0,/well/papiez/users/hri611/python/nnUNet_results/Dataset219_PETCT/nnUNetTrainer_1500epochs_1e2lr__nnUNetPlans__3d_fullres_maxnum_512_patch_192/crossval_results_folds_0_1_2_3_4/PETCT_c9f1b9980f_09152003.nii.gz,/well/papiez/users/hri611/python/nnUnet_raw/Dataset219_PETCT/labelsTr/PETCT_c9f1b9980f_09152003.nii.gz,,0.0,0.0
707,0.0,0,34,0.0,45439966,0,34,0,/well/papiez/users/hri611/python/nnUNet_results/Dataset219_PETCT/nnUNetTrainer_1500epochs_1e2lr__nnUNetPlans__3d_fullres_maxnum_512_patch_192/crossval_results_folds_0_1_2_3_4/PETCT_ca16242e89_09132002.nii.gz,/well/papiez/users/hri611/python/nnUnet_raw/Dataset219_PETCT/labelsTr/PETCT_ca16242e89_09132002.nii.gz,0.0,0.42299471282958984,0.0
708,,0,0,,45440000,0,0,0,/well/papiez/users/hri611/python/nnUNet_results/Dataset219_PETCT/nnUNetTrainer_1500epochs_1e2lr__nnUNetPlans__3d_fullres_maxnum_512_patch_192/crossval_results_folds_0_1_2_3_4/PETCT_ca16242e89_09182003.nii.gz,/well/papiez/users/hri611/python/nnUnet_raw/Dataset219_PETCT/labelsTr/PETCT_ca16242e89_09182003.nii.gz,,0.0,0.0
709,0.0,0,2659,0.0,45437341,0,2659,0,/well/papiez/users/hri611/python/nnUNet_results/Dataset219_PETCT/nnUNetTrainer_1500epochs_1e2lr__nnUNetPlans__3d_fullres_maxnum_512_patch_192/crossval_results_folds_0_1_2_3_4/PETCT_ca29501275_11042004.nii.gz,/well/papiez/users/hri611/python/nnUnet_raw/Dataset219_PETCT/labelsTr/PETCT_ca29501275_11042004.nii.gz,0.0,33.08067474746704,0.0
710,0.9011160134959771,2259,1551,0.8200283419933869,52138830,17360,18911,19619,/well/papiez/users/hri611/python/nnUNet_results/Dataset219_PETCT/nnUNetTrainer_1500epochs_1e2lr__nnUNetPlans__3d_fullres_maxnum_512_patch_192/crossval_results_folds_0_1_2_3_4/PETCT_ca47fe5e7d_09012003.nii.gz,/well/papiez/users/hri611/python/nnUnet_raw/Dataset219_PETCT/labelsTr/PETCT_ca47fe5e7d_09012003.nii.gz,0.9011160134959771,12.776928531646728,0.9081945304870606
711,,0,0,,38720000,0,0,0,/well/papiez/users/hri611/python/nnUNet_results/Dataset219_PETCT/nnUNetTrainer_1500epochs_1e2lr__nnUNetPlans__3d_fullres_maxnum_512_patch_192/crossval_results_folds_0_1_2_3_4/PETCT_ca5406d339_12092004.nii.gz,/well/papiez/users/hri611/python/nnUnet_raw/Dataset219_PETCT/labelsTr/PETCT_ca5406d339_12092004.nii.gz,,0.0,0.0
712,0.600985030184528,101642,1005,0.42957726911513816,51980051,77302,78307,178944,/well/papiez/users/hri611/python/nnUNet_results/Dataset219_PETCT/nnUNetTrainer_1500epochs_1e2lr__nnUNetPlans__3d_fullres_maxnum_512_patch_192/crossval_results_folds_0_1_2_3_4/PETCT_ca58410fad_05232003.nii.gz,/well/papiez/users/hri611/python/nnUnet_raw/Dataset219_PETCT/labelsTr/PETCT_ca58410fad_05232003.nii.gz,0.600985030184528,0.04976408386230469,51.12015514755249
713,0.0,0,12613,0.0,52147387,0,12613,0,/well/papiez/users/hri611/python/nnUNet_results/Dataset219_PETCT/nnUNetTrainer_1500epochs_1e2lr__nnUNetPlans__3d_fullres_maxnum_512_patch_192/crossval_results_folds_0_1_2_3_4/PETCT_ca62984a81_08072003.nii.gz,/well/papiez/users/hri611/python/nnUnet_raw/Dataset219_PETCT/labelsTr/PETCT_ca62984a81_08072003.nii.gz,0.0,156.91859743881224,0.0
714,0.0,0,158,0.0,52159842,0,158,0,/well/papiez/users/hri611/python/nnUNet_results/Dataset219_PETCT/nnUNetTrainer_1500epochs_1e2lr__nnUNetPlans__3d_fullres_maxnum_512_patch_192/crossval_results_folds_0_1_2_3_4/PETCT_ca9570a0eb_09282002.nii.gz,/well/papiez/users/hri611/python/nnUnet_raw/Dataset219_PETCT/labelsTr/PETCT_ca9570a0eb_09282002.nii.gz,0.0,1.965681312561035,0.0
715,0.864926419060967,1246,1838,0.7620003086896125,85587042,9874,11712,11120,/well/papiez/users/hri611/python/nnUNet_results/Dataset219_PETCT/nnUNetTrainer_1500epochs_1e2lr__nnUNetPlans__3d_fullres_maxnum_512_patch_192/crossval_results_folds_0_1_2_3_4/PETCT_caae8d63f0_01262004.nii.gz,/well/papiez/users/hri611/python/nnUnet_raw/Dataset219_PETCT/labelsTr/PETCT_caae8d63f0_01262004.nii.gz,0.864926419060967,17.19349097442627,0.0
716,0.6889352818371608,0,149,0.5254777070063694,101439686,165,314,165,/well/papiez/users/hri611/python/nnUNet_results/Dataset219_PETCT/nnUNetTrainer_1500epochs_1e2lr__nnUNetPlans__3d_fullres_maxnum_512_patch_192/crossval_results_folds_0_1_2_3_4/PETCT_cab58c1fee_03192007.nii.gz,/well/papiez/users/hri611/python/nnUnet_raw/Dataset219_PETCT/labelsTr/PETCT_cab58c1fee_03192007.nii.gz,0.6889352818371608,0.9206355514526368,0.0
717,0.26138123257974605,4417,353,0.1503384396152476,45434386,844,1197,5261,/well/papiez/users/hri611/python/nnUNet_results/Dataset219_PETCT/nnUNetTrainer_1500epochs_1e2lr__nnUNetPlans__3d_fullres_maxnum_512_patch_192/crossval_results_folds_0_1_2_3_4/PETCT_cb1f5e74ab_06142001.nii.gz,/well/papiez/users/hri611/python/nnUnet_raw/Dataset219_PETCT/labelsTr/PETCT_cb1f5e74ab_06142001.nii.gz,0.26138123257974605,3.3839577026367187,52.998749313354494
718,,0,0,,91040000,0,0,0,/well/papiez/users/hri611/python/nnUNet_results/Dataset219_PETCT/nnUNetTrainer_1500epochs_1e2lr__nnUNetPlans__3d_fullres_maxnum_512_patch_192/crossval_results_folds_0_1_2_3_4/PETCT_cb240e6f0f_04192007.nii.gz,/well/papiez/users/hri611/python/nnUnet_raw/Dataset219_PETCT/labelsTr/PETCT_cb240e6f0f_04192007.nii.gz,,0.0,0.0
719,0.8165743340669348,7170,2498,0.690008977811979,48128812,21520,24018,28690,/well/papiez/users/hri611/python/nnUNet_results/Dataset219_PETCT/nnUNetTrainer_1500epochs_1e2lr__nnUNetPlans__3d_fullres_maxnum_512_patch_192/crossval_results_folds_0_1_2_3_4/PETCT_cbbc9e2879_01162006.nii.gz,/well/papiez/users/hri611/python/nnUnet_raw/Dataset219_PETCT/labelsTr/PETCT_cbbc9e2879_01162006.nii.gz,0.8165743340669348,0.8584304466247559,1.3560712852478027
720,,0,0,,47200000,0,0,0,/well/papiez/users/hri611/python/nnUNet_results/Dataset219_PETCT/nnUNetTrainer_1500epochs_1e2lr__nnUNetPlans__3d_fullres_maxnum_512_patch_192/crossval_results_folds_0_1_2_3_4/PETCT_cbbc9e2879_03312006.nii.gz,/well/papiez/users/hri611/python/nnUnet_raw/Dataset219_PETCT/labelsTr/PETCT_cbbc9e2879_03312006.nii.gz,,0.0,0.0
721,,0,0,,46880000,0,0,0,/well/papiez/users/hri611/python/nnUNet_results/Dataset219_PETCT/nnUNetTrainer_1500epochs_1e2lr__nnUNetPlans__3d_fullres_maxnum_512_patch_192/crossval_results_folds_0_1_2_3_4/PETCT_cbbc9e2879_06282007.nii.gz,/well/papiez/users/hri611/python/nnUnet_raw/Dataset219_PETCT/labelsTr/PETCT_cbbc9e2879_06282007.nii.gz,,0.0,0.0
722,0.0,0,29,0.0,46239971,0,29,0,/well/papiez/users/hri611/python/nnUNet_results/Dataset219_PETCT/nnUNetTrainer_1500epochs_1e2lr__nnUNetPlans__3d_fullres_maxnum_512_patch_192/crossval_results_folds_0_1_2_3_4/PETCT_cbbc9e2879_08062006.nii.gz,/well/papiez/users/hri611/python/nnUnet_raw/Dataset219_PETCT/labelsTr/PETCT_cbbc9e2879_08062006.nii.gz,0.0,0.360789608001709,0.0
723,0.0,0,2516,0.0,45437484,0,2516,0,/well/papiez/users/hri611/python/nnUNet_results/Dataset219_PETCT/nnUNetTrainer_1500epochs_1e2lr__nnUNetPlans__3d_fullres_maxnum_512_patch_192/crossval_results_folds_0_1_2_3_4/PETCT_cc1698663a_10152004.nii.gz,/well/papiez/users/hri611/python/nnUnet_raw/Dataset219_PETCT/labelsTr/PETCT_cc1698663a_10152004.nii.gz,0.0,31.301608749389647,0.0
724,0.0,0,571,0.0,45439429,0,571,0,/well/papiez/users/hri611/python/nnUNet_results/Dataset219_PETCT/nnUNetTrainer_1500epochs_1e2lr__nnUNetPlans__3d_fullres_maxnum_512_patch_192/crossval_results_folds_0_1_2_3_4/PETCT_cc7cb73213_12182004.nii.gz,/well/papiez/users/hri611/python/nnUnet_raw/Dataset219_PETCT/labelsTr/PETCT_cc7cb73213_12182004.nii.gz,0.0,7.103822971343994,0.0
725,0.0,0,130,0.0,44159870,0,130,0,/well/papiez/users/hri611/python/nnUNet_results/Dataset219_PETCT/nnUNetTrainer_1500epochs_1e2lr__nnUNetPlans__3d_fullres_maxnum_512_patch_192/crossval_results_folds_0_1_2_3_4/PETCT_ccb9c375b2_10012005.nii.gz,/well/papiez/users/hri611/python/nnUnet_raw/Dataset219_PETCT/labelsTr/PETCT_ccb9c375b2_10012005.nii.gz,0.0,1.6173327255249024,0.0
726,0.0,0,3965,0.0,50876035,0,3965,0,/well/papiez/users/hri611/python/nnUNet_results/Dataset219_PETCT/nnUNetTrainer_1500epochs_1e2lr__nnUNetPlans__3d_fullres_maxnum_512_patch_192/crossval_results_folds_0_1_2_3_4/PETCT_ccd8f5ff71_10292006.nii.gz,/well/papiez/users/hri611/python/nnUnet_raw/Dataset219_PETCT/labelsTr/PETCT_ccd8f5ff71_10292006.nii.gz,0.0,49.32864812850952,0.0
727,0.8793855662606799,1,2653,0.7847351772244302,52147671,9675,12328,9676,/well/papiez/users/hri611/python/nnUNet_results/Dataset219_PETCT/nnUNetTrainer_1500epochs_1e2lr__nnUNetPlans__3d_fullres_maxnum_512_patch_192/crossval_results_folds_0_1_2_3_4/PETCT_cd2ef932b5_04272003.nii.gz,/well/papiez/users/hri611/python/nnUnet_raw/Dataset219_PETCT/labelsTr/PETCT_cd2ef932b5_04272003.nii.gz,0.8793855662606799,3.334193618774414,0.012441020965576172
728,,0,0,,52160000,0,0,0,/well/papiez/users/hri611/python/nnUNet_results/Dataset219_PETCT/nnUNetTrainer_1500epochs_1e2lr__nnUNetPlans__3d_fullres_maxnum_512_patch_192/crossval_results_folds_0_1_2_3_4/PETCT_cd50f3fec4_12012002.nii.gz,/well/papiez/users/hri611/python/nnUnet_raw/Dataset219_PETCT/labelsTr/PETCT_cd50f3fec4_12012002.nii.gz,,0.0,0.0
729,,0,0,,54400000,0,0,0,/well/papiez/users/hri611/python/nnUNet_results/Dataset219_PETCT/nnUNetTrainer_1500epochs_1e2lr__nnUNetPlans__3d_fullres_maxnum_512_patch_192/crossval_results_folds_0_1_2_3_4/PETCT_cd9bdca46b_10052006.nii.gz,/well/papiez/users/hri611/python/nnUnet_raw/Dataset219_PETCT/labelsTr/PETCT_cd9bdca46b_10052006.nii.gz,,0.0,0.0
730,0.8694869486948695,103,1347,0.7691082802547771,92313720,4830,6177,4933,/well/papiez/users/hri611/python/nnUNet_results/Dataset219_PETCT/nnUNetTrainer_1500epochs_1e2lr__nnUNetPlans__3d_fullres_maxnum_512_patch_192/crossval_results_folds_0_1_2_3_4/PETCT_cdd237e9b3_04162005.nii.gz,/well/papiez/users/hri611/python/nnUnet_raw/Dataset219_PETCT/labelsTr/PETCT_cdd237e9b3_04162005.nii.gz,0.8694869486948695,0.0,0.07464612579345703
731,,0,0,,52160000,0,0,0,/well/papiez/users/hri611/python/nnUNet_results/Dataset219_PETCT/nnUNetTrainer_1500epochs_1e2lr__nnUNetPlans__3d_fullres_maxnum_512_patch_192/crossval_results_folds_0_1_2_3_4/PETCT_ce0ffef966_05112003.nii.gz,/well/papiez/users/hri611/python/nnUnet_raw/Dataset219_PETCT/labelsTr/PETCT_ce0ffef966_05112003.nii.gz,,0.0,0.0
732,0.820831342570473,2158,1592,0.6961102106969206,72147660,8590,10182,10748,/well/papiez/users/hri611/python/nnUNet_results/Dataset219_PETCT/nnUNetTrainer_1500epochs_1e2lr__nnUNetPlans__3d_fullres_maxnum_512_patch_192/crossval_results_folds_0_1_2_3_4/PETCT_cf20ad1656_02182005.nii.gz,/well/papiez/users/hri611/python/nnUnet_raw/Dataset219_PETCT/labelsTr/PETCT_cf20ad1656_02182005.nii.gz,0.820831342570473,0.07464612579345703,4.055772834777832
733,0.0,0,40,0.0,89759960,0,40,0,/well/papiez/users/hri611/python/nnUNet_results/Dataset219_PETCT/nnUNetTrainer_1500epochs_1e2lr__nnUNetPlans__3d_fullres_maxnum_512_patch_192/crossval_results_folds_0_1_2_3_4/PETCT_cf3725edf0_10072005.nii.gz,/well/papiez/users/hri611/python/nnUnet_raw/Dataset219_PETCT/labelsTr/PETCT_cf3725edf0_10072005.nii.gz,0.0,0.49764083862304687,0.0
734,,0,0,,38720000,0,0,0,/well/papiez/users/hri611/python/nnUNet_results/Dataset219_PETCT/nnUNetTrainer_1500epochs_1e2lr__nnUNetPlans__3d_fullres_maxnum_512_patch_192/crossval_results_folds_0_1_2_3_4/PETCT_d0086487f4_04102003.nii.gz,/well/papiez/users/hri611/python/nnUnet_raw/Dataset219_PETCT/labelsTr/PETCT_d0086487f4_04102003.nii.gz,,0.0,0.0
735,0.0,0,24,0.0,45439976,0,24,0,/well/papiez/users/hri611/python/nnUNet_results/Dataset219_PETCT/nnUNetTrainer_1500epochs_1e2lr__nnUNetPlans__3d_fullres_maxnum_512_patch_192/crossval_results_folds_0_1_2_3_4/PETCT_d098458d29_08012003.nii.gz,/well/papiez/users/hri611/python/nnUnet_raw/Dataset219_PETCT/labelsTr/PETCT_d098458d29_08012003.nii.gz,0.0,0.2985845031738281,0.0
736,0.0,0,68,0.0,58879932,0,68,0,/well/papiez/users/hri611/python/nnUNet_results/Dataset219_PETCT/nnUNetTrainer_1500epochs_1e2lr__nnUNetPlans__3d_fullres_maxnum_512_patch_192/crossval_results_folds_0_1_2_3_4/PETCT_d0ea6c975f_10112002.nii.gz,/well/papiez/users/hri611/python/nnUnet_raw/Dataset219_PETCT/labelsTr/PETCT_d0ea6c975f_10112002.nii.gz,0.0,0.8459894256591797,0.0
737,0.0,0,715,0.0,52159285,0,715,0,/well/papiez/users/hri611/python/nnUNet_results/Dataset219_PETCT/nnUNetTrainer_1500epochs_1e2lr__nnUNetPlans__3d_fullres_maxnum_512_patch_192/crossval_results_folds_0_1_2_3_4/PETCT_d103e57f0e_12122002.nii.gz,/well/papiez/users/hri611/python/nnUnet_raw/Dataset219_PETCT/labelsTr/PETCT_d103e57f0e_12122002.nii.gz,0.0,8.895329990386962,0.0
738,0.11526339486717695,3930,0,0.061156235069278544,52155814,256,256,4186,/well/papiez/users/hri611/python/nnUNet_results/Dataset219_PETCT/nnUNetTrainer_1500epochs_1e2lr__nnUNetPlans__3d_fullres_maxnum_512_patch_192/crossval_results_folds_0_1_2_3_4/PETCT_d1c8141930_06142002.nii.gz,/well/papiez/users/hri611/python/nnUnet_raw/Dataset219_PETCT/labelsTr/PETCT_d1c8141930_06142002.nii.gz,0.11526339486717695,0.0,43.00860947799683
739,,0,0,,49920000,0,0,0,/well/papiez/users/hri611/python/nnUNet_results/Dataset219_PETCT/nnUNetTrainer_1500epochs_1e2lr__nnUNetPlans__3d_fullres_maxnum_512_patch_192/crossval_results_folds_0_1_2_3_4/PETCT_d1f456d229_09012006.nii.gz,/well/papiez/users/hri611/python/nnUnet_raw/Dataset219_PETCT/labelsTr/PETCT_d1f456d229_09012006.nii.gz,,0.0,0.0
740,0.6075962069138527,8230,23054,0.43636494667051023,46664496,24220,47274,32450,/well/papiez/users/hri611/python/nnUNet_results/Dataset219_PETCT/nnUNetTrainer_1500epochs_1e2lr__nnUNetPlans__3d_fullres_maxnum_512_patch_192/crossval_results_folds_0_1_2_3_4/PETCT_d206b891ee_10272005.nii.gz,/well/papiez/users/hri611/python/nnUnet_raw/Dataset219_PETCT/labelsTr/PETCT_d206b891ee_10272005.nii.gz,0.6075962069138527,168.3270136642456,85.13390646743774
741,,0,0,,92320000,0,0,0,/well/papiez/users/hri611/python/nnUNet_results/Dataset219_PETCT/nnUNetTrainer_1500epochs_1e2lr__nnUNetPlans__3d_fullres_maxnum_512_patch_192/crossval_results_folds_0_1_2_3_4/PETCT_d27451634d_03122005.nii.gz,/well/papiez/users/hri611/python/nnUnet_raw/Dataset219_PETCT/labelsTr/PETCT_d27451634d_03122005.nii.gz,,0.0,0.0
742,,0,0,,52160000,0,0,0,/well/papiez/users/hri611/python/nnUNet_results/Dataset219_PETCT/nnUNetTrainer_1500epochs_1e2lr__nnUNetPlans__3d_fullres_maxnum_512_patch_192/crossval_results_folds_0_1_2_3_4/PETCT_d31a5688a2_09212003.nii.gz,/well/papiez/users/hri611/python/nnUnet_raw/Dataset219_PETCT/labelsTr/PETCT_d31a5688a2_09212003.nii.gz,,0.0,0.0
743,0.8230889403652427,656,19048,0.6993637570375796,52094459,45837,64885,46493,/well/papiez/users/hri611/python/nnUNet_results/Dataset219_PETCT/nnUNetTrainer_1500epochs_1e2lr__nnUNetPlans__3d_fullres_maxnum_512_patch_192/crossval_results_folds_0_1_2_3_4/PETCT_d31c9ebd93_07212003.nii.gz,/well/papiez/users/hri611/python/nnUnet_raw/Dataset219_PETCT/labelsTr/PETCT_d31c9ebd93_07212003.nii.gz,0.8230889403652427,0.0,0.32346654510498046
744,,0,0,,45440000,0,0,0,/well/papiez/users/hri611/python/nnUNet_results/Dataset219_PETCT/nnUNetTrainer_1500epochs_1e2lr__nnUNetPlans__3d_fullres_maxnum_512_patch_192/crossval_results_folds_0_1_2_3_4/PETCT_d3208ff062_03142003.nii.gz,/well/papiez/users/hri611/python/nnUnet_raw/Dataset219_PETCT/labelsTr/PETCT_d3208ff062_03142003.nii.gz,,0.0,0.0
745,,0,0,,51680000,0,0,0,/well/papiez/users/hri611/python/nnUNet_results/Dataset219_PETCT/nnUNetTrainer_1500epochs_1e2lr__nnUNetPlans__3d_fullres_maxnum_512_patch_192/crossval_results_folds_0_1_2_3_4/PETCT_d325897ff4_05102007.nii.gz,/well/papiez/users/hri611/python/nnUnet_raw/Dataset219_PETCT/labelsTr/PETCT_d325897ff4_05102007.nii.gz,,0.0,0.0
746,,0,0,,52480000,0,0,0,/well/papiez/users/hri611/python/nnUNet_results/Dataset219_PETCT/nnUNetTrainer_1500epochs_1e2lr__nnUNetPlans__3d_fullres_maxnum_512_patch_192/crossval_results_folds_0_1_2_3_4/PETCT_d325897ff4_07152005.nii.gz,/well/papiez/users/hri611/python/nnUnet_raw/Dataset219_PETCT/labelsTr/PETCT_d325897ff4_07152005.nii.gz,,0.0,0.0
747,0.0,0,15,0.0,50879985,0,15,0,/well/papiez/users/hri611/python/nnUNet_results/Dataset219_PETCT/nnUNetTrainer_1500epochs_1e2lr__nnUNetPlans__3d_fullres_maxnum_512_patch_192/crossval_results_folds_0_1_2_3_4/PETCT_d325897ff4_11122005.nii.gz,/well/papiez/users/hri611/python/nnUnet_raw/Dataset219_PETCT/labelsTr/PETCT_d325897ff4_11122005.nii.gz,0.0,0.18661531448364257,0.0
748,,0,0,,52160000,0,0,0,/well/papiez/users/hri611/python/nnUNet_results/Dataset219_PETCT/nnUNetTrainer_1500epochs_1e2lr__nnUNetPlans__3d_fullres_maxnum_512_patch_192/crossval_results_folds_0_1_2_3_4/PETCT_d32cf972af_03132003.nii.gz,/well/papiez/users/hri611/python/nnUnet_raw/Dataset219_PETCT/labelsTr/PETCT_d32cf972af_03132003.nii.gz,,0.0,0.0
749,0.7765892420537898,1232,230,0.6347739195603298,45435997,2541,2771,3773,/well/papiez/users/hri611/python/nnUNet_results/Dataset219_PETCT/nnUNetTrainer_1500epochs_1e2lr__nnUNetPlans__3d_fullres_maxnum_512_patch_192/crossval_results_folds_0_1_2_3_4/PETCT_d393ab6c7b_09222002.nii.gz,/well/papiez/users/hri611/python/nnUnet_raw/Dataset219_PETCT/labelsTr/PETCT_d393ab6c7b_09222002.nii.gz,0.7765892420537898,1.4307174110412597,0.0
750,,0,0,,48480000,0,0,0,/well/papiez/users/hri611/python/nnUNet_results/Dataset219_PETCT/nnUNetTrainer_1500epochs_1e2lr__nnUNetPlans__3d_fullres_maxnum_512_patch_192/crossval_results_folds_0_1_2_3_4/PETCT_d3d3b7d4ff_08312006.nii.gz,/well/papiez/users/hri611/python/nnUnet_raw/Dataset219_PETCT/labelsTr/PETCT_d3d3b7d4ff_08312006.nii.gz,,0.0,0.0
751,0.875352166298637,2801,2110,0.778334461746784,52137845,17244,19354,20045,/well/papiez/users/hri611/python/nnUNet_results/Dataset219_PETCT/nnUNetTrainer_1500epochs_1e2lr__nnUNetPlans__3d_fullres_maxnum_512_patch_192/crossval_results_folds_0_1_2_3_4/PETCT_d3d61785e6_10192001.nii.gz,/well/papiez/users/hri611/python/nnUnet_raw/Dataset219_PETCT/labelsTr/PETCT_d3d61785e6_10192001.nii.gz,0.875352166298637,1.3560712852478027,19.880751502990723
752,0.9352558585758829,1887,2702,0.8783855408915037,72122266,33145,35847,35032,/well/papiez/users/hri611/python/nnUNet_results/Dataset219_PETCT/nnUNetTrainer_1500epochs_1e2lr__nnUNetPlans__3d_fullres_maxnum_512_patch_192/crossval_results_folds_0_1_2_3_4/PETCT_d3dac0d1cd_08092003.nii.gz,/well/papiez/users/hri611/python/nnUnet_raw/Dataset219_PETCT/labelsTr/PETCT_d3dac0d1cd_08092003.nii.gz,0.9352558585758829,0.9579586143493652,0.012441020965576172
753,,0,0,,45440000,0,0,0,/well/papiez/users/hri611/python/nnUNet_results/Dataset219_PETCT/nnUNetTrainer_1500epochs_1e2lr__nnUNetPlans__3d_fullres_maxnum_512_patch_192/crossval_results_folds_0_1_2_3_4/PETCT_d3f13dff4b_08242003.nii.gz,/well/papiez/users/hri611/python/nnUnet_raw/Dataset219_PETCT/labelsTr/PETCT_d3f13dff4b_08242003.nii.gz,,0.0,0.0
754,0.3364066782955395,6805,1184,0.20221689634511683,52149986,2025,3209,8830,/well/papiez/users/hri611/python/nnUNet_results/Dataset219_PETCT/nnUNetTrainer_1500epochs_1e2lr__nnUNetPlans__3d_fullres_maxnum_512_patch_192/crossval_results_folds_0_1_2_3_4/PETCT_d40a16781a_09132003.nii.gz,/well/papiez/users/hri611/python/nnUnet_raw/Dataset219_PETCT/labelsTr/PETCT_d40a16781a_09132003.nii.gz,0.3364066782955395,13.573153873443603,0.2985845031738281
755,0.801987798472789,6651,3151,0.6694320787805207,45410348,19850,23001,26501,/well/papiez/users/hri611/python/nnUNet_results/Dataset219_PETCT/nnUNetTrainer_1500epochs_1e2lr__nnUNetPlans__3d_fullres_maxnum_512_patch_192/crossval_results_folds_0_1_2_3_4/PETCT_d4112bc7ba_01292001.nii.gz,/well/papiez/users/hri611/python/nnUnet_raw/Dataset219_PETCT/labelsTr/PETCT_d4112bc7ba_01292001.nii.gz,0.801987798472789,7.86272525024414,38.51740090942383
756,0.7102477130229211,5374,264,0.5506853681861651,52147452,6910,7174,12284,/well/papiez/users/hri611/python/nnUNet_results/Dataset219_PETCT/nnUNetTrainer_1500epochs_1e2lr__nnUNetPlans__3d_fullres_maxnum_512_patch_192/crossval_results_folds_0_1_2_3_4/PETCT_d46f0109f8_09092000.nii.gz,/well/papiez/users/hri611/python/nnUnet_raw/Dataset219_PETCT/labelsTr/PETCT_d46f0109f8_09092000.nii.gz,0.7102477130229211,0.1368512306213379,52.165200908660886
757,0.0,0,96,0.0,45439904,0,96,0,/well/papiez/users/hri611/python/nnUNet_results/Dataset219_PETCT/nnUNetTrainer_1500epochs_1e2lr__nnUNetPlans__3d_fullres_maxnum_512_patch_192/crossval_results_folds_0_1_2_3_4/PETCT_d472033d3b_09282002.nii.gz,/well/papiez/users/hri611/python/nnUnet_raw/Dataset219_PETCT/labelsTr/PETCT_d472033d3b_09282002.nii.gz,0.0,1.1943380126953125,0.0
758,,0,0,,50080000,0,0,0,/well/papiez/users/hri611/python/nnUNet_results/Dataset219_PETCT/nnUNetTrainer_1500epochs_1e2lr__nnUNetPlans__3d_fullres_maxnum_512_patch_192/crossval_results_folds_0_1_2_3_4/PETCT_d4a08e4bde_03162006.nii.gz,/well/papiez/users/hri611/python/nnUnet_raw/Dataset219_PETCT/labelsTr/PETCT_d4a08e4bde_03162006.nii.gz,,0.0,0.0
759,0.6678182172051382,65236,3034,0.5012966141933599,45303105,68625,71659,133861,/well/papiez/users/hri611/python/nnUNet_results/Dataset219_PETCT/nnUNetTrainer_1500epochs_1e2lr__nnUNetPlans__3d_fullres_maxnum_512_patch_192/crossval_results_folds_0_1_2_3_4/PETCT_d4b2ff9721_12162001.nii.gz,/well/papiez/users/hri611/python/nnUnet_raw/Dataset219_PETCT/labelsTr/PETCT_d4b2ff9721_12162001.nii.gz,0.6678182172051382,0.24882041931152343,157.777027885437
760,0.0,0,107,0.0,49759893,0,107,0,/well/papiez/users/hri611/python/nnUNet_results/Dataset219_PETCT/nnUNetTrainer_1500epochs_1e2lr__nnUNetPlans__3d_fullres_maxnum_512_patch_192/crossval_results_folds_0_1_2_3_4/PETCT_d4d3d7dfc1_09122005.nii.gz,/well/papiez/users/hri611/python/nnUnet_raw/Dataset219_PETCT/labelsTr/PETCT_d4d3d7dfc1_09122005.nii.gz,0.0,1.3311892433166503,0.0
761,0.4672153386994664,2583,3308,0.3048147274014633,91831526,2583,5891,5166,/well/papiez/users/hri611/python/nnUNet_results/Dataset219_PETCT/nnUNetTrainer_1500epochs_1e2lr__nnUNetPlans__3d_fullres_maxnum_512_patch_192/crossval_results_folds_0_1_2_3_4/PETCT_d4f3375362_05272005.nii.gz,/well/papiez/users/hri611/python/nnUnet_raw/Dataset219_PETCT/labelsTr/PETCT_d4f3375362_05272005.nii.gz,0.4672153386994664,38.36810865783691,8.12398669052124
762,0.9151418969380134,567,1251,0.8435590740900095,75188379,9803,11054,10370,/well/papiez/users/hri611/python/nnUNet_results/Dataset219_PETCT/nnUNetTrainer_1500epochs_1e2lr__nnUNetPlans__3d_fullres_maxnum_512_patch_192/crossval_results_folds_0_1_2_3_4/PETCT_d5103c8fbf_04142006.nii.gz,/well/papiez/users/hri611/python/nnUnet_raw/Dataset219_PETCT/labelsTr/PETCT_d5103c8fbf_04142006.nii.gz,0.9151418969380134,0.3110255241394043,0.0
763,0.8867950672024387,139,2312,0.7966143888473985,45427949,9600,11912,9739,/well/papiez/users/hri611/python/nnUNet_results/Dataset219_PETCT/nnUNetTrainer_1500epochs_1e2lr__nnUNetPlans__3d_fullres_maxnum_512_patch_192/crossval_results_folds_0_1_2_3_4/PETCT_d51664a9e4_11052004.nii.gz,/well/papiez/users/hri611/python/nnUnet_raw/Dataset219_PETCT/labelsTr/PETCT_d51664a9e4_11052004.nii.gz,0.8867950672024387,4.851998176574707,0.0
764,0.9266977708657336,685,729,0.8634080370942813,45429648,8938,9667,9623,/well/papiez/users/hri611/python/nnUNet_results/Dataset219_PETCT/nnUNetTrainer_1500epochs_1e2lr__nnUNetPlans__3d_fullres_maxnum_512_patch_192/crossval_results_folds_0_1_2_3_4/PETCT_d51bacdaba_06282001.nii.gz,/well/papiez/users/hri611/python/nnUnet_raw/Dataset219_PETCT/labelsTr/PETCT_d51bacdaba_06282001.nii.gz,0.9266977708657336,0.19905633544921875,0.012441020965576172
765,0.0,0,78,0.0,85599922,0,78,0,/well/papiez/users/hri611/python/nnUNet_results/Dataset219_PETCT/nnUNetTrainer_1500epochs_1e2lr__nnUNetPlans__3d_fullres_maxnum_512_patch_192/crossval_results_folds_0_1_2_3_4/PETCT_d539f5a88b_06232003.nii.gz,/well/papiez/users/hri611/python/nnUnet_raw/Dataset219_PETCT/labelsTr/PETCT_d539f5a88b_06232003.nii.gz,0.0,0.9703996353149413,0.0
766,0.0,0,279,0.0,72159721,0,279,0,/well/papiez/users/hri611/python/nnUNet_results/Dataset219_PETCT/nnUNetTrainer_1500epochs_1e2lr__nnUNetPlans__3d_fullres_maxnum_512_patch_192/crossval_results_folds_0_1_2_3_4/PETCT_d5e2aa7feb_04172003.nii.gz,/well/papiez/users/hri611/python/nnUnet_raw/Dataset219_PETCT/labelsTr/PETCT_d5e2aa7feb_04172003.nii.gz,0.0,3.471044849395752,0.0
767,,0,0,,58880000,0,0,0,/well/papiez/users/hri611/python/nnUNet_results/Dataset219_PETCT/nnUNetTrainer_1500epochs_1e2lr__nnUNetPlans__3d_fullres_maxnum_512_patch_192/crossval_results_folds_0_1_2_3_4/PETCT_d626611daf_04032003.nii.gz,/well/papiez/users/hri611/python/nnUnet_raw/Dataset219_PETCT/labelsTr/PETCT_d626611daf_04032003.nii.gz,,0.0,0.0
768,,0,0,,55360000,0,0,0,/well/papiez/users/hri611/python/nnUNet_results/Dataset219_PETCT/nnUNetTrainer_1500epochs_1e2lr__nnUNetPlans__3d_fullres_maxnum_512_patch_192/crossval_results_folds_0_1_2_3_4/PETCT_d626611daf_06192005.nii.gz,/well/papiez/users/hri611/python/nnUnet_raw/Dataset219_PETCT/labelsTr/PETCT_d626611daf_06192005.nii.gz,,0.0,0.0
769,0.0,0,165,0.0,58879835,0,165,0,/well/papiez/users/hri611/python/nnUNet_results/Dataset219_PETCT/nnUNetTrainer_1500epochs_1e2lr__nnUNetPlans__3d_fullres_maxnum_512_patch_192/crossval_results_folds_0_1_2_3_4/PETCT_d626611daf_10022003.nii.gz,/well/papiez/users/hri611/python/nnUnet_raw/Dataset219_PETCT/labelsTr/PETCT_d626611daf_10022003.nii.gz,0.0,2.052768459320068,0.0
770,0.0,0,104,0.0,58879896,0,104,0,/well/papiez/users/hri611/python/nnUNet_results/Dataset219_PETCT/nnUNetTrainer_1500epochs_1e2lr__nnUNetPlans__3d_fullres_maxnum_512_patch_192/crossval_results_folds_0_1_2_3_4/PETCT_d626611daf_11122004.nii.gz,/well/papiez/users/hri611/python/nnUnet_raw/Dataset219_PETCT/labelsTr/PETCT_d626611daf_11122004.nii.gz,0.0,1.2938661804199219,0.0
771,0.9022726757754967,8380,246,0.8219460843000455,105711554,39820,40066,48200,/well/papiez/users/hri611/python/nnUNet_results/Dataset219_PETCT/nnUNetTrainer_1500epochs_1e2lr__nnUNetPlans__3d_fullres_maxnum_512_patch_192/crossval_results_folds_0_1_2_3_4/PETCT_d626611daf_11292002.nii.gz,/well/papiez/users/hri611/python/nnUnet_raw/Dataset219_PETCT/labelsTr/PETCT_d626611daf_11292002.nii.gz,0.9022726757754967,0.037323062896728515,0.037323062896728515
772,0.7839582052858021,212,1194,0.6446803133687137,73116043,2551,3745,2763,/well/papiez/users/hri611/python/nnUNet_results/Dataset219_PETCT/nnUNetTrainer_1500epochs_1e2lr__nnUNetPlans__3d_fullres_maxnum_512_patch_192/crossval_results_folds_0_1_2_3_4/PETCT_d63f6162a6_07082005.nii.gz,/well/papiez/users/hri611/python/nnUnet_raw/Dataset219_PETCT/labelsTr/PETCT_d63f6162a6_07082005.nii.gz,0.7839582052858021,1.0450457611083985,2.2767068367004395
773,,0,0,,45440000,0,0,0,/well/papiez/users/hri611/python/nnUNet_results/Dataset219_PETCT/nnUNetTrainer_1500epochs_1e2lr__nnUNetPlans__3d_fullres_maxnum_512_patch_192/crossval_results_folds_0_1_2_3_4/PETCT_d64d6a87c8_12182004.nii.gz,/well/papiez/users/hri611/python/nnUnet_raw/Dataset219_PETCT/labelsTr/PETCT_d64d6a87c8_12182004.nii.gz,,0.0,0.0
774,0.8130081300813008,0,46,0.684931506849315,52479854,100,146,100,/well/papiez/users/hri611/python/nnUNet_results/Dataset219_PETCT/nnUNetTrainer_1500epochs_1e2lr__nnUNetPlans__3d_fullres_maxnum_512_patch_192/crossval_results_folds_0_1_2_3_4/PETCT_d65cf203be_04282007.nii.gz,/well/papiez/users/hri611/python/nnUnet_raw/Dataset219_PETCT/labelsTr/PETCT_d65cf203be_04282007.nii.gz,0.8130081300813008,0.0,0.0
775,0.8431372549019608,23,9,0.7288135593220338,45439882,86,95,109,/well/papiez/users/hri611/python/nnUNet_results/Dataset219_PETCT/nnUNetTrainer_1500epochs_1e2lr__nnUNetPlans__3d_fullres_maxnum_512_patch_192/crossval_results_folds_0_1_2_3_4/PETCT_d674a028b1_12032001.nii.gz,/well/papiez/users/hri611/python/nnUnet_raw/Dataset219_PETCT/labelsTr/PETCT_d674a028b1_12032001.nii.gz,0.8431372549019608,0.0,0.0
776,0.8566814695195801,258,452,0.7492937853107344,52157168,2122,2574,2380,/well/papiez/users/hri611/python/nnUNet_results/Dataset219_PETCT/nnUNetTrainer_1500epochs_1e2lr__nnUNetPlans__3d_fullres_maxnum_512_patch_192/crossval_results_folds_0_1_2_3_4/PETCT_d69c3fceba_04052003.nii.gz,/well/papiez/users/hri611/python/nnUnet_raw/Dataset219_PETCT/labelsTr/PETCT_d69c3fceba_04052003.nii.gz,0.8566814695195801,0.7589022789001465,2.6499374656677244
777,0.6811970045747253,9485,1456,0.5165267344233319,45417370,11689,13145,21174,/well/papiez/users/hri611/python/nnUNet_results/Dataset219_PETCT/nnUNetTrainer_1500epochs_1e2lr__nnUNetPlans__3d_fullres_maxnum_512_patch_192/crossval_results_folds_0_1_2_3_4/PETCT_d69eabbb20_02012001.nii.gz,/well/papiez/users/hri611/python/nnUnet_raw/Dataset219_PETCT/labelsTr/PETCT_d69eabbb20_02012001.nii.gz,0.6811970045747253,12.926220783233642,52.115436824798586
778,,0,0,,58880000,0,0,0,/well/papiez/users/hri611/python/nnUNet_results/Dataset219_PETCT/nnUNetTrainer_1500epochs_1e2lr__nnUNetPlans__3d_fullres_maxnum_512_patch_192/crossval_results_folds_0_1_2_3_4/PETCT_d6a48a629d_03062003.nii.gz,/well/papiez/users/hri611/python/nnUnet_raw/Dataset219_PETCT/labelsTr/PETCT_d6a48a629d_03062003.nii.gz,,0.0,0.0
779,,0,0,,52160000,0,0,0,/well/papiez/users/hri611/python/nnUNet_results/Dataset219_PETCT/nnUNetTrainer_1500epochs_1e2lr__nnUNetPlans__3d_fullres_maxnum_512_patch_192/crossval_results_folds_0_1_2_3_4/PETCT_d6a48a629d_07272002.nii.gz,/well/papiez/users/hri611/python/nnUnet_raw/Dataset219_PETCT/labelsTr/PETCT_d6a48a629d_07272002.nii.gz,,0.0,0.0
780,0.0,0,830,0.0,99039170,0,830,0,/well/papiez/users/hri611/python/nnUNet_results/Dataset219_PETCT/nnUNetTrainer_1500epochs_1e2lr__nnUNetPlans__3d_fullres_maxnum_512_patch_192/crossval_results_folds_0_1_2_3_4/PETCT_d6a491e16d_05302003.nii.gz,/well/papiez/users/hri611/python/nnUnet_raw/Dataset219_PETCT/labelsTr/PETCT_d6a491e16d_05302003.nii.gz,0.0,10.326047401428223,0.0
781,,0,0,,45440000,0,0,0,/well/papiez/users/hri611/python/nnUNet_results/Dataset219_PETCT/nnUNetTrainer_1500epochs_1e2lr__nnUNetPlans__3d_fullres_maxnum_512_patch_192/crossval_results_folds_0_1_2_3_4/PETCT_d6b2218bf3_12182004.nii.gz,/well/papiez/users/hri611/python/nnUnet_raw/Dataset219_PETCT/labelsTr/PETCT_d6b2218bf3_12182004.nii.gz,,0.0,0.0
782,0.30950901180857676,1083,28,0.18308823529411763,54078640,249,277,1332,/well/papiez/users/hri611/python/nnUNet_results/Dataset219_PETCT/nnUNetTrainer_1500epochs_1e2lr__nnUNetPlans__3d_fullres_maxnum_512_patch_192/crossval_results_folds_0_1_2_3_4/PETCT_d6de1252d9_05132007.nii.gz,/well/papiez/users/hri611/python/nnUnet_raw/Dataset219_PETCT/labelsTr/PETCT_d6de1252d9_05132007.nii.gz,0.30950901180857676,0.32346654510498046,12.938661804199219
783,0.6352175681171208,678,219,0.465435041716329,47838322,781,1000,1459,/well/papiez/users/hri611/python/nnUNet_results/Dataset219_PETCT/nnUNetTrainer_1500epochs_1e2lr__nnUNetPlans__3d_fullres_maxnum_512_patch_192/crossval_results_folds_0_1_2_3_4/PETCT_d8a92bafe3_03182007.nii.gz,/well/papiez/users/hri611/python/nnUnet_raw/Dataset219_PETCT/labelsTr/PETCT_d8a92bafe3_03182007.nii.gz,0.6352175681171208,0.5225228805541993,7.613904830932617
784,0.7691376701966717,30,733,0.6248770894788593,92317966,1271,2004,1301,/well/papiez/users/hri611/python/nnUNet_results/Dataset219_PETCT/nnUNetTrainer_1500epochs_1e2lr__nnUNetPlans__3d_fullres_maxnum_512_patch_192/crossval_results_folds_0_1_2_3_4/PETCT_d8d9e52cd5_03132005.nii.gz,/well/papiez/users/hri611/python/nnUnet_raw/Dataset219_PETCT/labelsTr/PETCT_d8d9e52cd5_03132005.nii.gz,0.7691376701966717,1.3187482223510743,0.012441020965576172
785,0.8256038647342995,161,2005,0.7030028794734677,100472707,5127,7132,5288,/well/papiez/users/hri611/python/nnUNet_results/Dataset219_PETCT/nnUNetTrainer_1500epochs_1e2lr__nnUNetPlans__3d_fullres_maxnum_512_patch_192/crossval_results_folds_0_1_2_3_4/PETCT_d8d9e52cd5_05072007.nii.gz,/well/papiez/users/hri611/python/nnUnet_raw/Dataset219_PETCT/labelsTr/PETCT_d8d9e52cd5_05072007.nii.gz,0.8256038647342995,3.2719885139465332,0.0
786,0.8155750075460307,292,319,0.6885830784913354,92318038,1351,1670,1643,/well/papiez/users/hri611/python/nnUNet_results/Dataset219_PETCT/nnUNetTrainer_1500epochs_1e2lr__nnUNetPlans__3d_fullres_maxnum_512_patch_192/crossval_results_folds_0_1_2_3_4/PETCT_d8d9e52cd5_07042004.nii.gz,/well/papiez/users/hri611/python/nnUnet_raw/Dataset219_PETCT/labelsTr/PETCT_d8d9e52cd5_07042004.nii.gz,0.8155750075460307,1.7915070190429687,1.3685123062133788
787,0.32492336713039377,7982,607,0.19397522522522523,94069344,2067,2674,10049,/well/papiez/users/hri611/python/nnUNet_results/Dataset219_PETCT/nnUNetTrainer_1500epochs_1e2lr__nnUNetPlans__3d_fullres_maxnum_512_patch_192/crossval_results_folds_0_1_2_3_4/PETCT_d8d9e52cd5_10072005.nii.gz,/well/papiez/users/hri611/python/nnUnet_raw/Dataset219_PETCT/labelsTr/PETCT_d8d9e52cd5_10072005.nii.gz,0.32492336713039377,1.4058353691101073,98.60753217315674
788,0.0,0,81,0.0,52159919,0,81,0,/well/papiez/users/hri611/python/nnUNet_results/Dataset219_PETCT/nnUNetTrainer_1500epochs_1e2lr__nnUNetPlans__3d_fullres_maxnum_512_patch_192/crossval_results_folds_0_1_2_3_4/PETCT_d8e3aa97a0_05192005.nii.gz,/well/papiez/users/hri611/python/nnUnet_raw/Dataset219_PETCT/labelsTr/PETCT_d8e3aa97a0_05192005.nii.gz,0.0,1.0077226982116698,0.0
789,0.9221623751970572,1879,491,0.855567066853556,45423591,14039,14530,15918,/well/papiez/users/hri611/python/nnUNet_results/Dataset219_PETCT/nnUNetTrainer_1500epochs_1e2lr__nnUNetPlans__3d_fullres_maxnum_512_patch_192/crossval_results_folds_0_1_2_3_4/PETCT_d951eeb735_01232003.nii.gz,/well/papiez/users/hri611/python/nnUnet_raw/Dataset219_PETCT/labelsTr/PETCT_d951eeb735_01232003.nii.gz,0.9221623751970572,0.0,0.6842561531066894
790,0.8294580496861462,1860,69,0.7086102719033233,99033380,4691,4760,6551,/well/papiez/users/hri611/python/nnUNet_results/Dataset219_PETCT/nnUNetTrainer_1500epochs_1e2lr__nnUNetPlans__3d_fullres_maxnum_512_patch_192/crossval_results_folds_0_1_2_3_4/PETCT_d9da6129f8_04142002.nii.gz,/well/papiez/users/hri611/python/nnUnet_raw/Dataset219_PETCT/labelsTr/PETCT_d9da6129f8_04142002.nii.gz,0.8294580496861462,0.5100818595886231,0.012441020965576172
791,0.0,0,85,0.0,52159915,0,85,0,/well/papiez/users/hri611/python/nnUNet_results/Dataset219_PETCT/nnUNetTrainer_1500epochs_1e2lr__nnUNetPlans__3d_fullres_maxnum_512_patch_192/crossval_results_folds_0_1_2_3_4/PETCT_da4ce0da01_06132003.nii.gz,/well/papiez/users/hri611/python/nnUnet_raw/Dataset219_PETCT/labelsTr/PETCT_da4ce0da01_06132003.nii.gz,0.0,1.0574867820739746,0.0
792,0.8378063010501751,225,609,0.7208835341365462,45437012,2154,2763,2379,/well/papiez/users/hri611/python/nnUNet_results/Dataset219_PETCT/nnUNetTrainer_1500epochs_1e2lr__nnUNetPlans__3d_fullres_maxnum_512_patch_192/crossval_results_folds_0_1_2_3_4/PETCT_da6161d7eb_06202003.nii.gz,/well/papiez/users/hri611/python/nnUnet_raw/Dataset219_PETCT/labelsTr/PETCT_da6161d7eb_06202003.nii.gz,0.8378063010501751,0.19905633544921875,1.4680404739379882
793,0.794432969410839,6961,1399,0.6589703842702129,52135486,16154,17553,23115,/well/papiez/users/hri611/python/nnUNet_results/Dataset219_PETCT/nnUNetTrainer_1500epochs_1e2lr__nnUNetPlans__3d_fullres_maxnum_512_patch_192/crossval_results_folds_0_1_2_3_4/PETCT_dac5cd2a4d_12022001.nii.gz,/well/papiez/users/hri611/python/nnUnet_raw/Dataset219_PETCT/labelsTr/PETCT_dac5cd2a4d_12022001.nii.gz,0.794432969410839,0.0,6.966971740722656
794,0.8284023668639053,17,12,0.7070707070707071,99039901,70,82,87,/well/papiez/users/hri611/python/nnUNet_results/Dataset219_PETCT/nnUNetTrainer_1500epochs_1e2lr__nnUNetPlans__3d_fullres_maxnum_512_patch_192/crossval_results_folds_0_1_2_3_4/PETCT_dadcd69ba9_05192005.nii.gz,/well/papiez/users/hri611/python/nnUnet_raw/Dataset219_PETCT/labelsTr/PETCT_dadcd69ba9_05192005.nii.gz,0.8284023668639053,0.14929225158691406,0.0
795,0.0,0,1107,0.0,52158893,0,1107,0,/well/papiez/users/hri611/python/nnUNet_results/Dataset219_PETCT/nnUNetTrainer_1500epochs_1e2lr__nnUNetPlans__3d_fullres_maxnum_512_patch_192/crossval_results_folds_0_1_2_3_4/PETCT_dae86b88e2_06212003.nii.gz,/well/papiez/users/hri611/python/nnUnet_raw/Dataset219_PETCT/labelsTr/PETCT_dae86b88e2_06212003.nii.gz,0.0,13.772210208892822,0.0
796,0.0,0,196,0.0,51039804,0,196,0,/well/papiez/users/hri611/python/nnUNet_results/Dataset219_PETCT/nnUNetTrainer_1500epochs_1e2lr__nnUNetPlans__3d_fullres_maxnum_512_patch_192/crossval_results_folds_0_1_2_3_4/PETCT_db3bac356a_08212005.nii.gz,/well/papiez/users/hri611/python/nnUnet_raw/Dataset219_PETCT/labelsTr/PETCT_db3bac356a_08212005.nii.gz,0.0,2.4384401092529298,0.0
797,0.9205880284166843,707,422,0.852860680307572,52152327,6544,6966,7251,/well/papiez/users/hri611/python/nnUNet_results/Dataset219_PETCT/nnUNetTrainer_1500epochs_1e2lr__nnUNetPlans__3d_fullres_maxnum_512_patch_192/crossval_results_folds_0_1_2_3_4/PETCT_db3daf78d2_10302000.nii.gz,/well/papiez/users/hri611/python/nnUnet_raw/Dataset219_PETCT/labelsTr/PETCT_db3daf78d2_10302000.nii.gz,0.9205880284166843,0.5971690063476562,0.0
798,0.0,0,8,0.0,47999992,0,8,0,/well/papiez/users/hri611/python/nnUNet_results/Dataset219_PETCT/nnUNetTrainer_1500epochs_1e2lr__nnUNetPlans__3d_fullres_maxnum_512_patch_192/crossval_results_folds_0_1_2_3_4/PETCT_dc15c1d9bb_06032005.nii.gz,/well/papiez/users/hri611/python/nnUnet_raw/Dataset219_PETCT/labelsTr/PETCT_dc15c1d9bb_06032005.nii.gz,0.0,0.09952816772460937,0.0
799,0.8569349188335719,912,10686,0.7496816523859884,45393667,34735,45421,35647,/well/papiez/users/hri611/python/nnUNet_results/Dataset219_PETCT/nnUNetTrainer_1500epochs_1e2lr__nnUNetPlans__3d_fullres_maxnum_512_patch_192/crossval_results_folds_0_1_2_3_4/PETCT_dc6174cb5d_03292003.nii.gz,/well/papiez/users/hri611/python/nnUnet_raw/Dataset219_PETCT/labelsTr/PETCT_dc6174cb5d_03292003.nii.gz,0.8569349188335719,2.7867886962890625,10.164314128875732
800,0.890701266604881,1265,2273,0.802940848835914,45422046,14416,16689,15681,/well/papiez/users/hri611/python/nnUNet_results/Dataset219_PETCT/nnUNetTrainer_1500epochs_1e2lr__nnUNetPlans__3d_fullres_maxnum_512_patch_192/crossval_results_folds_0_1_2_3_4/PETCT_dc6174cb5d_12152002.nii.gz,/well/papiez/users/hri611/python/nnUnet_raw/Dataset219_PETCT/labelsTr/PETCT_dc6174cb5d_12152002.nii.gz,0.890701266604881,6.730592342376709,0.2737024612426758
801,0.0,0,3,0.0,48159997,0,3,0,/well/papiez/users/hri611/python/nnUNet_results/Dataset219_PETCT/nnUNetTrainer_1500epochs_1e2lr__nnUNetPlans__3d_fullres_maxnum_512_patch_192/crossval_results_folds_0_1_2_3_4/PETCT_dd6165ae36_06012006.nii.gz,/well/papiez/users/hri611/python/nnUnet_raw/Dataset219_PETCT/labelsTr/PETCT_dd6165ae36_06012006.nii.gz,0.0,0.037323062896728515,0.0
802,0.7563996696944674,289,6,0.6082337317397079,45439247,458,464,747,/well/papiez/users/hri611/python/nnUNet_results/Dataset219_PETCT/nnUNetTrainer_1500epochs_1e2lr__nnUNetPlans__3d_fullres_maxnum_512_patch_192/crossval_results_folds_0_1_2_3_4/PETCT_dd68a71e0a_11202004.nii.gz,/well/papiez/users/hri611/python/nnUnet_raw/Dataset219_PETCT/labelsTr/PETCT_dd68a71e0a_11202004.nii.gz,0.7563996696944674,0.0,0.4105536918640137
803,0.0,0,170,0.0,47999830,0,170,0,/well/papiez/users/hri611/python/nnUNet_results/Dataset219_PETCT/nnUNetTrainer_1500epochs_1e2lr__nnUNetPlans__3d_fullres_maxnum_512_patch_192/crossval_results_folds_0_1_2_3_4/PETCT_dd887591a9_05062006.nii.gz,/well/papiez/users/hri611/python/nnUnet_raw/Dataset219_PETCT/labelsTr/PETCT_dd887591a9_05062006.nii.gz,0.0,2.1149735641479492,0.0
804,0.7527955271565495,1629,2085,0.6035862952289466,52150631,5655,7740,7284,/well/papiez/users/hri611/python/nnUNet_results/Dataset219_PETCT/nnUNetTrainer_1500epochs_1e2lr__nnUNetPlans__3d_fullres_maxnum_512_patch_192/crossval_results_folds_0_1_2_3_4/PETCT_dd8f9f217c_02152004.nii.gz,/well/papiez/users/hri611/python/nnUnet_raw/Dataset219_PETCT/labelsTr/PETCT_dd8f9f217c_02152004.nii.gz,0.7527955271565495,2.4882041931152346,4.864439197540283
805,0.8600439713029391,3369,1469,0.7544536365020555,45420297,14865,16334,18234,/well/papiez/users/hri611/python/nnUNet_results/Dataset219_PETCT/nnUNetTrainer_1500epochs_1e2lr__nnUNetPlans__3d_fullres_maxnum_512_patch_192/crossval_results_folds_0_1_2_3_4/PETCT_dd975744e7_09232001.nii.gz,/well/papiez/users/hri611/python/nnUnet_raw/Dataset219_PETCT/labelsTr/PETCT_dd975744e7_09232001.nii.gz,0.8600439713029391,0.0,6.892325614929199
806,0.7632501668127641,2762,69620,0.6171419201616444,51970943,116675,186295,119437,/well/papiez/users/hri611/python/nnUNet_results/Dataset219_PETCT/nnUNetTrainer_1500epochs_1e2lr__nnUNetPlans__3d_fullres_maxnum_512_patch_192/crossval_results_folds_0_1_2_3_4/PETCT_ddbb3c69f0_08112003.nii.gz,/well/papiez/users/hri611/python/nnUnet_raw/Dataset219_PETCT/labelsTr/PETCT_ddbb3c69f0_08112003.nii.gz,0.7632501668127641,94.80057975769043,1.2814251594543458
807,0.0,1769,0,0.0,45438231,0,0,1769,/well/papiez/users/hri611/python/nnUNet_results/Dataset219_PETCT/nnUNetTrainer_1500epochs_1e2lr__nnUNetPlans__3d_fullres_maxnum_512_patch_192/crossval_results_folds_0_1_2_3_4/PETCT_de118d7ab9_06022001.nii.gz,/well/papiez/users/hri611/python/nnUnet_raw/Dataset219_PETCT/labelsTr/PETCT_de118d7ab9_06022001.nii.gz,0.0,0.0,22.008166088104247
808,,0,0,,52160000,0,0,0,/well/papiez/users/hri611/python/nnUNet_results/Dataset219_PETCT/nnUNetTrainer_1500epochs_1e2lr__nnUNetPlans__3d_fullres_maxnum_512_patch_192/crossval_results_folds_0_1_2_3_4/PETCT_dec9ff6a91_03032003.nii.gz,/well/papiez/users/hri611/python/nnUnet_raw/Dataset219_PETCT/labelsTr/PETCT_dec9ff6a91_03032003.nii.gz,,0.0,0.0
809,,0,0,,52160000,0,0,0,/well/papiez/users/hri611/python/nnUNet_results/Dataset219_PETCT/nnUNetTrainer_1500epochs_1e2lr__nnUNetPlans__3d_fullres_maxnum_512_patch_192/crossval_results_folds_0_1_2_3_4/PETCT_df2e16771a_11142003.nii.gz,/well/papiez/users/hri611/python/nnUnet_raw/Dataset219_PETCT/labelsTr/PETCT_df2e16771a_11142003.nii.gz,,0.0,0.0
810,0.0,0,1205,0.0,52158795,0,1205,0,/well/papiez/users/hri611/python/nnUNet_results/Dataset219_PETCT/nnUNetTrainer_1500epochs_1e2lr__nnUNetPlans__3d_fullres_maxnum_512_patch_192/crossval_results_folds_0_1_2_3_4/PETCT_e00c98b415_10192002.nii.gz,/well/papiez/users/hri611/python/nnUnet_raw/Dataset219_PETCT/labelsTr/PETCT_e00c98b415_10192002.nii.gz,0.0,14.991430263519288,0.0
811,0.8050896375180906,20617,2682,0.6737657173261643,38648582,48119,50801,68736,/well/papiez/users/hri611/python/nnUNet_results/Dataset219_PETCT/nnUNetTrainer_1500epochs_1e2lr__nnUNetPlans__3d_fullres_maxnum_512_patch_192/crossval_results_folds_0_1_2_3_4/PETCT_e03b96666f_05172001.nii.gz,/well/papiez/users/hri611/python/nnUnet_raw/Dataset219_PETCT/labelsTr/PETCT_e03b96666f_05172001.nii.gz,0.8050896375180906,0.012441020965576172,32.471064720153805
812,0.7859220477021525,709,27,0.6473406804024916,52157913,1351,1378,2060,/well/papiez/users/hri611/python/nnUNet_results/Dataset219_PETCT/nnUNetTrainer_1500epochs_1e2lr__nnUNetPlans__3d_fullres_maxnum_512_patch_192/crossval_results_folds_0_1_2_3_4/PETCT_e04b7fa860_06012002.nii.gz,/well/papiez/users/hri611/python/nnUnet_raw/Dataset219_PETCT/labelsTr/PETCT_e04b7fa860_06012002.nii.gz,0.7859220477021525,0.0,4.988849407196045
813,,0,0,,47360000,0,0,0,/well/papiez/users/hri611/python/nnUNet_results/Dataset219_PETCT/nnUNetTrainer_1500epochs_1e2lr__nnUNetPlans__3d_fullres_maxnum_512_patch_192/crossval_results_folds_0_1_2_3_4/PETCT_e09a20d8fc_03162006.nii.gz,/well/papiez/users/hri611/python/nnUnet_raw/Dataset219_PETCT/labelsTr/PETCT_e09a20d8fc_03162006.nii.gz,,0.0,0.0
814,,0,0,,47360000,0,0,0,/well/papiez/users/hri611/python/nnUNet_results/Dataset219_PETCT/nnUNetTrainer_1500epochs_1e2lr__nnUNetPlans__3d_fullres_maxnum_512_patch_192/crossval_results_folds_0_1_2_3_4/PETCT_e0a7ccecad_01282006.nii.gz,/well/papiez/users/hri611/python/nnUnet_raw/Dataset219_PETCT/labelsTr/PETCT_e0a7ccecad_01282006.nii.gz,,0.0,0.0
815,0.932005117894352,286,1202,0.8726681499229848,45428314,10198,11400,10484,/well/papiez/users/hri611/python/nnUNet_results/Dataset219_PETCT/nnUNetTrainer_1500epochs_1e2lr__nnUNetPlans__3d_fullres_maxnum_512_patch_192/crossval_results_folds_0_1_2_3_4/PETCT_e0aa99fa04_08292003.nii.gz,/well/papiez/users/hri611/python/nnUnet_raw/Dataset219_PETCT/labelsTr/PETCT_e0aa99fa04_08292003.nii.gz,0.932005117894352,3.2471064720153806,0.0
816,0.0,0,4,0.0,45439996,0,4,0,/well/papiez/users/hri611/python/nnUNet_results/Dataset219_PETCT/nnUNetTrainer_1500epochs_1e2lr__nnUNetPlans__3d_fullres_maxnum_512_patch_192/crossval_results_folds_0_1_2_3_4/PETCT_e0fdc6212a_05292003.nii.gz,/well/papiez/users/hri611/python/nnUnet_raw/Dataset219_PETCT/labelsTr/PETCT_e0fdc6212a_05292003.nii.gz,0.0,0.04976408386230469,0.0
817,0.8802395209580839,0,280,0.786096256684492,51678691,1029,1309,1029,/well/papiez/users/hri611/python/nnUNet_results/Dataset219_PETCT/nnUNetTrainer_1500epochs_1e2lr__nnUNetPlans__3d_fullres_maxnum_512_patch_192/crossval_results_folds_0_1_2_3_4/PETCT_e1a4145b63_03052006.nii.gz,/well/papiez/users/hri611/python/nnUnet_raw/Dataset219_PETCT/labelsTr/PETCT_e1a4145b63_03052006.nii.gz,0.8802395209580839,1.8661531448364257,0.0
818,0.0,0,895,0.0,45439105,0,895,0,/well/papiez/users/hri611/python/nnUNet_results/Dataset219_PETCT/nnUNetTrainer_1500epochs_1e2lr__nnUNetPlans__3d_fullres_maxnum_512_patch_192/crossval_results_folds_0_1_2_3_4/PETCT_e1a5b05186_02272005.nii.gz,/well/papiez/users/hri611/python/nnUnet_raw/Dataset219_PETCT/labelsTr/PETCT_e1a5b05186_02272005.nii.gz,0.0,11.134713764190673,0.0
819,,0,0,,38720000,0,0,0,/well/papiez/users/hri611/python/nnUNet_results/Dataset219_PETCT/nnUNetTrainer_1500epochs_1e2lr__nnUNetPlans__3d_fullres_maxnum_512_patch_192/crossval_results_folds_0_1_2_3_4/PETCT_e207c7a1a4_12232005.nii.gz,/well/papiez/users/hri611/python/nnUnet_raw/Dataset219_PETCT/labelsTr/PETCT_e207c7a1a4_12232005.nii.gz,,0.0,0.0
820,0.7743737142637418,925,46017,0.6318187878930485,52032503,80555,126572,81480,/well/papiez/users/hri611/python/nnUNet_results/Dataset219_PETCT/nnUNetTrainer_1500epochs_1e2lr__nnUNetPlans__3d_fullres_maxnum_512_patch_192/crossval_results_folds_0_1_2_3_4/PETCT_e252be4334_07092004.nii.gz,/well/papiez/users/hri611/python/nnUnet_raw/Dataset219_PETCT/labelsTr/PETCT_e252be4334_07092004.nii.gz,0.7743737142637418,13.548271831512452,5.374521057128906
821,0.7691971241901534,2605,5838,0.624955579246624,52137488,14069,19907,16674,/well/papiez/users/hri611/python/nnUNet_results/Dataset219_PETCT/nnUNetTrainer_1500epochs_1e2lr__nnUNetPlans__3d_fullres_maxnum_512_patch_192/crossval_results_folds_0_1_2_3_4/PETCT_e2834e6f5c_06142002.nii.gz,/well/papiez/users/hri611/python/nnUnet_raw/Dataset219_PETCT/labelsTr/PETCT_e2834e6f5c_06142002.nii.gz,0.7691971241901534,2.2020607109069825,5.710428623199463
822,0.0,0,63,0.0,50879937,0,63,0,/well/papiez/users/hri611/python/nnUNet_results/Dataset219_PETCT/nnUNetTrainer_1500epochs_1e2lr__nnUNetPlans__3d_fullres_maxnum_512_patch_192/crossval_results_folds_0_1_2_3_4/PETCT_e344879c2e_03082007.nii.gz,/well/papiez/users/hri611/python/nnUnet_raw/Dataset219_PETCT/labelsTr/PETCT_e344879c2e_03082007.nii.gz,0.0,0.7837843208312988,0.0
823,0.0,0,218,0.0,49919782,0,218,0,/well/papiez/users/hri611/python/nnUNet_results/Dataset219_PETCT/nnUNetTrainer_1500epochs_1e2lr__nnUNetPlans__3d_fullres_maxnum_512_patch_192/crossval_results_folds_0_1_2_3_4/PETCT_e344879c2e_11172006.nii.gz,/well/papiez/users/hri611/python/nnUnet_raw/Dataset219_PETCT/labelsTr/PETCT_e344879c2e_11172006.nii.gz,0.0,2.7121425704956055,0.0
824,,0,0,,45440000,0,0,0,/well/papiez/users/hri611/python/nnUNet_results/Dataset219_PETCT/nnUNetTrainer_1500epochs_1e2lr__nnUNetPlans__3d_fullres_maxnum_512_patch_192/crossval_results_folds_0_1_2_3_4/PETCT_e37d5b9bc2_12102004.nii.gz,/well/papiez/users/hri611/python/nnUnet_raw/Dataset219_PETCT/labelsTr/PETCT_e37d5b9bc2_12102004.nii.gz,,0.0,0.0
825,0.7903405072244114,1846,229,0.6533578349482125,52154014,3911,4140,5757,/well/papiez/users/hri611/python/nnUNet_results/Dataset219_PETCT/nnUNetTrainer_1500epochs_1e2lr__nnUNetPlans__3d_fullres_maxnum_512_patch_192/crossval_results_folds_0_1_2_3_4/PETCT_e4712dc58c_02121999.nii.gz,/well/papiez/users/hri611/python/nnUnet_raw/Dataset219_PETCT/labelsTr/PETCT_e4712dc58c_02121999.nii.gz,0.7903405072244114,0.0,3.421280765533447
826,0.7515935278254474,2637,5469,0.6020423192105651,48779631,12263,17732,14900,/well/papiez/users/hri611/python/nnUNet_results/Dataset219_PETCT/nnUNetTrainer_1500epochs_1e2lr__nnUNetPlans__3d_fullres_maxnum_512_patch_192/crossval_results_folds_0_1_2_3_4/PETCT_e4749cda88_11032005.nii.gz,/well/papiez/users/hri611/python/nnUnet_raw/Dataset219_PETCT/labelsTr/PETCT_e4749cda88_11032005.nii.gz,0.7515935278254474,1.0326047401428222,0.012441020965576172
827,0.0,0,22,0.0,52159978,0,22,0,/well/papiez/users/hri611/python/nnUNet_results/Dataset219_PETCT/nnUNetTrainer_1500epochs_1e2lr__nnUNetPlans__3d_fullres_maxnum_512_patch_192/crossval_results_folds_0_1_2_3_4/PETCT_e4e5baf901_02142005.nii.gz,/well/papiez/users/hri611/python/nnUnet_raw/Dataset219_PETCT/labelsTr/PETCT_e4e5baf901_02142005.nii.gz,0.0,0.2737024612426758,0.0
828,,0,0,,45600000,0,0,0,/well/papiez/users/hri611/python/nnUNet_results/Dataset219_PETCT/nnUNetTrainer_1500epochs_1e2lr__nnUNetPlans__3d_fullres_maxnum_512_patch_192/crossval_results_folds_0_1_2_3_4/PETCT_e4e99dbb47_07172005.nii.gz,/well/papiez/users/hri611/python/nnUnet_raw/Dataset219_PETCT/labelsTr/PETCT_e4e99dbb47_07172005.nii.gz,,0.0,0.0
829,0.0,0,532,0.0,47359468,0,532,0,/well/papiez/users/hri611/python/nnUNet_results/Dataset219_PETCT/nnUNetTrainer_1500epochs_1e2lr__nnUNetPlans__3d_fullres_maxnum_512_patch_192/crossval_results_folds_0_1_2_3_4/PETCT_e52eca67d7_03132006.nii.gz,/well/papiez/users/hri611/python/nnUnet_raw/Dataset219_PETCT/labelsTr/PETCT_e52eca67d7_03132006.nii.gz,0.0,6.618623153686523,0.0
830,,0,0,,45440000,0,0,0,/well/papiez/users/hri611/python/nnUNet_results/Dataset219_PETCT/nnUNetTrainer_1500epochs_1e2lr__nnUNetPlans__3d_fullres_maxnum_512_patch_192/crossval_results_folds_0_1_2_3_4/PETCT_e5b1d6b4bd_10232004.nii.gz,/well/papiez/users/hri611/python/nnUnet_raw/Dataset219_PETCT/labelsTr/PETCT_e5b1d6b4bd_10232004.nii.gz,,0.0,0.0
831,,0,0,,92320000,0,0,0,/well/papiez/users/hri611/python/nnUNet_results/Dataset219_PETCT/nnUNetTrainer_1500epochs_1e2lr__nnUNetPlans__3d_fullres_maxnum_512_patch_192/crossval_results_folds_0_1_2_3_4/PETCT_e5c7be07a8_04082005.nii.gz,/well/papiez/users/hri611/python/nnUnet_raw/Dataset219_PETCT/labelsTr/PETCT_e5c7be07a8_04082005.nii.gz,,0.0,0.0
832,,0,0,,54080000,0,0,0,/well/papiez/users/hri611/python/nnUNet_results/Dataset219_PETCT/nnUNetTrainer_1500epochs_1e2lr__nnUNetPlans__3d_fullres_maxnum_512_patch_192/crossval_results_folds_0_1_2_3_4/PETCT_e5d50c5569_08242006.nii.gz,/well/papiez/users/hri611/python/nnUnet_raw/Dataset219_PETCT/labelsTr/PETCT_e5d50c5569_08242006.nii.gz,,0.0,0.0
833,,0,0,,45440000,0,0,0,/well/papiez/users/hri611/python/nnUNet_results/Dataset219_PETCT/nnUNetTrainer_1500epochs_1e2lr__nnUNetPlans__3d_fullres_maxnum_512_patch_192/crossval_results_folds_0_1_2_3_4/PETCT_e5e1918765_07242003.nii.gz,/well/papiez/users/hri611/python/nnUnet_raw/Dataset219_PETCT/labelsTr/PETCT_e5e1918765_07242003.nii.gz,,0.0,0.0
834,0.9430316212146562,1008,354,0.8922041946972695,52147365,11273,11627,12281,/well/papiez/users/hri611/python/nnUNet_results/Dataset219_PETCT/nnUNetTrainer_1500epochs_1e2lr__nnUNetPlans__3d_fullres_maxnum_512_patch_192/crossval_results_folds_0_1_2_3_4/PETCT_e61c9da258_12132002.nii.gz,/well/papiez/users/hri611/python/nnUnet_raw/Dataset219_PETCT/labelsTr/PETCT_e61c9da258_12132002.nii.gz,0.9430316212146562,0.9330765724182128,0.024882041931152343
835,0.0,0,195,0.0,51839805,0,195,0,/well/papiez/users/hri611/python/nnUNet_results/Dataset219_PETCT/nnUNetTrainer_1500epochs_1e2lr__nnUNetPlans__3d_fullres_maxnum_512_patch_192/crossval_results_folds_0_1_2_3_4/PETCT_e664932bbc_06092007.nii.gz,/well/papiez/users/hri611/python/nnUnet_raw/Dataset219_PETCT/labelsTr/PETCT_e664932bbc_06092007.nii.gz,0.0,2.4259990882873534,0.0
836,,0,0,,51200000,0,0,0,/well/papiez/users/hri611/python/nnUNet_results/Dataset219_PETCT/nnUNetTrainer_1500epochs_1e2lr__nnUNetPlans__3d_fullres_maxnum_512_patch_192/crossval_results_folds_0_1_2_3_4/PETCT_e68c4577d8_05252007.nii.gz,/well/papiez/users/hri611/python/nnUnet_raw/Dataset219_PETCT/labelsTr/PETCT_e68c4577d8_05252007.nii.gz,,0.0,0.0
837,0.0,0,783,0.0,48159217,0,783,0,/well/papiez/users/hri611/python/nnUNet_results/Dataset219_PETCT/nnUNetTrainer_1500epochs_1e2lr__nnUNetPlans__3d_fullres_maxnum_512_patch_192/crossval_results_folds_0_1_2_3_4/PETCT_e6a91fef70_03022006.nii.gz,/well/papiez/users/hri611/python/nnUnet_raw/Dataset219_PETCT/labelsTr/PETCT_e6a91fef70_03022006.nii.gz,0.0,9.741319416046142,0.0
838,0.0,0,119,0.0,44479881,0,119,0,/well/papiez/users/hri611/python/nnUNet_results/Dataset219_PETCT/nnUNetTrainer_1500epochs_1e2lr__nnUNetPlans__3d_fullres_maxnum_512_patch_192/crossval_results_folds_0_1_2_3_4/PETCT_e6f6c84ec5_11052005.nii.gz,/well/papiez/users/hri611/python/nnUnet_raw/Dataset219_PETCT/labelsTr/PETCT_e6f6c84ec5_11052005.nii.gz,0.0,1.4804814949035645,0.0
839,0.8857962522126595,2359,3254,0.7950038347759395,46372619,21768,25022,24127,/well/papiez/users/hri611/python/nnUNet_results/Dataset219_PETCT/nnUNetTrainer_1500epochs_1e2lr__nnUNetPlans__3d_fullres_maxnum_512_patch_192/crossval_results_folds_0_1_2_3_4/PETCT_e77124b7f4_09292005.nii.gz,/well/papiez/users/hri611/python/nnUnet_raw/Dataset219_PETCT/labelsTr/PETCT_e77124b7f4_09292005.nii.gz,0.8857962522126595,2.2891478576660154,0.012441020965576172
840,0.8488662471281591,1372,141,0.7374175633460603,52154238,4249,4390,5621,/well/papiez/users/hri611/python/nnUNet_results/Dataset219_PETCT/nnUNetTrainer_1500epochs_1e2lr__nnUNetPlans__3d_fullres_maxnum_512_patch_192/crossval_results_folds_0_1_2_3_4/PETCT_e77c5fca12_10282002.nii.gz,/well/papiez/users/hri611/python/nnUnet_raw/Dataset219_PETCT/labelsTr/PETCT_e77c5fca12_10282002.nii.gz,0.8488662471281591,0.0,7.875166271209717
841,0.6764705882352942,88,0,0.5111111111111111,89759820,92,92,180,/well/papiez/users/hri611/python/nnUNet_results/Dataset219_PETCT/nnUNetTrainer_1500epochs_1e2lr__nnUNetPlans__3d_fullres_maxnum_512_patch_192/crossval_results_folds_0_1_2_3_4/PETCT_e79291780d_05142007.nii.gz,/well/papiez/users/hri611/python/nnUnet_raw/Dataset219_PETCT/labelsTr/PETCT_e79291780d_05142007.nii.gz,0.6764705882352942,0.0,0.0
842,,0,0,,49920000,0,0,0,/well/papiez/users/hri611/python/nnUNet_results/Dataset219_PETCT/nnUNetTrainer_1500epochs_1e2lr__nnUNetPlans__3d_fullres_maxnum_512_patch_192/crossval_results_folds_0_1_2_3_4/PETCT_e8624bab41_07072007.nii.gz,/well/papiez/users/hri611/python/nnUnet_raw/Dataset219_PETCT/labelsTr/PETCT_e8624bab41_07072007.nii.gz,,0.0,0.0
843,0.0,0,7,0.0,85599993,0,7,0,/well/papiez/users/hri611/python/nnUNet_results/Dataset219_PETCT/nnUNetTrainer_1500epochs_1e2lr__nnUNetPlans__3d_fullres_maxnum_512_patch_192/crossval_results_folds_0_1_2_3_4/PETCT_e90a287d09_02242003.nii.gz,/well/papiez/users/hri611/python/nnUnet_raw/Dataset219_PETCT/labelsTr/PETCT_e90a287d09_02242003.nii.gz,0.0,0.0870871467590332,0.0
844,0.0,0,297,0.0,92319703,0,297,0,/well/papiez/users/hri611/python/nnUNet_results/Dataset219_PETCT/nnUNetTrainer_1500epochs_1e2lr__nnUNetPlans__3d_fullres_maxnum_512_patch_192/crossval_results_folds_0_1_2_3_4/PETCT_e90a287d09_08222002.nii.gz,/well/papiez/users/hri611/python/nnUnet_raw/Dataset219_PETCT/labelsTr/PETCT_e90a287d09_08222002.nii.gz,0.0,3.694983226776123,0.0
845,0.7944596696540996,1412,1363,0.6590071270582453,105751862,5363,6726,6775,/well/papiez/users/hri611/python/nnUNet_results/Dataset219_PETCT/nnUNetTrainer_1500epochs_1e2lr__nnUNetPlans__3d_fullres_maxnum_512_patch_192/crossval_results_folds_0_1_2_3_4/PETCT_e9be8ec30f_12122002.nii.gz,/well/papiez/users/hri611/python/nnUnet_raw/Dataset219_PETCT/labelsTr/PETCT_e9be8ec30f_12122002.nii.gz,0.7944596696540996,4.267270191192627,4.2299471282958985
846,0.808422362825433,1431,416,0.6784470752089137,45434256,3897,4313,5328,/well/papiez/users/hri611/python/nnUNet_results/Dataset219_PETCT/nnUNetTrainer_1500epochs_1e2lr__nnUNetPlans__3d_fullres_maxnum_512_patch_192/crossval_results_folds_0_1_2_3_4/PETCT_e9e1a391b5_10112001.nii.gz,/well/papiez/users/hri611/python/nnUnet_raw/Dataset219_PETCT/labelsTr/PETCT_e9e1a391b5_10112001.nii.gz,0.808422362825433,0.0,0.0
847,0.0,0,2615,0.0,42397385,0,2615,0,/well/papiez/users/hri611/python/nnUNet_results/Dataset219_PETCT/nnUNetTrainer_1500epochs_1e2lr__nnUNetPlans__3d_fullres_maxnum_512_patch_192/crossval_results_folds_0_1_2_3_4/PETCT_e9feb1135e_07012005.nii.gz,/well/papiez/users/hri611/python/nnUnet_raw/Dataset219_PETCT/labelsTr/PETCT_e9feb1135e_07012005.nii.gz,0.0,32.53326982498169,0.0
848,,0,0,,44320000,0,0,0,/well/papiez/users/hri611/python/nnUNet_results/Dataset219_PETCT/nnUNetTrainer_1500epochs_1e2lr__nnUNetPlans__3d_fullres_maxnum_512_patch_192/crossval_results_folds_0_1_2_3_4/PETCT_e9feb1135e_09092005.nii.gz,/well/papiez/users/hri611/python/nnUnet_raw/Dataset219_PETCT/labelsTr/PETCT_e9feb1135e_09092005.nii.gz,,0.0,0.0
849,0.8896273196666837,7600,1036,0.8011970534069982,52116560,34804,35840,42404,/well/papiez/users/hri611/python/nnUNet_results/Dataset219_PETCT/nnUNetTrainer_1500epochs_1e2lr__nnUNetPlans__3d_fullres_maxnum_512_patch_192/crossval_results_folds_0_1_2_3_4/PETCT_ea0fd89f0f_10252003.nii.gz,/well/papiez/users/hri611/python/nnUnet_raw/Dataset219_PETCT/labelsTr/PETCT_ea0fd89f0f_10252003.nii.gz,0.8896273196666837,0.09952816772460937,3.2968705558776854
850,0.8926903748943803,12150,2328,0.8061795496532705,47125302,60220,62548,72370,/well/papiez/users/hri611/python/nnUNet_results/Dataset219_PETCT/nnUNetTrainer_1500epochs_1e2lr__nnUNetPlans__3d_fullres_maxnum_512_patch_192/crossval_results_folds_0_1_2_3_4/PETCT_ea42c88cc7_02262006.nii.gz,/well/papiez/users/hri611/python/nnUnet_raw/Dataset219_PETCT/labelsTr/PETCT_ea42c88cc7_02262006.nii.gz,0.8926903748943803,7.1909101181030275,2.5752913398742674
851,0.6944198405668733,5,2065,0.5318860244233379,51515578,2352,4417,2357,/well/papiez/users/hri611/python/nnUNet_results/Dataset219_PETCT/nnUNetTrainer_1500epochs_1e2lr__nnUNetPlans__3d_fullres_maxnum_512_patch_192/crossval_results_folds_0_1_2_3_4/PETCT_ea6c621616_08082005.nii.gz,/well/papiez/users/hri611/python/nnUnet_raw/Dataset219_PETCT/labelsTr/PETCT_ea6c621616_08082005.nii.gz,0.6944198405668733,3.8069524154663084,0.0
852,0.8313928417421302,373,409,0.7114391143911439,58877290,1928,2337,2301,/well/papiez/users/hri611/python/nnUNet_results/Dataset219_PETCT/nnUNetTrainer_1500epochs_1e2lr__nnUNetPlans__3d_fullres_maxnum_512_patch_192/crossval_results_folds_0_1_2_3_4/PETCT_ea9302fb0f_08232003.nii.gz,/well/papiez/users/hri611/python/nnUnet_raw/Dataset219_PETCT/labelsTr/PETCT_ea9302fb0f_08232003.nii.gz,0.8313928417421302,2.3015888786315917,1.4929225158691406
853,0.7941555651052857,3,476,0.6585887384176764,52158597,924,1400,927,/well/papiez/users/hri611/python/nnUNet_results/Dataset219_PETCT/nnUNetTrainer_1500epochs_1e2lr__nnUNetPlans__3d_fullres_maxnum_512_patch_192/crossval_results_folds_0_1_2_3_4/PETCT_eafa147e24_04182005.nii.gz,/well/papiez/users/hri611/python/nnUnet_raw/Dataset219_PETCT/labelsTr/PETCT_eafa147e24_04182005.nii.gz,0.7941555651052857,1.1445739288330077,0.0
854,0.0,0,21,0.0,52159979,0,21,0,/well/papiez/users/hri611/python/nnUNet_results/Dataset219_PETCT/nnUNetTrainer_1500epochs_1e2lr__nnUNetPlans__3d_fullres_maxnum_512_patch_192/crossval_results_folds_0_1_2_3_4/PETCT_ebaa30ba2e_04172003.nii.gz,/well/papiez/users/hri611/python/nnUnet_raw/Dataset219_PETCT/labelsTr/PETCT_ebaa30ba2e_04172003.nii.gz,0.0,0.26126144027709963,0.0
855,0.8886144436603152,422,1472,0.79955550851942,52150551,7555,9027,7977,/well/papiez/users/hri611/python/nnUNet_results/Dataset219_PETCT/nnUNetTrainer_1500epochs_1e2lr__nnUNetPlans__3d_fullres_maxnum_512_patch_192/crossval_results_folds_0_1_2_3_4/PETCT_ebb0045704_09272002.nii.gz,/well/papiez/users/hri611/python/nnUnet_raw/Dataset219_PETCT/labelsTr/PETCT_ebb0045704_09272002.nii.gz,0.8886144436603152,2.2767068367004395,0.04976408386230469
856,0.7600267379679144,0,718,0.6129380053908355,58878145,1137,1855,1137,/well/papiez/users/hri611/python/nnUNet_results/Dataset219_PETCT/nnUNetTrainer_1500epochs_1e2lr__nnUNetPlans__3d_fullres_maxnum_512_patch_192/crossval_results_folds_0_1_2_3_4/PETCT_ec581d49ef_01232003.nii.gz,/well/papiez/users/hri611/python/nnUnet_raw/Dataset219_PETCT/labelsTr/PETCT_ec581d49ef_01232003.nii.gz,0.7600267379679144,0.2737024612426758,0.0
857,0.8706600534147272,282,57,0.7709459459459459,52158520,1141,1198,1423,/well/papiez/users/hri611/python/nnUNet_results/Dataset219_PETCT/nnUNetTrainer_1500epochs_1e2lr__nnUNetPlans__3d_fullres_maxnum_512_patch_192/crossval_results_folds_0_1_2_3_4/PETCT_ec581d49ef_03252002.nii.gz,/well/papiez/users/hri611/python/nnUnet_raw/Dataset219_PETCT/labelsTr/PETCT_ec581d49ef_03252002.nii.gz,0.8706600534147272,0.0,0.16173327255249023
858,0.9208914375081454,766,448,0.8533816425120773,45431720,7066,7514,7832,/well/papiez/users/hri611/python/nnUNet_results/Dataset219_PETCT/nnUNetTrainer_1500epochs_1e2lr__nnUNetPlans__3d_fullres_maxnum_512_patch_192/crossval_results_folds_0_1_2_3_4/PETCT_ec6b934720_10252002.nii.gz,/well/papiez/users/hri611/python/nnUnet_raw/Dataset219_PETCT/labelsTr/PETCT_ec6b934720_10252002.nii.gz,0.9208914375081454,0.0,0.0
859,0.0,0,46,0.0,52159954,0,46,0,/well/papiez/users/hri611/python/nnUNet_results/Dataset219_PETCT/nnUNetTrainer_1500epochs_1e2lr__nnUNetPlans__3d_fullres_maxnum_512_patch_192/crossval_results_folds_0_1_2_3_4/PETCT_eca59074b9_07202002.nii.gz,/well/papiez/users/hri611/python/nnUnet_raw/Dataset219_PETCT/labelsTr/PETCT_eca59074b9_07202002.nii.gz,0.0,0.5722869644165038,0.0
860,0.843398943831013,140,8015,0.729204715258177,52129885,21960,29975,22100,/well/papiez/users/hri611/python/nnUNet_results/Dataset219_PETCT/nnUNetTrainer_1500epochs_1e2lr__nnUNetPlans__3d_fullres_maxnum_512_patch_192/crossval_results_folds_0_1_2_3_4/PETCT_ed9dca00d2_09252004.nii.gz,/well/papiez/users/hri611/python/nnUnet_raw/Dataset219_PETCT/labelsTr/PETCT_ed9dca00d2_09252004.nii.gz,0.843398943831013,5.8846029167175296,0.0870871467590332
861,,0,0,,56480000,0,0,0,/well/papiez/users/hri611/python/nnUNet_results/Dataset219_PETCT/nnUNetTrainer_1500epochs_1e2lr__nnUNetPlans__3d_fullres_maxnum_512_patch_192/crossval_results_folds_0_1_2_3_4/PETCT_eda00de6b0_06242006.nii.gz,/well/papiez/users/hri611/python/nnUnet_raw/Dataset219_PETCT/labelsTr/PETCT_eda00de6b0_06242006.nii.gz,,0.0,0.0
862,0.8000682593856655,4998,860,0.6667614767620457,45422421,11721,12581,16719,/well/papiez/users/hri611/python/nnUNet_results/Dataset219_PETCT/nnUNetTrainer_1500epochs_1e2lr__nnUNetPlans__3d_fullres_maxnum_512_patch_192/crossval_results_folds_0_1_2_3_4/PETCT_ede28cc3c2_01042001.nii.gz,/well/papiez/users/hri611/python/nnUnet_raw/Dataset219_PETCT/labelsTr/PETCT_ede28cc3c2_01042001.nii.gz,0.8000682593856655,0.5474049224853516,0.0
863,0.6587936755807144,3386,110,0.4911948770193567,52153129,3375,3485,6761,/well/papiez/users/hri611/python/nnUNet_results/Dataset219_PETCT/nnUNetTrainer_1500epochs_1e2lr__nnUNetPlans__3d_fullres_maxnum_512_patch_192/crossval_results_folds_0_1_2_3_4/PETCT_ee97822c60_03032003.nii.gz,/well/papiez/users/hri611/python/nnUnet_raw/Dataset219_PETCT/labelsTr/PETCT_ee97822c60_03032003.nii.gz,0.6587936755807144,0.8833124885559082,5.586018413543701
864,,0,0,,48160000,0,0,0,/well/papiez/users/hri611/python/nnUNet_results/Dataset219_PETCT/nnUNetTrainer_1500epochs_1e2lr__nnUNetPlans__3d_fullres_maxnum_512_patch_192/crossval_results_folds_0_1_2_3_4/PETCT_eee2ede9ad_11242006.nii.gz,/well/papiez/users/hri611/python/nnUnet_raw/Dataset219_PETCT/labelsTr/PETCT_eee2ede9ad_11242006.nii.gz,,0.0,0.0
865,0.8952915362756735,1984,927,0.8104324042719458,45424644,12445,13372,14429,/well/papiez/users/hri611/python/nnUNet_results/Dataset219_PETCT/nnUNetTrainer_1500epochs_1e2lr__nnUNetPlans__3d_fullres_maxnum_512_patch_192/crossval_results_folds_0_1_2_3_4/PETCT_eeeda112bb_06072003.nii.gz,/well/papiez/users/hri611/python/nnUnet_raw/Dataset219_PETCT/labelsTr/PETCT_eeeda112bb_06072003.nii.gz,0.8952915362756735,0.0,0.0
866,0.8155106298125594,27106,2963,0.6884913029515058,52063473,66458,69421,93564,/well/papiez/users/hri611/python/nnUNet_results/Dataset219_PETCT/nnUNetTrainer_1500epochs_1e2lr__nnUNetPlans__3d_fullres_maxnum_512_patch_192/crossval_results_folds_0_1_2_3_4/PETCT_ef9d41b836_05212001.nii.gz,/well/papiez/users/hri611/python/nnUnet_raw/Dataset219_PETCT/labelsTr/PETCT_ef9d41b836_05212001.nii.gz,0.8155106298125594,1.953240291595459,22.87903755569458
867,0.8322822822822823,1616,618,0.7127427028417127,45432223,5543,6161,7159,/well/papiez/users/hri611/python/nnUNet_results/Dataset219_PETCT/nnUNetTrainer_1500epochs_1e2lr__nnUNetPlans__3d_fullres_maxnum_512_patch_192/crossval_results_folds_0_1_2_3_4/PETCT_efd619ecbf_02232003.nii.gz,/well/papiez/users/hri611/python/nnUnet_raw/Dataset219_PETCT/labelsTr/PETCT_efd619ecbf_02232003.nii.gz,0.8322822822822823,4.391680400848388,0.0
868,0.7246708643388666,148,333,0.5682226211849192,45438886,633,966,781,/well/papiez/users/hri611/python/nnUNet_results/Dataset219_PETCT/nnUNetTrainer_1500epochs_1e2lr__nnUNetPlans__3d_fullres_maxnum_512_patch_192/crossval_results_folds_0_1_2_3_4/PETCT_f01e83894d_03242005.nii.gz,/well/papiez/users/hri611/python/nnUnet_raw/Dataset219_PETCT/labelsTr/PETCT_f01e83894d_03242005.nii.gz,0.7246708643388666,0.3856716499328613,1.7790659980773926
869,0.0,0,4251,0.0,92475749,0,4251,0,/well/papiez/users/hri611/python/nnUNet_results/Dataset219_PETCT/nnUNetTrainer_1500epochs_1e2lr__nnUNetPlans__3d_fullres_maxnum_512_patch_192/crossval_results_folds_0_1_2_3_4/PETCT_f068e22258_05142007.nii.gz,/well/papiez/users/hri611/python/nnUnet_raw/Dataset219_PETCT/labelsTr/PETCT_f068e22258_05142007.nii.gz,0.0,52.886780124664305,0.0
870,0.0,0,16,0.0,52159984,0,16,0,/well/papiez/users/hri611/python/nnUNet_results/Dataset219_PETCT/nnUNetTrainer_1500epochs_1e2lr__nnUNetPlans__3d_fullres_maxnum_512_patch_192/crossval_results_folds_0_1_2_3_4/PETCT_f0a1a38a3b_03272005.nii.gz,/well/papiez/users/hri611/python/nnUnet_raw/Dataset219_PETCT/labelsTr/PETCT_f0a1a38a3b_03272005.nii.gz,0.0,0.19905633544921875,0.0
871,,0,0,,52160000,0,0,0,/well/papiez/users/hri611/python/nnUNet_results/Dataset219_PETCT/nnUNetTrainer_1500epochs_1e2lr__nnUNetPlans__3d_fullres_maxnum_512_patch_192/crossval_results_folds_0_1_2_3_4/PETCT_f0e1b89b41_05172007.nii.gz,/well/papiez/users/hri611/python/nnUnet_raw/Dataset219_PETCT/labelsTr/PETCT_f0e1b89b41_05172007.nii.gz,,0.0,0.0
872,0.7226890756302521,2035,3146,0.5657894736842105,52148068,6751,9897,8786,/well/papiez/users/hri611/python/nnUNet_results/Dataset219_PETCT/nnUNetTrainer_1500epochs_1e2lr__nnUNetPlans__3d_fullres_maxnum_512_patch_192/crossval_results_folds_0_1_2_3_4/PETCT_f11f3d3692_10242003.nii.gz,/well/papiez/users/hri611/python/nnUnet_raw/Dataset219_PETCT/labelsTr/PETCT_f11f3d3692_10242003.nii.gz,0.7226890756302521,1.6173327255249024,9.007299179077147
873,0.8890024595138467,2532,943,0.8001840032200563,45422609,13916,14859,16448,/well/papiez/users/hri611/python/nnUNet_results/Dataset219_PETCT/nnUNetTrainer_1500epochs_1e2lr__nnUNetPlans__3d_fullres_maxnum_512_patch_192/crossval_results_folds_0_1_2_3_4/PETCT_f1501b1f45_03202005.nii.gz,/well/papiez/users/hri611/python/nnUnet_raw/Dataset219_PETCT/labelsTr/PETCT_f1501b1f45_03202005.nii.gz,0.8890024595138467,1.7541839561462402,1.443158432006836
874,0.0,0,862,0.0,72159138,0,862,0,/well/papiez/users/hri611/python/nnUNet_results/Dataset219_PETCT/nnUNetTrainer_1500epochs_1e2lr__nnUNetPlans__3d_fullres_maxnum_512_patch_192/crossval_results_folds_0_1_2_3_4/PETCT_f1594a7d8a_04252003.nii.gz,/well/papiez/users/hri611/python/nnUnet_raw/Dataset219_PETCT/labelsTr/PETCT_f1594a7d8a_04252003.nii.gz,0.0,10.72416007232666,0.0
875,,0,0,,47520000,0,0,0,/well/papiez/users/hri611/python/nnUNet_results/Dataset219_PETCT/nnUNetTrainer_1500epochs_1e2lr__nnUNetPlans__3d_fullres_maxnum_512_patch_192/crossval_results_folds_0_1_2_3_4/PETCT_f15b868db6_02032006.nii.gz,/well/papiez/users/hri611/python/nnUnet_raw/Dataset219_PETCT/labelsTr/PETCT_f15b868db6_02032006.nii.gz,,0.0,0.0
876,0.7430093209054593,791,174,0.5911016949152542,99037640,1395,1569,2186,/well/papiez/users/hri611/python/nnUNet_results/Dataset219_PETCT/nnUNetTrainer_1500epochs_1e2lr__nnUNetPlans__3d_fullres_maxnum_512_patch_192/crossval_results_folds_0_1_2_3_4/PETCT_f1ca0f7c4c_12222001.nii.gz,/well/papiez/users/hri611/python/nnUnet_raw/Dataset219_PETCT/labelsTr/PETCT_f1ca0f7c4c_12222001.nii.gz,0.7430093209054593,0.5474049224853516,1.530245578765869
877,0.909937254659537,3714,10855,0.8347567684054125,45351833,73598,84453,77312,/well/papiez/users/hri611/python/nnUNet_results/Dataset219_PETCT/nnUNetTrainer_1500epochs_1e2lr__nnUNetPlans__3d_fullres_maxnum_512_patch_192/crossval_results_folds_0_1_2_3_4/PETCT_f21755a99b_05052005.nii.gz,/well/papiez/users/hri611/python/nnUnet_raw/Dataset219_PETCT/labelsTr/PETCT_f21755a99b_05052005.nii.gz,0.909937254659537,0.3359075660705566,0.435435733795166
878,0.9277871376285366,8,2478,0.8653012570437798,105581544,15970,18448,15978,/well/papiez/users/hri611/python/nnUNet_results/Dataset219_PETCT/nnUNetTrainer_1500epochs_1e2lr__nnUNetPlans__3d_fullres_maxnum_512_patch_192/crossval_results_folds_0_1_2_3_4/PETCT_f24f3ce1da_09142001.nii.gz,/well/papiez/users/hri611/python/nnUnet_raw/Dataset219_PETCT/labelsTr/PETCT_f24f3ce1da_09142001.nii.gz,0.9277871376285366,1.4307174110412597,0.0
879,0.7605749486652977,1618,131,0.6136514247846255,52155473,2778,2909,4396,/well/papiez/users/hri611/python/nnUNet_results/Dataset219_PETCT/nnUNetTrainer_1500epochs_1e2lr__nnUNetPlans__3d_fullres_maxnum_512_patch_192/crossval_results_folds_0_1_2_3_4/PETCT_f2f28337ba_05032001.nii.gz,/well/papiez/users/hri611/python/nnUnet_raw/Dataset219_PETCT/labelsTr/PETCT_f2f28337ba_05032001.nii.gz,0.7605749486652977,0.0,0.7837843208312988
880,0.9263442180211147,101,499,0.8627944203064258,45435627,3773,4272,3874,/well/papiez/users/hri611/python/nnUNet_results/Dataset219_PETCT/nnUNetTrainer_1500epochs_1e2lr__nnUNetPlans__3d_fullres_maxnum_512_patch_192/crossval_results_folds_0_1_2_3_4/PETCT_f4668d2bdc_09042000.nii.gz,/well/papiez/users/hri611/python/nnUnet_raw/Dataset219_PETCT/labelsTr/PETCT_f4668d2bdc_09042000.nii.gz,0.9263442180211147,0.0,0.0
881,0.7972270363951474,79,155,0.6628242074927954,52159306,460,615,539,/well/papiez/users/hri611/python/nnUNet_results/Dataset219_PETCT/nnUNetTrainer_1500epochs_1e2lr__nnUNetPlans__3d_fullres_maxnum_512_patch_192/crossval_results_folds_0_1_2_3_4/PETCT_f47e31ceb5_07262003.nii.gz,/well/papiez/users/hri611/python/nnUnet_raw/Dataset219_PETCT/labelsTr/PETCT_f47e31ceb5_07262003.nii.gz,0.7972270363951474,1.2192200546264649,0.4478767547607422
882,0.7274149393820883,1183,211,0.5716041794714198,45436746,1860,2071,3043,/well/papiez/users/hri611/python/nnUNet_results/Dataset219_PETCT/nnUNetTrainer_1500epochs_1e2lr__nnUNetPlans__3d_fullres_maxnum_512_patch_192/crossval_results_folds_0_1_2_3_4/PETCT_f4813007a0_11252000.nii.gz,/well/papiez/users/hri611/python/nnUnet_raw/Dataset219_PETCT/labelsTr/PETCT_f4813007a0_11252000.nii.gz,0.7274149393820883,0.0,10.214078212738038
883,0.0,0,328,0.0,99039672,0,328,0,/well/papiez/users/hri611/python/nnUNet_results/Dataset219_PETCT/nnUNetTrainer_1500epochs_1e2lr__nnUNetPlans__3d_fullres_maxnum_512_patch_192/crossval_results_folds_0_1_2_3_4/PETCT_f4a5ebd915_10032003.nii.gz,/well/papiez/users/hri611/python/nnUnet_raw/Dataset219_PETCT/labelsTr/PETCT_f4a5ebd915_10032003.nii.gz,0.0,4.0806548767089845,0.0
884,0.897297943567671,2671,765,0.8137265531822617,52141554,15010,15775,17681,/well/papiez/users/hri611/python/nnUNet_results/Dataset219_PETCT/nnUNetTrainer_1500epochs_1e2lr__nnUNetPlans__3d_fullres_maxnum_512_patch_192/crossval_results_folds_0_1_2_3_4/PETCT_f5c2c09846_10282002.nii.gz,/well/papiez/users/hri611/python/nnUnet_raw/Dataset219_PETCT/labelsTr/PETCT_f5c2c09846_10282002.nii.gz,0.897297943567671,0.0,7.4024074745178225
885,0.7941245237866014,9721,5248,0.6585460434772691,92276161,28870,34118,38591,/well/papiez/users/hri611/python/nnUNet_results/Dataset219_PETCT/nnUNetTrainer_1500epochs_1e2lr__nnUNetPlans__3d_fullres_maxnum_512_patch_192/crossval_results_folds_0_1_2_3_4/PETCT_f5c9b0de6c_04022004.nii.gz,/well/papiez/users/hri611/python/nnUnet_raw/Dataset219_PETCT/labelsTr/PETCT_f5c9b0de6c_04022004.nii.gz,0.7941245237866014,38.46763682556152,9.281001640319824
886,0.0,0,24,0.0,65279976,0,24,0,/well/papiez/users/hri611/python/nnUNet_results/Dataset219_PETCT/nnUNetTrainer_1500epochs_1e2lr__nnUNetPlans__3d_fullres_maxnum_512_patch_192/crossval_results_folds_0_1_2_3_4/PETCT_f5cff2e59d_05102007.nii.gz,/well/papiez/users/hri611/python/nnUnet_raw/Dataset219_PETCT/labelsTr/PETCT_f5cff2e59d_05102007.nii.gz,0.0,0.2985845031738281,0.0
887,,0,0,,52160000,0,0,0,/well/papiez/users/hri611/python/nnUNet_results/Dataset219_PETCT/nnUNetTrainer_1500epochs_1e2lr__nnUNetPlans__3d_fullres_maxnum_512_patch_192/crossval_results_folds_0_1_2_3_4/PETCT_f603eeceba_03172003.nii.gz,/well/papiez/users/hri611/python/nnUnet_raw/Dataset219_PETCT/labelsTr/PETCT_f603eeceba_03172003.nii.gz,,0.0,0.0
888,0.8743980550750385,9087,1659,0.7768270648584661,52111849,37405,39064,46492,/well/papiez/users/hri611/python/nnUNet_results/Dataset219_PETCT/nnUNetTrainer_1500epochs_1e2lr__nnUNetPlans__3d_fullres_maxnum_512_patch_192/crossval_results_folds_0_1_2_3_4/PETCT_f60ea3abc5_05032003.nii.gz,/well/papiez/users/hri611/python/nnUnet_raw/Dataset219_PETCT/labelsTr/PETCT_f60ea3abc5_05032003.nii.gz,0.8743980550750385,0.0,1.6297737464904785
889,0.0,0,9789,0.0,47190211,0,9789,0,/well/papiez/users/hri611/python/nnUNet_results/Dataset219_PETCT/nnUNetTrainer_1500epochs_1e2lr__nnUNetPlans__3d_fullres_maxnum_512_patch_192/crossval_results_folds_0_1_2_3_4/PETCT_f6295a93a6_10092006.nii.gz,/well/papiez/users/hri611/python/nnUnet_raw/Dataset219_PETCT/labelsTr/PETCT_f6295a93a6_10092006.nii.gz,0.0,121.78515423202515,0.0
890,0.8814814814814815,22,10,0.7880794701986755,92319849,119,129,141,/well/papiez/users/hri611/python/nnUNet_results/Dataset219_PETCT/nnUNetTrainer_1500epochs_1e2lr__nnUNetPlans__3d_fullres_maxnum_512_patch_192/crossval_results_folds_0_1_2_3_4/PETCT_f637b5930b_07272003.nii.gz,/well/papiez/users/hri611/python/nnUnet_raw/Dataset219_PETCT/labelsTr/PETCT_f637b5930b_07272003.nii.gz,0.8814814814814815,0.0,0.0
891,0.0,0,32,0.0,52159968,0,32,0,/well/papiez/users/hri611/python/nnUNet_results/Dataset219_PETCT/nnUNetTrainer_1500epochs_1e2lr__nnUNetPlans__3d_fullres_maxnum_512_patch_192/crossval_results_folds_0_1_2_3_4/PETCT_f650c87621_03112005.nii.gz,/well/papiez/users/hri611/python/nnUnet_raw/Dataset219_PETCT/labelsTr/PETCT_f650c87621_03112005.nii.gz,0.0,0.3981126708984375,0.0
892,,0,0,,47520000,0,0,0,/well/papiez/users/hri611/python/nnUNet_results/Dataset219_PETCT/nnUNetTrainer_1500epochs_1e2lr__nnUNetPlans__3d_fullres_maxnum_512_patch_192/crossval_results_folds_0_1_2_3_4/PETCT_f650c87621_12082005.nii.gz,/well/papiez/users/hri611/python/nnUnet_raw/Dataset219_PETCT/labelsTr/PETCT_f650c87621_12082005.nii.gz,,0.0,0.0
893,0.8631685507001856,754,868,0.759275749480558,52313262,5116,5984,5870,/well/papiez/users/hri611/python/nnUNet_results/Dataset219_PETCT/nnUNetTrainer_1500epochs_1e2lr__nnUNetPlans__3d_fullres_maxnum_512_patch_192/crossval_results_folds_0_1_2_3_4/PETCT_f65602d938_03252007.nii.gz,/well/papiez/users/hri611/python/nnUnet_raw/Dataset219_PETCT/labelsTr/PETCT_f65602d938_03252007.nii.gz,0.8631685507001856,2.4882041931152346,3.620337100982666
894,0.7313703820650458,5825,981,0.5765042623358845,52143929,9265,10246,15090,/well/papiez/users/hri611/python/nnUNet_results/Dataset219_PETCT/nnUNetTrainer_1500epochs_1e2lr__nnUNetPlans__3d_fullres_maxnum_512_patch_192/crossval_results_folds_0_1_2_3_4/PETCT_f7067b7bbb_05262001.nii.gz,/well/papiez/users/hri611/python/nnUnet_raw/Dataset219_PETCT/labelsTr/PETCT_f7067b7bbb_05262001.nii.gz,0.7313703820650458,0.0,21.099971557617188
895,0.0,0,4,0.0,52159996,0,4,0,/well/papiez/users/hri611/python/nnUNet_results/Dataset219_PETCT/nnUNetTrainer_1500epochs_1e2lr__nnUNetPlans__3d_fullres_maxnum_512_patch_192/crossval_results_folds_0_1_2_3_4/PETCT_f75d25523c_09132002.nii.gz,/well/papiez/users/hri611/python/nnUnet_raw/Dataset219_PETCT/labelsTr/PETCT_f75d25523c_09132002.nii.gz,0.0,0.04976408386230469,0.0
896,0.0,0,363,0.0,52159637,0,363,0,/well/papiez/users/hri611/python/nnUNet_results/Dataset219_PETCT/nnUNetTrainer_1500epochs_1e2lr__nnUNetPlans__3d_fullres_maxnum_512_patch_192/crossval_results_folds_0_1_2_3_4/PETCT_f7a9267a69_02012003.nii.gz,/well/papiez/users/hri611/python/nnUnet_raw/Dataset219_PETCT/labelsTr/PETCT_f7a9267a69_02012003.nii.gz,0.0,4.5160906105041505,0.0
897,0.0,0,227,0.0,52159773,0,227,0,/well/papiez/users/hri611/python/nnUNet_results/Dataset219_PETCT/nnUNetTrainer_1500epochs_1e2lr__nnUNetPlans__3d_fullres_maxnum_512_patch_192/crossval_results_folds_0_1_2_3_4/PETCT_f7a9267a69_11012002.nii.gz,/well/papiez/users/hri611/python/nnUnet_raw/Dataset219_PETCT/labelsTr/PETCT_f7a9267a69_11012002.nii.gz,0.0,2.824111759185791,0.0
898,,0,0,,45440000,0,0,0,/well/papiez/users/hri611/python/nnUNet_results/Dataset219_PETCT/nnUNetTrainer_1500epochs_1e2lr__nnUNetPlans__3d_fullres_maxnum_512_patch_192/crossval_results_folds_0_1_2_3_4/PETCT_f8314eb3f7_03142003.nii.gz,/well/papiez/users/hri611/python/nnUnet_raw/Dataset219_PETCT/labelsTr/PETCT_f8314eb3f7_03142003.nii.gz,,0.0,0.0
899,0.0,0,5243,0.0,45434757,0,5243,0,/well/papiez/users/hri611/python/nnUNet_results/Dataset219_PETCT/nnUNetTrainer_1500epochs_1e2lr__nnUNetPlans__3d_fullres_maxnum_512_patch_192/crossval_results_folds_0_1_2_3_4/PETCT_f8314eb3f7_09202003.nii.gz,/well/papiez/users/hri611/python/nnUnet_raw/Dataset219_PETCT/labelsTr/PETCT_f8314eb3f7_09202003.nii.gz,0.0,65.22827292251587,0.0
900,,0,0,,52320000,0,0,0,/well/papiez/users/hri611/python/nnUNet_results/Dataset219_PETCT/nnUNetTrainer_1500epochs_1e2lr__nnUNetPlans__3d_fullres_maxnum_512_patch_192/crossval_results_folds_0_1_2_3_4/PETCT_f8aac0e202_02262006.nii.gz,/well/papiez/users/hri611/python/nnUnet_raw/Dataset219_PETCT/labelsTr/PETCT_f8aac0e202_02262006.nii.gz,,0.0,0.0
901,,0,0,,50880000,0,0,0,/well/papiez/users/hri611/python/nnUNet_results/Dataset219_PETCT/nnUNetTrainer_1500epochs_1e2lr__nnUNetPlans__3d_fullres_maxnum_512_patch_192/crossval_results_folds_0_1_2_3_4/PETCT_f8aac0e202_07302006.nii.gz,/well/papiez/users/hri611/python/nnUnet_raw/Dataset219_PETCT/labelsTr/PETCT_f8aac0e202_07302006.nii.gz,,0.0,0.0
902,,0,0,,53440000,0,0,0,/well/papiez/users/hri611/python/nnUNet_results/Dataset219_PETCT/nnUNetTrainer_1500epochs_1e2lr__nnUNetPlans__3d_fullres_maxnum_512_patch_192/crossval_results_folds_0_1_2_3_4/PETCT_f8de0cde56_12052005.nii.gz,/well/papiez/users/hri611/python/nnUnet_raw/Dataset219_PETCT/labelsTr/PETCT_f8de0cde56_12052005.nii.gz,,0.0,0.0
903,0.7403138889981513,45,13159,0.5876971116315378,63487975,18821,31980,18866,/well/papiez/users/hri611/python/nnUNet_results/Dataset219_PETCT/nnUNetTrainer_1500epochs_1e2lr__nnUNetPlans__3d_fullres_maxnum_512_patch_192/crossval_results_folds_0_1_2_3_4/PETCT_f9c4d4f9ab_03222007.nii.gz,/well/papiez/users/hri611/python/nnUnet_raw/Dataset219_PETCT/labelsTr/PETCT_f9c4d4f9ab_03222007.nii.gz,0.7403138889981513,6.369802734375,0.0
904,0.9651053127947187,51,60,0.9325637910085055,52158354,1535,1595,1586,/well/papiez/users/hri611/python/nnUNet_results/Dataset219_PETCT/nnUNetTrainer_1500epochs_1e2lr__nnUNetPlans__3d_fullres_maxnum_512_patch_192/crossval_results_folds_0_1_2_3_4/PETCT_f9e0c504af_06292003.nii.gz,/well/papiez/users/hri611/python/nnUnet_raw/Dataset219_PETCT/labelsTr/PETCT_f9e0c504af_06292003.nii.gz,0.9651053127947187,0.0,0.012441020965576172
905,,0,0,,45440000,0,0,0,/well/papiez/users/hri611/python/nnUNet_results/Dataset219_PETCT/nnUNetTrainer_1500epochs_1e2lr__nnUNetPlans__3d_fullres_maxnum_512_patch_192/crossval_results_folds_0_1_2_3_4/PETCT_fa45f610c4_10072004.nii.gz,/well/papiez/users/hri611/python/nnUnet_raw/Dataset219_PETCT/labelsTr/PETCT_fa45f610c4_10072004.nii.gz,,0.0,0.0
906,0.631424375917768,3010,2,0.4613733905579399,52154408,2580,2582,5590,/well/papiez/users/hri611/python/nnUNet_results/Dataset219_PETCT/nnUNetTrainer_1500epochs_1e2lr__nnUNetPlans__3d_fullres_maxnum_512_patch_192/crossval_results_folds_0_1_2_3_4/PETCT_faf4a6dbaa_01102003.nii.gz,/well/papiez/users/hri611/python/nnUnet_raw/Dataset219_PETCT/labelsTr/PETCT_faf4a6dbaa_01102003.nii.gz,0.631424375917768,0.0,5.013731449127198
907,0.3955781296683597,0,2023,0.24655493482309124,47997315,662,2685,662,/well/papiez/users/hri611/python/nnUNet_results/Dataset219_PETCT/nnUNetTrainer_1500epochs_1e2lr__nnUNetPlans__3d_fullres_maxnum_512_patch_192/crossval_results_folds_0_1_2_3_4/PETCT_fb014a1ea0_12012005.nii.gz,/well/papiez/users/hri611/python/nnUnet_raw/Dataset219_PETCT/labelsTr/PETCT_fb014a1ea0_12012005.nii.gz,0.3955781296683597,0.0,0.0
908,0.0,737,313,0.0,45438950,0,313,737,/well/papiez/users/hri611/python/nnUNet_results/Dataset219_PETCT/nnUNetTrainer_1500epochs_1e2lr__nnUNetPlans__3d_fullres_maxnum_512_patch_192/crossval_results_folds_0_1_2_3_4/PETCT_fbd907a179_10042003.nii.gz,/well/papiez/users/hri611/python/nnUnet_raw/Dataset219_PETCT/labelsTr/PETCT_fbd907a179_10042003.nii.gz,0.0,3.8940395622253416,9.169032451629638
909,0.0,0,80,0.0,95519920,0,80,0,/well/papiez/users/hri611/python/nnUNet_results/Dataset219_PETCT/nnUNetTrainer_1500epochs_1e2lr__nnUNetPlans__3d_fullres_maxnum_512_patch_192/crossval_results_folds_0_1_2_3_4/PETCT_fc0389a486_05302005.nii.gz,/well/papiez/users/hri611/python/nnUnet_raw/Dataset219_PETCT/labelsTr/PETCT_fc0389a486_05302005.nii.gz,0.0,0.9952816772460937,0.0
910,0.885167067407346,910,475,0.793990777926521,99033277,5338,5813,6248,/well/papiez/users/hri611/python/nnUNet_results/Dataset219_PETCT/nnUNetTrainer_1500epochs_1e2lr__nnUNetPlans__3d_fullres_maxnum_512_patch_192/crossval_results_folds_0_1_2_3_4/PETCT_fcdbe15200_12142003.nii.gz,/well/papiez/users/hri611/python/nnUnet_raw/Dataset219_PETCT/labelsTr/PETCT_fcdbe15200_12142003.nii.gz,0.885167067407346,0.0,0.06220510482788086
911,0.5961783439490446,257,60,0.4246823956442831,47839449,234,294,491,/well/papiez/users/hri611/python/nnUNet_results/Dataset219_PETCT/nnUNetTrainer_1500epochs_1e2lr__nnUNetPlans__3d_fullres_maxnum_512_patch_192/crossval_results_folds_0_1_2_3_4/PETCT_fde66dd53a_12222005.nii.gz,/well/papiez/users/hri611/python/nnUnet_raw/Dataset219_PETCT/labelsTr/PETCT_fde66dd53a_12222005.nii.gz,0.5961783439490446,0.0,3.0107270736694334
912,,0,0,,92320000,0,0,0,/well/papiez/users/hri611/python/nnUNet_results/Dataset219_PETCT/nnUNetTrainer_1500epochs_1e2lr__nnUNetPlans__3d_fullres_maxnum_512_patch_192/crossval_results_folds_0_1_2_3_4/PETCT_fde79b6aa9_02232003.nii.gz,/well/papiez/users/hri611/python/nnUnet_raw/Dataset219_PETCT/labelsTr/PETCT_fde79b6aa9_02232003.nii.gz,,0.0,0.0
913,0.9023941068139963,68,674,0.8221476510067114,92315828,3430,4104,3498,/well/papiez/users/hri611/python/nnUNet_results/Dataset219_PETCT/nnUNetTrainer_1500epochs_1e2lr__nnUNetPlans__3d_fullres_maxnum_512_patch_192/crossval_results_folds_0_1_2_3_4/PETCT_fde79b6aa9_05092005.nii.gz,/well/papiez/users/hri611/python/nnUnet_raw/Dataset219_PETCT/labelsTr/PETCT_fde79b6aa9_05092005.nii.gz,0.9023941068139963,2.2269427528381347,0.0
914,,0,0,,92320000,0,0,0,/well/papiez/users/hri611/python/nnUNet_results/Dataset219_PETCT/nnUNetTrainer_1500epochs_1e2lr__nnUNetPlans__3d_fullres_maxnum_512_patch_192/crossval_results_folds_0_1_2_3_4/PETCT_fde79b6aa9_08162003.nii.gz,/well/papiez/users/hri611/python/nnUnet_raw/Dataset219_PETCT/labelsTr/PETCT_fde79b6aa9_08162003.nii.gz,,0.0,0.0
915,0.0,0,299,0.0,45439701,0,299,0,/well/papiez/users/hri611/python/nnUNet_results/Dataset219_PETCT/nnUNetTrainer_1500epochs_1e2lr__nnUNetPlans__3d_fullres_maxnum_512_patch_192/crossval_results_folds_0_1_2_3_4/PETCT_fe705ea1cc_04272003.nii.gz,/well/papiez/users/hri611/python/nnUnet_raw/Dataset219_PETCT/labelsTr/PETCT_fe705ea1cc_04272003.nii.gz,0.0,3.7198652687072755,0.0
916,0.7627927905407095,5809,3680,0.6165440879334034,45415254,15257,18937,21066,/well/papiez/users/hri611/python/nnUNet_results/Dataset219_PETCT/nnUNetTrainer_1500epochs_1e2lr__nnUNetPlans__3d_fullres_maxnum_512_patch_192/crossval_results_folds_0_1_2_3_4/PETCT_fe705ea1cc_12292002.nii.gz,/well/papiez/users/hri611/python/nnUnet_raw/Dataset219_PETCT/labelsTr/PETCT_fe705ea1cc_12292002.nii.gz,0.7627927905407095,2.724583591461182,31.16475751876831
917,,0,0,,52160000,0,0,0,/well/papiez/users/hri611/python/nnUNet_results/Dataset219_PETCT/nnUNetTrainer_1500epochs_1e2lr__nnUNetPlans__3d_fullres_maxnum_512_patch_192/crossval_results_folds_0_1_2_3_4/PETCT_ff1451316e_03312003.nii.gz,/well/papiez/users/hri611/python/nnUnet_raw/Dataset219_PETCT/labelsTr/PETCT_ff1451316e_03312003.nii.gz,,0.0,0.0
918,,0,0,,86080000,0,0,0,/well/papiez/users/hri611/python/nnUNet_results/Dataset219_PETCT/nnUNetTrainer_1500epochs_1e2lr__nnUNetPlans__3d_fullres_maxnum_512_patch_192/crossval_results_folds_0_1_2_3_4/PETCT_ff39795341_09222005.nii.gz,/well/papiez/users/hri611/python/nnUnet_raw/Dataset219_PETCT/labelsTr/PETCT_ff39795341_09222005.nii.gz,,0.0,0.0
