,DICE,FN,FP,IoU,TN,TP,n_pred,n_ref,prediction_file,reference_file,challenge_DICE,challenge_FP,challenge_FN
0,0.43089430894308944,928,52,0.27461139896373055,52158649,371,423,1299,/well/papiez/users/hri611/python/nnUNet_results/Dataset219_PETCT/nnUNetTrainer__nnUNetPlans__3d_fullres_maxnum_512_patch_192/crossval_results_folds_0_1_2/PETCT_0011f3deaf_03232003.nii.gz,/well/papiez/users/hri611/python/nnUnet_raw/Dataset219_PETCT/labelsTr/PETCT_0011f3deaf_03232003.nii.gz,0.43089430894308944,0.4478767547607422,10.151873107910156
1,0.682301242096767,6845,240,0.517797590689444,45425307,7608,7848,14453,/well/papiez/users/hri611/python/nnUNet_results/Dataset219_PETCT/nnUNetTrainer__nnUNetPlans__3d_fullres_maxnum_512_patch_192/crossval_results_folds_0_1_2/PETCT_0117d7f11f_09132001.nii.gz,/well/papiez/users/hri611/python/nnUnet_raw/Dataset219_PETCT/labelsTr/PETCT_0117d7f11f_09132001.nii.gz,0.682301242096767,0.0,0.09952816772460937
2,0.0,0,9,0.0,46079991,0,9,0,/well/papiez/users/hri611/python/nnUNet_results/Dataset219_PETCT/nnUNetTrainer__nnUNetPlans__3d_fullres_maxnum_512_patch_192/crossval_results_folds_0_1_2/PETCT_0143bab87a_07172005.nii.gz,/well/papiez/users/hri611/python/nnUnet_raw/Dataset219_PETCT/labelsTr/PETCT_0143bab87a_07172005.nii.gz,0.0,0.11196918869018554,0.0
3,0.5486779209777939,7259,200,0.3780538647544401,52148007,4534,4734,11793,/well/papiez/users/hri611/python/nnUNet_results/Dataset219_PETCT/nnUNetTrainer__nnUNetPlans__3d_fullres_maxnum_512_patch_192/crossval_results_folds_0_1_2/PETCT_01682f60c3_03112002.nii.gz,/well/papiez/users/hri611/python/nnUnet_raw/Dataset219_PETCT/labelsTr/PETCT_01682f60c3_03112002.nii.gz,0.5486779209777939,0.0,46.765797809600826
4,0.7619047619047619,0,5,0.6153846153846154,99039987,8,13,8,/well/papiez/users/hri611/python/nnUNet_results/Dataset219_PETCT/nnUNetTrainer__nnUNetPlans__3d_fullres_maxnum_512_patch_192/crossval_results_folds_0_1_2/PETCT_0223010e46_09042003.nii.gz,/well/papiez/users/hri611/python/nnUnet_raw/Dataset219_PETCT/labelsTr/PETCT_0223010e46_09042003.nii.gz,0.7619047619047619,0.0,0.0
5,,0,0,,37120000,0,0,0,/well/papiez/users/hri611/python/nnUNet_results/Dataset219_PETCT/nnUNetTrainer__nnUNetPlans__3d_fullres_maxnum_512_patch_192/crossval_results_folds_0_1_2/PETCT_0225325b91_08222005.nii.gz,/well/papiez/users/hri611/python/nnUnet_raw/Dataset219_PETCT/labelsTr/PETCT_0225325b91_08222005.nii.gz,,0.0,0.0
6,0.0,0,934,0.0,45439066,0,934,0,/well/papiez/users/hri611/python/nnUNet_results/Dataset219_PETCT/nnUNetTrainer__nnUNetPlans__3d_fullres_maxnum_512_patch_192/crossval_results_folds_0_1_2/PETCT_0410759456_08222003.nii.gz,/well/papiez/users/hri611/python/nnUnet_raw/Dataset219_PETCT/labelsTr/PETCT_0410759456_08222003.nii.gz,0.0,11.619913581848145,0.0
7,,0,0,,45440000,0,0,0,/well/papiez/users/hri611/python/nnUNet_results/Dataset219_PETCT/nnUNetTrainer__nnUNetPlans__3d_fullres_maxnum_512_patch_192/crossval_results_folds_0_1_2/PETCT_0410759456_11072002.nii.gz,/well/papiez/users/hri611/python/nnUnet_raw/Dataset219_PETCT/labelsTr/PETCT_0410759456_11072002.nii.gz,,0.0,0.0
8,0.7488265735948971,185,6076,0.5984994228549442,45424406,9333,15409,9518,/well/papiez/users/hri611/python/nnUNet_results/Dataset219_PETCT/nnUNetTrainer__nnUNetPlans__3d_fullres_maxnum_512_patch_192/crossval_results_folds_0_1_2/PETCT_04606080a0_02202003.nii.gz,/well/papiez/users/hri611/python/nnUnet_raw/Dataset219_PETCT/labelsTr/PETCT_04606080a0_02202003.nii.gz,0.7488265735948971,14.730168823242188,0.0
9,0.8612813876401944,484,2571,0.7563601563123056,45427461,9484,12055,9968,/well/papiez/users/hri611/python/nnUNet_results/Dataset219_PETCT/nnUNetTrainer__nnUNetPlans__3d_fullres_maxnum_512_patch_192/crossval_results_folds_0_1_2/PETCT_04a4e1c874_11182001.nii.gz,/well/papiez/users/hri611/python/nnUnet_raw/Dataset219_PETCT/labelsTr/PETCT_04a4e1c874_11182001.nii.gz,0.8612813876401944,23.314473289489747,0.0
10,0.0,0,62,0.0,51839938,0,62,0,/well/papiez/users/hri611/python/nnUNet_results/Dataset219_PETCT/nnUNetTrainer__nnUNetPlans__3d_fullres_maxnum_512_patch_192/crossval_results_folds_0_1_2/PETCT_05808cf24e_03182006.nii.gz,/well/papiez/users/hri611/python/nnUnet_raw/Dataset219_PETCT/labelsTr/PETCT_05808cf24e_03182006.nii.gz,0.0,0.7713432998657226,0.0
11,0.8768939393939394,0,130,0.7807757166947723,40639407,463,593,463,/well/papiez/users/hri611/python/nnUNet_results/Dataset219_PETCT/nnUNetTrainer__nnUNetPlans__3d_fullres_maxnum_512_patch_192/crossval_results_folds_0_1_2/PETCT_06a46414eb_03122006.nii.gz,/well/papiez/users/hri611/python/nnUnet_raw/Dataset219_PETCT/labelsTr/PETCT_06a46414eb_03122006.nii.gz,0.8768939393939394,0.37323062896728515,0.0
12,,0,0,,38720000,0,0,0,/well/papiez/users/hri611/python/nnUNet_results/Dataset219_PETCT/nnUNetTrainer__nnUNetPlans__3d_fullres_maxnum_512_patch_192/crossval_results_folds_0_1_2/PETCT_06d55e8295_04172003.nii.gz,/well/papiez/users/hri611/python/nnUnet_raw/Dataset219_PETCT/labelsTr/PETCT_06d55e8295_04172003.nii.gz,,0.0,0.0
13,0.5722253206915784,7734,1470,0.40078125,45424640,6156,7626,13890,/well/papiez/users/hri611/python/nnUNet_results/Dataset219_PETCT/nnUNetTrainer__nnUNetPlans__3d_fullres_maxnum_512_patch_192/crossval_results_folds_0_1_2/PETCT_06e7c24059_04222005.nii.gz,/well/papiez/users/hri611/python/nnUnet_raw/Dataset219_PETCT/labelsTr/PETCT_06e7c24059_04222005.nii.gz,0.5722253206915784,4.180183044433594,69.20939963150025
14,0.0,0,2697,0.0,38877303,0,2697,0,/well/papiez/users/hri611/python/nnUNet_results/Dataset219_PETCT/nnUNetTrainer__nnUNetPlans__3d_fullres_maxnum_512_patch_192/crossval_results_folds_0_1_2/PETCT_072833774e_07232006.nii.gz,/well/papiez/users/hri611/python/nnUnet_raw/Dataset219_PETCT/labelsTr/PETCT_072833774e_07232006.nii.gz,0.0,33.553433544158935,0.0
15,0.9182422022467325,5631,2382,0.8488426930259757,45386989,44998,47380,50629,/well/papiez/users/hri611/python/nnUNet_results/Dataset219_PETCT/nnUNetTrainer__nnUNetPlans__3d_fullres_maxnum_512_patch_192/crossval_results_folds_0_1_2/PETCT_07574bfa00_04202003.nii.gz,/well/papiez/users/hri611/python/nnUnet_raw/Dataset219_PETCT/labelsTr/PETCT_07574bfa00_04202003.nii.gz,0.9182422022467325,0.0,0.3359075660705566
16,,0,0,,45440000,0,0,0,/well/papiez/users/hri611/python/nnUNet_results/Dataset219_PETCT/nnUNetTrainer__nnUNetPlans__3d_fullres_maxnum_512_patch_192/crossval_results_folds_0_1_2/PETCT_07b7e9abfc_02102003.nii.gz,/well/papiez/users/hri611/python/nnUnet_raw/Dataset219_PETCT/labelsTr/PETCT_07b7e9abfc_02102003.nii.gz,,0.0,0.0
17,0.0,0,115,0.0,41439885,0,115,0,/well/papiez/users/hri611/python/nnUNet_results/Dataset219_PETCT/nnUNetTrainer__nnUNetPlans__3d_fullres_maxnum_512_patch_192/crossval_results_folds_0_1_2/PETCT_080922db5a_01282006.nii.gz,/well/papiez/users/hri611/python/nnUnet_raw/Dataset219_PETCT/labelsTr/PETCT_080922db5a_01282006.nii.gz,0.0,1.4307174110412597,0.0
18,,0,0,,49440000,0,0,0,/well/papiez/users/hri611/python/nnUNet_results/Dataset219_PETCT/nnUNetTrainer__nnUNetPlans__3d_fullres_maxnum_512_patch_192/crossval_results_folds_0_1_2/PETCT_08198c4f0c_11102005.nii.gz,/well/papiez/users/hri611/python/nnUnet_raw/Dataset219_PETCT/labelsTr/PETCT_08198c4f0c_11102005.nii.gz,,0.0,0.0
19,0.0,0,422,0.0,52159578,0,422,0,/well/papiez/users/hri611/python/nnUNet_results/Dataset219_PETCT/nnUNetTrainer__nnUNetPlans__3d_fullres_maxnum_512_patch_192/crossval_results_folds_0_1_2/PETCT_098c4b7b87_08312003.nii.gz,/well/papiez/users/hri611/python/nnUnet_raw/Dataset219_PETCT/labelsTr/PETCT_098c4b7b87_08312003.nii.gz,0.0,5.250110847473144,0.0
20,0.731986531986532,1842,1342,0.5772703133297928,94872468,4348,5690,6190,/well/papiez/users/hri611/python/nnUNet_results/Dataset219_PETCT/nnUNetTrainer__nnUNetPlans__3d_fullres_maxnum_512_patch_192/crossval_results_folds_0_1_2/PETCT_09ee00bdc6_09302005.nii.gz,/well/papiez/users/hri611/python/nnUnet_raw/Dataset219_PETCT/labelsTr/PETCT_09ee00bdc6_09302005.nii.gz,0.731986531986532,0.3981126708984375,20.639653781890868
21,0.8195545594621095,3014,3427,0.6942756787545092,52138932,14627,18054,17641,/well/papiez/users/hri611/python/nnUNet_results/Dataset219_PETCT/nnUNetTrainer__nnUNetPlans__3d_fullres_maxnum_512_patch_192/crossval_results_folds_0_1_2/PETCT_0b57b247b6_05022002.nii.gz,/well/papiez/users/hri611/python/nnUnet_raw/Dataset219_PETCT/labelsTr/PETCT_0b57b247b6_05022002.nii.gz,0.8195545594621095,2.724583591461182,0.0
22,0.8669541062390292,6003,1804,0.7651535661643053,52126757,25436,27240,31439,/well/papiez/users/hri611/python/nnUNet_results/Dataset219_PETCT/nnUNetTrainer__nnUNetPlans__3d_fullres_maxnum_512_patch_192/crossval_results_folds_0_1_2/PETCT_0b98dbe00d_08112002.nii.gz,/well/papiez/users/hri611/python/nnUnet_raw/Dataset219_PETCT/labelsTr/PETCT_0b98dbe00d_08112002.nii.gz,0.8669541062390292,0.0,3.8069524154663084
23,,0,0,,52160000,0,0,0,/well/papiez/users/hri611/python/nnUNet_results/Dataset219_PETCT/nnUNetTrainer__nnUNetPlans__3d_fullres_maxnum_512_patch_192/crossval_results_folds_0_1_2/PETCT_0c13e4df10_10112003.nii.gz,/well/papiez/users/hri611/python/nnUnet_raw/Dataset219_PETCT/labelsTr/PETCT_0c13e4df10_10112003.nii.gz,,0.0,0.0
24,0.7960119641076769,3836,256,0.6611460748592249,45427924,7984,8240,11820,/well/papiez/users/hri611/python/nnUNet_results/Dataset219_PETCT/nnUNetTrainer__nnUNetPlans__3d_fullres_maxnum_512_patch_192/crossval_results_folds_0_1_2/PETCT_0e2034240b_01312003.nii.gz,/well/papiez/users/hri611/python/nnUnet_raw/Dataset219_PETCT/labelsTr/PETCT_0e2034240b_01312003.nii.gz,0.7960119641076769,0.0,1.1072508659362792
25,,0,0,,46080000,0,0,0,/well/papiez/users/hri611/python/nnUNet_results/Dataset219_PETCT/nnUNetTrainer__nnUNetPlans__3d_fullres_maxnum_512_patch_192/crossval_results_folds_0_1_2/PETCT_0fa313309d_10032005.nii.gz,/well/papiez/users/hri611/python/nnUnet_raw/Dataset219_PETCT/labelsTr/PETCT_0fa313309d_10032005.nii.gz,,0.0,0.0
26,0.8218527315914489,49,26,0.6975806451612904,54079752,173,199,222,/well/papiez/users/hri611/python/nnUNet_results/Dataset219_PETCT/nnUNetTrainer__nnUNetPlans__3d_fullres_maxnum_512_patch_192/crossval_results_folds_0_1_2/PETCT_1019ae8551_04062007.nii.gz,/well/papiez/users/hri611/python/nnUnet_raw/Dataset219_PETCT/labelsTr/PETCT_1019ae8551_04062007.nii.gz,0.8218527315914489,0.19905633544921875,0.0
27,0.7971311475409836,198,0,0.6626916524701874,52159413,389,389,587,/well/papiez/users/hri611/python/nnUNet_results/Dataset219_PETCT/nnUNetTrainer__nnUNetPlans__3d_fullres_maxnum_512_patch_192/crossval_results_folds_0_1_2/PETCT_12025abab5_11012004.nii.gz,/well/papiez/users/hri611/python/nnUnet_raw/Dataset219_PETCT/labelsTr/PETCT_12025abab5_11012004.nii.gz,0.7971311475409836,0.0,0.0
28,0.9128205128205128,174,455,0.839622641509434,104476078,3293,3748,3467,/well/papiez/users/hri611/python/nnUNet_results/Dataset219_PETCT/nnUNetTrainer__nnUNetPlans__3d_fullres_maxnum_512_patch_192/crossval_results_folds_0_1_2/PETCT_1253499c80_10072005.nii.gz,/well/papiez/users/hri611/python/nnUnet_raw/Dataset219_PETCT/labelsTr/PETCT_1253499c80_10072005.nii.gz,0.9128205128205128,3.93136262512207,0.0
29,0.6571316977318209,81612,3539,0.48934932533733133,47833250,81599,85138,163211,/well/papiez/users/hri611/python/nnUNet_results/Dataset219_PETCT/nnUNetTrainer__nnUNetPlans__3d_fullres_maxnum_512_patch_192/crossval_results_folds_0_1_2/PETCT_1285b86bea_02242006.nii.gz,/well/papiez/users/hri611/python/nnUnet_raw/Dataset219_PETCT/labelsTr/PETCT_1285b86bea_02242006.nii.gz,0.6571316977318209,5.225228805541992,313.3768771018982
30,,0,0,,105760000,0,0,0,/well/papiez/users/hri611/python/nnUNet_results/Dataset219_PETCT/nnUNetTrainer__nnUNetPlans__3d_fullres_maxnum_512_patch_192/crossval_results_folds_0_1_2/PETCT_141fffa2a9_03012003.nii.gz,/well/papiez/users/hri611/python/nnUnet_raw/Dataset219_PETCT/labelsTr/PETCT_141fffa2a9_03012003.nii.gz,,0.0,0.0
31,0.8343915011315062,8825,1713,0.7158419846299042,52122915,26547,28260,35372,/well/papiez/users/hri611/python/nnUNet_results/Dataset219_PETCT/nnUNetTrainer__nnUNetPlans__3d_fullres_maxnum_512_patch_192/crossval_results_folds_0_1_2/PETCT_1472967bef_12212002.nii.gz,/well/papiez/users/hri611/python/nnUnet_raw/Dataset219_PETCT/labelsTr/PETCT_1472967bef_12212002.nii.gz,0.8343915011315062,0.0,0.0
32,0.8963987181498331,3418,1205,0.812248710555172,52135377,20000,21205,23418,/well/papiez/users/hri611/python/nnUNet_results/Dataset219_PETCT/nnUNetTrainer__nnUNetPlans__3d_fullres_maxnum_512_patch_192/crossval_results_folds_0_1_2/PETCT_147a9fcff3_08162001.nii.gz,/well/papiez/users/hri611/python/nnUnet_raw/Dataset219_PETCT/labelsTr/PETCT_147a9fcff3_08162001.nii.gz,0.8963987181498331,0.06220510482788086,3.9935677299499512
33,,0,0,,45440000,0,0,0,/well/papiez/users/hri611/python/nnUNet_results/Dataset219_PETCT/nnUNetTrainer__nnUNetPlans__3d_fullres_maxnum_512_patch_192/crossval_results_folds_0_1_2/PETCT_14929994cf_04302005.nii.gz,/well/papiez/users/hri611/python/nnUnet_raw/Dataset219_PETCT/labelsTr/PETCT_14929994cf_04302005.nii.gz,,0.0,0.0
34,0.7788032152426317,734,9,0.6377376889322282,52157949,1308,1317,2042,/well/papiez/users/hri611/python/nnUNet_results/Dataset219_PETCT/nnUNetTrainer__nnUNetPlans__3d_fullres_maxnum_512_patch_192/crossval_results_folds_0_1_2/PETCT_14c4d2c208_09222002.nii.gz,/well/papiez/users/hri611/python/nnUnet_raw/Dataset219_PETCT/labelsTr/PETCT_14c4d2c208_09222002.nii.gz,0.7788032152426317,0.0,2.898757884979248
35,0.837716872014081,2980,247,0.7207511249567324,52148444,8329,8576,11309,/well/papiez/users/hri611/python/nnUNet_results/Dataset219_PETCT/nnUNetTrainer__nnUNetPlans__3d_fullres_maxnum_512_patch_192/crossval_results_folds_0_1_2/PETCT_154e94256c_11252000.nii.gz,/well/papiez/users/hri611/python/nnUnet_raw/Dataset219_PETCT/labelsTr/PETCT_154e94256c_11252000.nii.gz,0.837716872014081,1.6297737464904785,0.0
36,0.9053038633531266,5316,5018,0.826991009693459,45380269,49397,54415,54713,/well/papiez/users/hri611/python/nnUNet_results/Dataset219_PETCT/nnUNetTrainer__nnUNetPlans__3d_fullres_maxnum_512_patch_192/crossval_results_folds_0_1_2/PETCT_15cfa01130_02242001.nii.gz,/well/papiez/users/hri611/python/nnUnet_raw/Dataset219_PETCT/labelsTr/PETCT_15cfa01130_02242001.nii.gz,0.9053038633531266,1.1321329078674316,0.0
37,0.8992472495657209,2407,29,0.8169384534455549,45426693,10871,10900,13278,/well/papiez/users/hri611/python/nnUNet_results/Dataset219_PETCT/nnUNetTrainer__nnUNetPlans__3d_fullres_maxnum_512_patch_192/crossval_results_folds_0_1_2/PETCT_15f4b7254f_07182003.nii.gz,/well/papiez/users/hri611/python/nnUnet_raw/Dataset219_PETCT/labelsTr/PETCT_15f4b7254f_07182003.nii.gz,0.8992472495657209,0.037323062896728515,9.629350227355957
38,0.8521739130434782,0,17,0.7424242424242424,45439934,49,66,49,/well/papiez/users/hri611/python/nnUNet_results/Dataset219_PETCT/nnUNetTrainer__nnUNetPlans__3d_fullres_maxnum_512_patch_192/crossval_results_folds_0_1_2/PETCT_15f4b7254f_10112003.nii.gz,/well/papiez/users/hri611/python/nnUnet_raw/Dataset219_PETCT/labelsTr/PETCT_15f4b7254f_10112003.nii.gz,0.8521739130434782,0.0,0.0
39,0.0,0,42,0.0,92319958,0,42,0,/well/papiez/users/hri611/python/nnUNet_results/Dataset219_PETCT/nnUNetTrainer__nnUNetPlans__3d_fullres_maxnum_512_patch_192/crossval_results_folds_0_1_2/PETCT_173b804eda_10112004.nii.gz,/well/papiez/users/hri611/python/nnUnet_raw/Dataset219_PETCT/labelsTr/PETCT_173b804eda_10112004.nii.gz,0.0,0.5225228805541993,0.0
40,,0,0,,43840000,0,0,0,/well/papiez/users/hri611/python/nnUNet_results/Dataset219_PETCT/nnUNetTrainer__nnUNetPlans__3d_fullres_maxnum_512_patch_192/crossval_results_folds_0_1_2/PETCT_176bdc5388_06222006.nii.gz,/well/papiez/users/hri611/python/nnUnet_raw/Dataset219_PETCT/labelsTr/PETCT_176bdc5388_06222006.nii.gz,,0.0,0.0
41,0.0,0,90,0.0,49119910,0,90,0,/well/papiez/users/hri611/python/nnUNet_results/Dataset219_PETCT/nnUNetTrainer__nnUNetPlans__3d_fullres_maxnum_512_patch_192/crossval_results_folds_0_1_2/PETCT_1774857f8e_11232006.nii.gz,/well/papiez/users/hri611/python/nnUnet_raw/Dataset219_PETCT/labelsTr/PETCT_1774857f8e_11232006.nii.gz,0.0,1.1196918869018555,0.0
42,0.0,0,54,0.0,45439946,0,54,0,/well/papiez/users/hri611/python/nnUNet_results/Dataset219_PETCT/nnUNetTrainer__nnUNetPlans__3d_fullres_maxnum_512_patch_192/crossval_results_folds_0_1_2/PETCT_1781ba966c_08082002.nii.gz,/well/papiez/users/hri611/python/nnUnet_raw/Dataset219_PETCT/labelsTr/PETCT_1781ba966c_08082002.nii.gz,0.0,0.6718151321411132,0.0
43,,0,0,,38720000,0,0,0,/well/papiez/users/hri611/python/nnUNet_results/Dataset219_PETCT/nnUNetTrainer__nnUNetPlans__3d_fullres_maxnum_512_patch_192/crossval_results_folds_0_1_2/PETCT_17b46d7275_11132003.nii.gz,/well/papiez/users/hri611/python/nnUnet_raw/Dataset219_PETCT/labelsTr/PETCT_17b46d7275_11132003.nii.gz,,0.0,0.0
44,0.0,0,444,0.0,49439556,0,444,0,/well/papiez/users/hri611/python/nnUNet_results/Dataset219_PETCT/nnUNetTrainer__nnUNetPlans__3d_fullres_maxnum_512_patch_192/crossval_results_folds_0_1_2/PETCT_182bdeba22_05102007.nii.gz,/well/papiez/users/hri611/python/nnUnet_raw/Dataset219_PETCT/labelsTr/PETCT_182bdeba22_05102007.nii.gz,0.0,5.5238133087158205,0.0
45,0.7783505154639175,0,258,0.6371308016877637,52319289,453,711,453,/well/papiez/users/hri611/python/nnUNet_results/Dataset219_PETCT/nnUNetTrainer__nnUNetPlans__3d_fullres_maxnum_512_patch_192/crossval_results_folds_0_1_2/PETCT_18e8b02af3_08142005.nii.gz,/well/papiez/users/hri611/python/nnUnet_raw/Dataset219_PETCT/labelsTr/PETCT_18e8b02af3_08142005.nii.gz,0.7783505154639175,2.699701549530029,0.0
46,0.0,0,251,0.0,99039749,0,251,0,/well/papiez/users/hri611/python/nnUNet_results/Dataset219_PETCT/nnUNetTrainer__nnUNetPlans__3d_fullres_maxnum_512_patch_192/crossval_results_folds_0_1_2/PETCT_1928952a0f_06202003.nii.gz,/well/papiez/users/hri611/python/nnUnet_raw/Dataset219_PETCT/labelsTr/PETCT_1928952a0f_06202003.nii.gz,0.0,3.1226962623596193,0.0
47,,0,0,,38720000,0,0,0,/well/papiez/users/hri611/python/nnUNet_results/Dataset219_PETCT/nnUNetTrainer__nnUNetPlans__3d_fullres_maxnum_512_patch_192/crossval_results_folds_0_1_2/PETCT_193dea6ac7_04102003.nii.gz,/well/papiez/users/hri611/python/nnUnet_raw/Dataset219_PETCT/labelsTr/PETCT_193dea6ac7_04102003.nii.gz,,0.0,0.0
48,0.5381555153707053,1701,4684,0.3681345868381989,52149895,3720,8404,5421,/well/papiez/users/hri611/python/nnUNet_results/Dataset219_PETCT/nnUNetTrainer__nnUNetPlans__3d_fullres_maxnum_512_patch_192/crossval_results_folds_0_1_2/PETCT_1a1712f7d0_07052001.nii.gz,/well/papiez/users/hri611/python/nnUnet_raw/Dataset219_PETCT/labelsTr/PETCT_1a1712f7d0_07052001.nii.gz,0.5381555153707053,56.83058377075195,4.628059799194336
49,,0,0,,45120000,0,0,0,/well/papiez/users/hri611/python/nnUNet_results/Dataset219_PETCT/nnUNetTrainer__nnUNetPlans__3d_fullres_maxnum_512_patch_192/crossval_results_folds_0_1_2/PETCT_1a8bd52f71_05052006.nii.gz,/well/papiez/users/hri611/python/nnUnet_raw/Dataset219_PETCT/labelsTr/PETCT_1a8bd52f71_05052006.nii.gz,,0.0,0.0
50,0.57801766437684,171,689,0.4064872325741891,58878551,589,1278,760,/well/papiez/users/hri611/python/nnUNet_results/Dataset219_PETCT/nnUNetTrainer__nnUNetPlans__3d_fullres_maxnum_512_patch_192/crossval_results_folds_0_1_2/PETCT_1a90052cb2_06222001.nii.gz,/well/papiez/users/hri611/python/nnUnet_raw/Dataset219_PETCT/labelsTr/PETCT_1a90052cb2_06222001.nii.gz,0.57801766437684,8.273278942108155,0.0
51,,0,0,,45440000,0,0,0,/well/papiez/users/hri611/python/nnUNet_results/Dataset219_PETCT/nnUNetTrainer__nnUNetPlans__3d_fullres_maxnum_512_patch_192/crossval_results_folds_0_1_2/PETCT_1ac497ed9d_10282004.nii.gz,/well/papiez/users/hri611/python/nnUnet_raw/Dataset219_PETCT/labelsTr/PETCT_1ac497ed9d_10282004.nii.gz,,0.0,0.0
52,0.8871284140636789,1068,1924,0.7971525423728814,52145250,11758,13682,12826,/well/papiez/users/hri611/python/nnUNet_results/Dataset219_PETCT/nnUNetTrainer__nnUNetPlans__3d_fullres_maxnum_512_patch_192/crossval_results_folds_0_1_2/PETCT_1b1bdfc35b_10292000.nii.gz,/well/papiez/users/hri611/python/nnUnet_raw/Dataset219_PETCT/labelsTr/PETCT_1b1bdfc35b_10292000.nii.gz,0.8871284140636789,2.8365527801513672,2.5752913398742674
53,0.8046071858346227,10195,1171,0.6730901978831109,52125232,23402,24573,33597,/well/papiez/users/hri611/python/nnUNet_results/Dataset219_PETCT/nnUNetTrainer__nnUNetPlans__3d_fullres_maxnum_512_patch_192/crossval_results_folds_0_1_2/PETCT_1bb48bfb40_12022000.nii.gz,/well/papiez/users/hri611/python/nnUnet_raw/Dataset219_PETCT/labelsTr/PETCT_1bb48bfb40_12022000.nii.gz,0.8046071858346227,3.76962935256958,13.16260018157959
54,,0,0,,47520000,0,0,0,/well/papiez/users/hri611/python/nnUNet_results/Dataset219_PETCT/nnUNetTrainer__nnUNetPlans__3d_fullres_maxnum_512_patch_192/crossval_results_folds_0_1_2/PETCT_1f2a4f4280_06122005.nii.gz,/well/papiez/users/hri611/python/nnUnet_raw/Dataset219_PETCT/labelsTr/PETCT_1f2a4f4280_06122005.nii.gz,,0.0,0.0
55,0.6551724137931034,20,0,0.48717948717948717,105759961,19,19,39,/well/papiez/users/hri611/python/nnUNet_results/Dataset219_PETCT/nnUNetTrainer__nnUNetPlans__3d_fullres_maxnum_512_patch_192/crossval_results_folds_0_1_2/PETCT_1f65acff65_05062007.nii.gz,/well/papiez/users/hri611/python/nnUnet_raw/Dataset219_PETCT/labelsTr/PETCT_1f65acff65_05062007.nii.gz,0.6551724137931034,0.0,0.0
56,0.8758215962441315,0,1058,0.7790770515765295,52155211,3731,4789,3731,/well/papiez/users/hri611/python/nnUNet_results/Dataset219_PETCT/nnUNetTrainer__nnUNetPlans__3d_fullres_maxnum_512_patch_192/crossval_results_folds_0_1_2/PETCT_1fc35d02da_08092003.nii.gz,/well/papiez/users/hri611/python/nnUnet_raw/Dataset219_PETCT/labelsTr/PETCT_1fc35d02da_08092003.nii.gz,0.8758215962441315,0.0,0.0
57,0.8426818329293662,830,7413,0.7281332453825857,52129680,22077,29490,22907,/well/papiez/users/hri611/python/nnUNet_results/Dataset219_PETCT/nnUNetTrainer__nnUNetPlans__3d_fullres_maxnum_512_patch_192/crossval_results_folds_0_1_2/PETCT_1fe6e48293_06262003.nii.gz,/well/papiez/users/hri611/python/nnUnet_raw/Dataset219_PETCT/labelsTr/PETCT_1fe6e48293_06262003.nii.gz,0.8426818329293662,4.466326526641845,0.1741742935180664
58,0.8984105044920525,0,147,0.8155583437892095,55199203,650,797,650,/well/papiez/users/hri611/python/nnUNet_results/Dataset219_PETCT/nnUNetTrainer__nnUNetPlans__3d_fullres_maxnum_512_patch_192/crossval_results_folds_0_1_2/PETCT_20995a0fe1_12022005.nii.gz,/well/papiez/users/hri611/python/nnUnet_raw/Dataset219_PETCT/labelsTr/PETCT_20995a0fe1_12022005.nii.gz,0.8984105044920525,0.0,0.0
59,,0,0,,45440000,0,0,0,/well/papiez/users/hri611/python/nnUNet_results/Dataset219_PETCT/nnUNetTrainer__nnUNetPlans__3d_fullres_maxnum_512_patch_192/crossval_results_folds_0_1_2/PETCT_20f4a3aa02_03172005.nii.gz,/well/papiez/users/hri611/python/nnUnet_raw/Dataset219_PETCT/labelsTr/PETCT_20f4a3aa02_03172005.nii.gz,,0.0,0.0
60,0.0,0,106,0.0,43519894,0,106,0,/well/papiez/users/hri611/python/nnUNet_results/Dataset219_PETCT/nnUNetTrainer__nnUNetPlans__3d_fullres_maxnum_512_patch_192/crossval_results_folds_0_1_2/PETCT_2122b88719_09092006.nii.gz,/well/papiez/users/hri611/python/nnUnet_raw/Dataset219_PETCT/labelsTr/PETCT_2122b88719_09092006.nii.gz,0.0,1.3187482223510743,0.0
61,0.10468602358760193,76557,192,0.055234132650549016,54638764,4487,4679,81044,/well/papiez/users/hri611/python/nnUNet_results/Dataset219_PETCT/nnUNetTrainer__nnUNetPlans__3d_fullres_maxnum_512_patch_192/crossval_results_folds_0_1_2/PETCT_2140db0ca5_04132007.nii.gz,/well/papiez/users/hri611/python/nnUnet_raw/Dataset219_PETCT/labelsTr/PETCT_2140db0ca5_04132007.nii.gz,0.10468602358760193,0.32346654510498046,403.46230991363524
62,0.8815586419753086,500,114,0.788202828561573,52157101,2285,2399,2785,/well/papiez/users/hri611/python/nnUNet_results/Dataset219_PETCT/nnUNetTrainer__nnUNetPlans__3d_fullres_maxnum_512_patch_192/crossval_results_folds_0_1_2/PETCT_21853fc15b_10122002.nii.gz,/well/papiez/users/hri611/python/nnUnet_raw/Dataset219_PETCT/labelsTr/PETCT_21853fc15b_10122002.nii.gz,0.8815586419753086,0.0,0.012441020965576172
63,0.8244051963217048,1343,1063,0.7012664514526943,45431946,5648,6711,6991,/well/papiez/users/hri611/python/nnUNet_results/Dataset219_PETCT/nnUNetTrainer__nnUNetPlans__3d_fullres_maxnum_512_patch_192/crossval_results_folds_0_1_2/PETCT_2202a936e0_05312002.nii.gz,/well/papiez/users/hri611/python/nnUnet_raw/Dataset219_PETCT/labelsTr/PETCT_2202a936e0_05312002.nii.gz,0.8244051963217048,0.024882041931152343,10.587308841705322
64,,0,0,,51840000,0,0,0,/well/papiez/users/hri611/python/nnUNet_results/Dataset219_PETCT/nnUNetTrainer__nnUNetPlans__3d_fullres_maxnum_512_patch_192/crossval_results_folds_0_1_2/PETCT_234f8427c0_12032005.nii.gz,/well/papiez/users/hri611/python/nnUnet_raw/Dataset219_PETCT/labelsTr/PETCT_234f8427c0_12032005.nii.gz,,0.0,0.0
65,,0,0,,45440000,0,0,0,/well/papiez/users/hri611/python/nnUNet_results/Dataset219_PETCT/nnUNetTrainer__nnUNetPlans__3d_fullres_maxnum_512_patch_192/crossval_results_folds_0_1_2/PETCT_234f8427c0_12092004.nii.gz,/well/papiez/users/hri611/python/nnUnet_raw/Dataset219_PETCT/labelsTr/PETCT_234f8427c0_12092004.nii.gz,,0.0,0.0
66,0.3111111111111111,44,142,0.18421052631578946,92319772,42,184,86,/well/papiez/users/hri611/python/nnUNet_results/Dataset219_PETCT/nnUNetTrainer__nnUNetPlans__3d_fullres_maxnum_512_patch_192/crossval_results_folds_0_1_2/PETCT_23ed525e82_08012003.nii.gz,/well/papiez/users/hri611/python/nnUnet_raw/Dataset219_PETCT/labelsTr/PETCT_23ed525e82_08012003.nii.gz,0.3111111111111111,1.741742935180664,0.14929225158691406
67,,0,0,,99520000,0,0,0,/well/papiez/users/hri611/python/nnUNet_results/Dataset219_PETCT/nnUNetTrainer__nnUNetPlans__3d_fullres_maxnum_512_patch_192/crossval_results_folds_0_1_2/PETCT_2428b44e92_03222007.nii.gz,/well/papiez/users/hri611/python/nnUnet_raw/Dataset219_PETCT/labelsTr/PETCT_2428b44e92_03222007.nii.gz,,0.0,0.0
68,0.6161086076093777,26253,667,0.4452001154115659,52111478,21602,22269,47855,/well/papiez/users/hri611/python/nnUNet_results/Dataset219_PETCT/nnUNetTrainer__nnUNetPlans__3d_fullres_maxnum_512_patch_192/crossval_results_folds_0_1_2/PETCT_249c02c01c_03062003.nii.gz,/well/papiez/users/hri611/python/nnUnet_raw/Dataset219_PETCT/labelsTr/PETCT_249c02c01c_03062003.nii.gz,0.6161086076093777,0.09952816772460937,42.12529698944092
69,,0,0,,45440000,0,0,0,/well/papiez/users/hri611/python/nnUNet_results/Dataset219_PETCT/nnUNetTrainer__nnUNetPlans__3d_fullres_maxnum_512_patch_192/crossval_results_folds_0_1_2/PETCT_249c02c01c_07262003.nii.gz,/well/papiez/users/hri611/python/nnUnet_raw/Dataset219_PETCT/labelsTr/PETCT_249c02c01c_07262003.nii.gz,,0.0,0.0
70,,0,0,,72160000,0,0,0,/well/papiez/users/hri611/python/nnUNet_results/Dataset219_PETCT/nnUNetTrainer__nnUNetPlans__3d_fullres_maxnum_512_patch_192/crossval_results_folds_0_1_2/PETCT_24cb79a92b_04132003.nii.gz,/well/papiez/users/hri611/python/nnUnet_raw/Dataset219_PETCT/labelsTr/PETCT_24cb79a92b_04132003.nii.gz,,0.0,0.0
71,0.0,0,89,0.0,47839911,0,89,0,/well/papiez/users/hri611/python/nnUNet_results/Dataset219_PETCT/nnUNetTrainer__nnUNetPlans__3d_fullres_maxnum_512_patch_192/crossval_results_folds_0_1_2/PETCT_265c26907a_11102005.nii.gz,/well/papiez/users/hri611/python/nnUnet_raw/Dataset219_PETCT/labelsTr/PETCT_265c26907a_11102005.nii.gz,0.0,1.1072508659362792,0.0
72,,0,0,,58880000,0,0,0,/well/papiez/users/hri611/python/nnUNet_results/Dataset219_PETCT/nnUNetTrainer__nnUNetPlans__3d_fullres_maxnum_512_patch_192/crossval_results_folds_0_1_2/PETCT_2716c9bfff_10042003.nii.gz,/well/papiez/users/hri611/python/nnUnet_raw/Dataset219_PETCT/labelsTr/PETCT_2716c9bfff_10042003.nii.gz,,0.0,0.0
73,0.0,0,20,0.0,54559980,0,20,0,/well/papiez/users/hri611/python/nnUNet_results/Dataset219_PETCT/nnUNetTrainer__nnUNetPlans__3d_fullres_maxnum_512_patch_192/crossval_results_folds_0_1_2/PETCT_274688d0a8_03242007.nii.gz,/well/papiez/users/hri611/python/nnUnet_raw/Dataset219_PETCT/labelsTr/PETCT_274688d0a8_03242007.nii.gz,0.0,0.24882041931152343,0.0
74,0.46650637814733187,15532,444,0.3042114890466443,52137039,6985,7429,22517,/well/papiez/users/hri611/python/nnUNet_results/Dataset219_PETCT/nnUNetTrainer__nnUNetPlans__3d_fullres_maxnum_512_patch_192/crossval_results_folds_0_1_2/PETCT_27d69a8466_12162001.nii.gz,/well/papiez/users/hri611/python/nnUnet_raw/Dataset219_PETCT/labelsTr/PETCT_27d69a8466_12162001.nii.gz,0.46650637814733187,0.0,67.9777385559082
75,,0,0,,52160000,0,0,0,/well/papiez/users/hri611/python/nnUNet_results/Dataset219_PETCT/nnUNetTrainer__nnUNetPlans__3d_fullres_maxnum_512_patch_192/crossval_results_folds_0_1_2/PETCT_28a0a0a163_10222004.nii.gz,/well/papiez/users/hri611/python/nnUnet_raw/Dataset219_PETCT/labelsTr/PETCT_28a0a0a163_10222004.nii.gz,,0.0,0.0
76,0.7704172434249555,16,4628,0.6265680283049212,52147564,7792,12420,7808,/well/papiez/users/hri611/python/nnUNet_results/Dataset219_PETCT/nnUNetTrainer__nnUNetPlans__3d_fullres_maxnum_512_patch_192/crossval_results_folds_0_1_2/PETCT_29ab45ef17_06272002.nii.gz,/well/papiez/users/hri611/python/nnUnet_raw/Dataset219_PETCT/labelsTr/PETCT_29ab45ef17_06272002.nii.gz,0.7704172434249555,1.3311892433166503,0.09952816772460937
77,0.7630674002751031,1220,158,0.6169029747011399,45436403,2219,2377,3439,/well/papiez/users/hri611/python/nnUNet_results/Dataset219_PETCT/nnUNetTrainer__nnUNetPlans__3d_fullres_maxnum_512_patch_192/crossval_results_folds_0_1_2/PETCT_2a78eed085_12222001.nii.gz,/well/papiez/users/hri611/python/nnUnet_raw/Dataset219_PETCT/labelsTr/PETCT_2a78eed085_12222001.nii.gz,0.7630674002751031,0.0,13.983707565307617
78,0.0,0,750,0.0,31999250,0,750,0,/well/papiez/users/hri611/python/nnUNet_results/Dataset219_PETCT/nnUNetTrainer__nnUNetPlans__3d_fullres_maxnum_512_patch_192/crossval_results_folds_0_1_2/PETCT_2ad62beb52_03082003.nii.gz,/well/papiez/users/hri611/python/nnUnet_raw/Dataset219_PETCT/labelsTr/PETCT_2ad62beb52_03082003.nii.gz,0.0,9.330765724182129,0.0
79,0.8525484295655444,95,1473,0.7429929519750861,51033899,4533,6006,4628,/well/papiez/users/hri611/python/nnUNet_results/Dataset219_PETCT/nnUNetTrainer__nnUNetPlans__3d_fullres_maxnum_512_patch_192/crossval_results_folds_0_1_2/PETCT_2b29531d8c_10162005.nii.gz,/well/papiez/users/hri611/python/nnUnet_raw/Dataset219_PETCT/labelsTr/PETCT_2b29531d8c_10162005.nii.gz,0.8525484295655444,1.6795378303527833,1.1818969917297364
80,0.0,0,9,0.0,47839991,0,9,0,/well/papiez/users/hri611/python/nnUNet_results/Dataset219_PETCT/nnUNetTrainer__nnUNetPlans__3d_fullres_maxnum_512_patch_192/crossval_results_folds_0_1_2/PETCT_2b8064fbe2_06112006.nii.gz,/well/papiez/users/hri611/python/nnUnet_raw/Dataset219_PETCT/labelsTr/PETCT_2b8064fbe2_06112006.nii.gz,0.0,0.11196918869018554,0.0
81,0.8549019607843137,0,37,0.7465753424657534,43839854,109,146,109,/well/papiez/users/hri611/python/nnUNet_results/Dataset219_PETCT/nnUNetTrainer__nnUNetPlans__3d_fullres_maxnum_512_patch_192/crossval_results_folds_0_1_2/PETCT_2ce074c2ea_02042006.nii.gz,/well/papiez/users/hri611/python/nnUnet_raw/Dataset219_PETCT/labelsTr/PETCT_2ce074c2ea_02042006.nii.gz,0.8549019607843137,0.19905633544921875,0.0
82,0.6344410876132931,121,0,0.4646017699115044,94079774,105,105,226,/well/papiez/users/hri611/python/nnUNet_results/Dataset219_PETCT/nnUNetTrainer__nnUNetPlans__3d_fullres_maxnum_512_patch_192/crossval_results_folds_0_1_2/PETCT_2d70838805_04302007.nii.gz,/well/papiez/users/hri611/python/nnUnet_raw/Dataset219_PETCT/labelsTr/PETCT_2d70838805_04302007.nii.gz,0.6344410876132931,0.0,0.0
83,0.6664771111742963,1172,1,0.4997867803837953,45437655,1172,1173,2344,/well/papiez/users/hri611/python/nnUNet_results/Dataset219_PETCT/nnUNetTrainer__nnUNetPlans__3d_fullres_maxnum_512_patch_192/crossval_results_folds_0_1_2/PETCT_2dac5ef654_11042000.nii.gz,/well/papiez/users/hri611/python/nnUnet_raw/Dataset219_PETCT/labelsTr/PETCT_2dac5ef654_11042000.nii.gz,0.6664771111742963,0.0,0.0
84,0.8751286419731733,3834,10605,0.7779810871069425,46654965,50596,61201,54430,/well/papiez/users/hri611/python/nnUNet_results/Dataset219_PETCT/nnUNetTrainer__nnUNetPlans__3d_fullres_maxnum_512_patch_192/crossval_results_folds_0_1_2/PETCT_2f7200f771_11052005.nii.gz,/well/papiez/users/hri611/python/nnUnet_raw/Dataset219_PETCT/labelsTr/PETCT_2f7200f771_11052005.nii.gz,0.8751286419731733,0.024882041931152343,1.3311892433166503
85,0.7122878189388278,2524,171,0.5531420991543691,52153969,3336,3507,5860,/well/papiez/users/hri611/python/nnUNet_results/Dataset219_PETCT/nnUNetTrainer__nnUNetPlans__3d_fullres_maxnum_512_patch_192/crossval_results_folds_0_1_2/PETCT_3049d4f1a4_02242002.nii.gz,/well/papiez/users/hri611/python/nnUnet_raw/Dataset219_PETCT/labelsTr/PETCT_3049d4f1a4_02242002.nii.gz,0.7122878189388278,0.0,3.2844295349121095
86,0.8972635236239151,11536,2539,0.8136699409568694,45364462,61463,64002,72999,/well/papiez/users/hri611/python/nnUNet_results/Dataset219_PETCT/nnUNetTrainer__nnUNetPlans__3d_fullres_maxnum_512_patch_192/crossval_results_folds_0_1_2/PETCT_30c4b7062b_01182001.nii.gz,/well/papiez/users/hri611/python/nnUnet_raw/Dataset219_PETCT/labelsTr/PETCT_30c4b7062b_01182001.nii.gz,0.8972635236239151,2.724583591461182,11.109831722259521
87,0.0,0,142,0.0,99039858,0,142,0,/well/papiez/users/hri611/python/nnUNet_results/Dataset219_PETCT/nnUNetTrainer__nnUNetPlans__3d_fullres_maxnum_512_patch_192/crossval_results_folds_0_1_2/PETCT_30e2b83b74_04262003.nii.gz,/well/papiez/users/hri611/python/nnUnet_raw/Dataset219_PETCT/labelsTr/PETCT_30e2b83b74_04262003.nii.gz,0.0,1.7666249771118163,0.0
88,0.0,0,2,0.0,92319998,0,2,0,/well/papiez/users/hri611/python/nnUNet_results/Dataset219_PETCT/nnUNetTrainer__nnUNetPlans__3d_fullres_maxnum_512_patch_192/crossval_results_folds_0_1_2/PETCT_30e2b83b74_07212003.nii.gz,/well/papiez/users/hri611/python/nnUnet_raw/Dataset219_PETCT/labelsTr/PETCT_30e2b83b74_07212003.nii.gz,0.0,0.024882041931152343,0.0
89,0.9450985955454675,524,250,0.8959117805271651,52152564,6662,6912,7186,/well/papiez/users/hri611/python/nnUNet_results/Dataset219_PETCT/nnUNetTrainer__nnUNetPlans__3d_fullres_maxnum_512_patch_192/crossval_results_folds_0_1_2/PETCT_31ddf5013a_02222001.nii.gz,/well/papiez/users/hri611/python/nnUnet_raw/Dataset219_PETCT/labelsTr/PETCT_31ddf5013a_02222001.nii.gz,0.9450985955454675,0.42299471282958984,0.0
90,0.6196873229107637,2549,8860,0.4489470633693972,45419296,9295,18155,11844,/well/papiez/users/hri611/python/nnUNet_results/Dataset219_PETCT/nnUNetTrainer__nnUNetPlans__3d_fullres_maxnum_512_patch_192/crossval_results_folds_0_1_2/PETCT_321bba14bc_03072002.nii.gz,/well/papiez/users/hri611/python/nnUnet_raw/Dataset219_PETCT/labelsTr/PETCT_321bba14bc_03072002.nii.gz,0.6196873229107637,0.12441020965576172,0.870871467590332
91,,0,0,,45440000,0,0,0,/well/papiez/users/hri611/python/nnUNet_results/Dataset219_PETCT/nnUNetTrainer__nnUNetPlans__3d_fullres_maxnum_512_patch_192/crossval_results_folds_0_1_2/PETCT_32219760da_03132003.nii.gz,/well/papiez/users/hri611/python/nnUnet_raw/Dataset219_PETCT/labelsTr/PETCT_32219760da_03132003.nii.gz,,0.0,0.0
92,0.829736211031175,56,15,0.7090163934426229,99839756,173,188,229,/well/papiez/users/hri611/python/nnUNet_results/Dataset219_PETCT/nnUNetTrainer__nnUNetPlans__3d_fullres_maxnum_512_patch_192/crossval_results_folds_0_1_2/PETCT_32aa845af1_01262007.nii.gz,/well/papiez/users/hri611/python/nnUnet_raw/Dataset219_PETCT/labelsTr/PETCT_32aa845af1_01262007.nii.gz,0.829736211031175,0.0,0.0
93,0.903203677025451,545,866,0.8234926194645984,50872006,6583,7449,7128,/well/papiez/users/hri611/python/nnUNet_results/Dataset219_PETCT/nnUNetTrainer__nnUNetPlans__3d_fullres_maxnum_512_patch_192/crossval_results_folds_0_1_2/PETCT_32aa845af1_06152007.nii.gz,/well/papiez/users/hri611/python/nnUnet_raw/Dataset219_PETCT/labelsTr/PETCT_32aa845af1_06152007.nii.gz,0.903203677025451,5.772633728027344,1.7915070190429687
94,0.8441610678266569,8541,1920,0.7303448986956745,45401206,28333,30253,36874,/well/papiez/users/hri611/python/nnUNet_results/Dataset219_PETCT/nnUNetTrainer__nnUNetPlans__3d_fullres_maxnum_512_patch_192/crossval_results_folds_0_1_2/PETCT_335a00191d_02162001.nii.gz,/well/papiez/users/hri611/python/nnUnet_raw/Dataset219_PETCT/labelsTr/PETCT_335a00191d_02162001.nii.gz,0.8441610678266569,0.1741742935180664,21.970843025207518
95,0.0,0,18,0.0,49919982,0,18,0,/well/papiez/users/hri611/python/nnUNet_results/Dataset219_PETCT/nnUNetTrainer__nnUNetPlans__3d_fullres_maxnum_512_patch_192/crossval_results_folds_0_1_2/PETCT_345b11778a_10142005.nii.gz,/well/papiez/users/hri611/python/nnUnet_raw/Dataset219_PETCT/labelsTr/PETCT_345b11778a_10142005.nii.gz,0.0,0.2239383773803711,0.0
96,,0,0,,54240000,0,0,0,/well/papiez/users/hri611/python/nnUNet_results/Dataset219_PETCT/nnUNetTrainer__nnUNetPlans__3d_fullres_maxnum_512_patch_192/crossval_results_folds_0_1_2/PETCT_3481507253_06172007.nii.gz,/well/papiez/users/hri611/python/nnUnet_raw/Dataset219_PETCT/labelsTr/PETCT_3481507253_06172007.nii.gz,,0.0,0.0
97,,0,0,,52160000,0,0,0,/well/papiez/users/hri611/python/nnUNet_results/Dataset219_PETCT/nnUNetTrainer__nnUNetPlans__3d_fullres_maxnum_512_patch_192/crossval_results_folds_0_1_2/PETCT_34d3efa936_10222004.nii.gz,/well/papiez/users/hri611/python/nnUnet_raw/Dataset219_PETCT/labelsTr/PETCT_34d3efa936_10222004.nii.gz,,0.0,0.0
98,0.6662702188392008,2641,165,0.4995541287676119,45594393,2801,2966,5442,/well/papiez/users/hri611/python/nnUNet_results/Dataset219_PETCT/nnUNetTrainer__nnUNetPlans__3d_fullres_maxnum_512_patch_192/crossval_results_folds_0_1_2/PETCT_350e91119a_10232005.nii.gz,/well/papiez/users/hri611/python/nnUnet_raw/Dataset219_PETCT/labelsTr/PETCT_350e91119a_10232005.nii.gz,0.6662702188392008,0.5971690063476562,5.78507474899292
99,0.8593668915412558,754,330,0.7534121929026387,92315604,3312,3642,4066,/well/papiez/users/hri611/python/nnUNet_results/Dataset219_PETCT/nnUNetTrainer__nnUNetPlans__3d_fullres_maxnum_512_patch_192/crossval_results_folds_0_1_2/PETCT_35c9c85a96_04082005.nii.gz,/well/papiez/users/hri611/python/nnUnet_raw/Dataset219_PETCT/labelsTr/PETCT_35c9c85a96_04082005.nii.gz,0.8593668915412558,0.06220510482788086,0.7091381950378418
100,0.10296886314265025,12273,115,0.0542789525918009,52146901,711,826,12984,/well/papiez/users/hri611/python/nnUNet_results/Dataset219_PETCT/nnUNetTrainer__nnUNetPlans__3d_fullres_maxnum_512_patch_192/crossval_results_folds_0_1_2/PETCT_36bb0257fc_08032003.nii.gz,/well/papiez/users/hri611/python/nnUnet_raw/Dataset219_PETCT/labelsTr/PETCT_36bb0257fc_08032003.nii.gz,0.10296886314265025,0.19905633544921875,150.4741485786438
101,0.7625883941579901,4466,2215,0.616277066222503,100942589,10730,12945,15196,/well/papiez/users/hri611/python/nnUNet_results/Dataset219_PETCT/nnUNetTrainer__nnUNetPlans__3d_fullres_maxnum_512_patch_192/crossval_results_folds_0_1_2/PETCT_36d8219e3f_02092006.nii.gz,/well/papiez/users/hri611/python/nnUnet_raw/Dataset219_PETCT/labelsTr/PETCT_36d8219e3f_02092006.nii.gz,0.7625883941579901,2.2145017318725584,2.0403274383544923
102,0.0,0,77,0.0,48799923,0,77,0,/well/papiez/users/hri611/python/nnUNet_results/Dataset219_PETCT/nnUNetTrainer__nnUNetPlans__3d_fullres_maxnum_512_patch_192/crossval_results_folds_0_1_2/PETCT_372746cc99_07152006.nii.gz,/well/papiez/users/hri611/python/nnUnet_raw/Dataset219_PETCT/labelsTr/PETCT_372746cc99_07152006.nii.gz,0.0,0.9579586143493652,0.0
103,0.8806324110671937,3718,1416,0.786723163841808,52135928,18938,20354,22656,/well/papiez/users/hri611/python/nnUNet_results/Dataset219_PETCT/nnUNetTrainer__nnUNetPlans__3d_fullres_maxnum_512_patch_192/crossval_results_folds_0_1_2/PETCT_37952b7ffb_08242002.nii.gz,/well/papiez/users/hri611/python/nnUnet_raw/Dataset219_PETCT/labelsTr/PETCT_37952b7ffb_08242002.nii.gz,0.8806324110671937,3.9189216041564943,4.1553010025024415
104,0.0,0,36,0.0,52159964,0,36,0,/well/papiez/users/hri611/python/nnUNet_results/Dataset219_PETCT/nnUNetTrainer__nnUNetPlans__3d_fullres_maxnum_512_patch_192/crossval_results_folds_0_1_2/PETCT_389462c0ac_03032005.nii.gz,/well/papiez/users/hri611/python/nnUnet_raw/Dataset219_PETCT/labelsTr/PETCT_389462c0ac_03032005.nii.gz,0.0,0.4478767547607422,0.0
105,0.0,0,68,0.0,56159932,0,68,0,/well/papiez/users/hri611/python/nnUNet_results/Dataset219_PETCT/nnUNetTrainer__nnUNetPlans__3d_fullres_maxnum_512_patch_192/crossval_results_folds_0_1_2/PETCT_389462c0ac_08292005.nii.gz,/well/papiez/users/hri611/python/nnUnet_raw/Dataset219_PETCT/labelsTr/PETCT_389462c0ac_08292005.nii.gz,0.0,0.8459894256591797,0.0
106,0.0,0,4,0.0,97279996,0,4,0,/well/papiez/users/hri611/python/nnUNet_results/Dataset219_PETCT/nnUNetTrainer__nnUNetPlans__3d_fullres_maxnum_512_patch_192/crossval_results_folds_0_1_2/PETCT_389c968170_02172006.nii.gz,/well/papiez/users/hri611/python/nnUnet_raw/Dataset219_PETCT/labelsTr/PETCT_389c968170_02172006.nii.gz,0.0,0.04976408386230469,0.0
107,0.0,0,301,0.0,100959699,0,301,0,/well/papiez/users/hri611/python/nnUNet_results/Dataset219_PETCT/nnUNetTrainer__nnUNetPlans__3d_fullres_maxnum_512_patch_192/crossval_results_folds_0_1_2/PETCT_389c968170_08192005.nii.gz,/well/papiez/users/hri611/python/nnUnet_raw/Dataset219_PETCT/labelsTr/PETCT_389c968170_08192005.nii.gz,0.0,3.7447473106384277,0.0
108,0.0,0,492,0.0,52799508,0,492,0,/well/papiez/users/hri611/python/nnUNet_results/Dataset219_PETCT/nnUNetTrainer__nnUNetPlans__3d_fullres_maxnum_512_patch_192/crossval_results_folds_0_1_2/PETCT_38a374d01a_05242007.nii.gz,/well/papiez/users/hri611/python/nnUnet_raw/Dataset219_PETCT/labelsTr/PETCT_38a374d01a_05242007.nii.gz,0.0,6.120982315063476,0.0
109,,0,0,,71520000,0,0,0,/well/papiez/users/hri611/python/nnUNet_results/Dataset219_PETCT/nnUNetTrainer__nnUNetPlans__3d_fullres_maxnum_512_patch_192/crossval_results_folds_0_1_2/PETCT_390129c0d2_04272007.nii.gz,/well/papiez/users/hri611/python/nnUnet_raw/Dataset219_PETCT/labelsTr/PETCT_390129c0d2_04272007.nii.gz,,0.0,0.0
110,0.0,0,1,0.0,65439999,0,1,0,/well/papiez/users/hri611/python/nnUNet_results/Dataset219_PETCT/nnUNetTrainer__nnUNetPlans__3d_fullres_maxnum_512_patch_192/crossval_results_folds_0_1_2/PETCT_39eca178a1_06082003.nii.gz,/well/papiez/users/hri611/python/nnUnet_raw/Dataset219_PETCT/labelsTr/PETCT_39eca178a1_06082003.nii.gz,0.0,0.012441020965576172,0.0
111,,0,0,,49440000,0,0,0,/well/papiez/users/hri611/python/nnUNet_results/Dataset219_PETCT/nnUNetTrainer__nnUNetPlans__3d_fullres_maxnum_512_patch_192/crossval_results_folds_0_1_2/PETCT_3a40a26443_10022005.nii.gz,/well/papiez/users/hri611/python/nnUnet_raw/Dataset219_PETCT/labelsTr/PETCT_3a40a26443_10022005.nii.gz,,0.0,0.0
112,0.6497143969881864,18321,3265,0.4811681288306694,58838395,20019,23284,38340,/well/papiez/users/hri611/python/nnUNet_results/Dataset219_PETCT/nnUNetTrainer__nnUNetPlans__3d_fullres_maxnum_512_patch_192/crossval_results_folds_0_1_2/PETCT_3b1c9155f5_01312003.nii.gz,/well/papiez/users/hri611/python/nnUnet_raw/Dataset219_PETCT/labelsTr/PETCT_3b1c9155f5_01312003.nii.gz,0.6497143969881864,17.96483427429199,39.61221075439453
113,0.9036297066401483,3449,815,0.824201195629767,52135745,19991,20806,23440,/well/papiez/users/hri611/python/nnUNet_results/Dataset219_PETCT/nnUNetTrainer__nnUNetPlans__3d_fullres_maxnum_512_patch_192/crossval_results_folds_0_1_2/PETCT_3b26172779_11102001.nii.gz,/well/papiez/users/hri611/python/nnUnet_raw/Dataset219_PETCT/labelsTr/PETCT_3b26172779_11102001.nii.gz,0.9036297066401483,0.7713432998657226,11.707000728607177
114,,0,0,,45440000,0,0,0,/well/papiez/users/hri611/python/nnUNet_results/Dataset219_PETCT/nnUNetTrainer__nnUNetPlans__3d_fullres_maxnum_512_patch_192/crossval_results_folds_0_1_2/PETCT_3b2a4af482_01262003.nii.gz,/well/papiez/users/hri611/python/nnUnet_raw/Dataset219_PETCT/labelsTr/PETCT_3b2a4af482_01262003.nii.gz,,0.0,0.0
115,,0,0,,48480000,0,0,0,/well/papiez/users/hri611/python/nnUNet_results/Dataset219_PETCT/nnUNetTrainer__nnUNetPlans__3d_fullres_maxnum_512_patch_192/crossval_results_folds_0_1_2/PETCT_3bce0eb7aa_06032007.nii.gz,/well/papiez/users/hri611/python/nnUnet_raw/Dataset219_PETCT/labelsTr/PETCT_3bce0eb7aa_06032007.nii.gz,,0.0,0.0
116,0.9011494252873563,9,34,0.8200836820083682,45439761,196,230,205,/well/papiez/users/hri611/python/nnUNet_results/Dataset219_PETCT/nnUNetTrainer__nnUNetPlans__3d_fullres_maxnum_512_patch_192/crossval_results_folds_0_1_2/PETCT_3c3050f75e_09052002.nii.gz,/well/papiez/users/hri611/python/nnUnet_raw/Dataset219_PETCT/labelsTr/PETCT_3c3050f75e_09052002.nii.gz,0.9011494252873563,0.0,0.0
117,0.050446016610273765,187,2900,0.025875670558535815,78876831,82,2982,269,/well/papiez/users/hri611/python/nnUNet_results/Dataset219_PETCT/nnUNetTrainer__nnUNetPlans__3d_fullres_maxnum_512_patch_192/crossval_results_folds_0_1_2/PETCT_3c3ee87fc6_06132003.nii.gz,/well/papiez/users/hri611/python/nnUnet_raw/Dataset219_PETCT/labelsTr/PETCT_3c3ee87fc6_06132003.nii.gz,0.050446016610273765,36.0789608001709,2.027886417388916
118,0.8359310800070051,9562,2617,0.7181113297072098,52116795,31026,33643,40588,/well/papiez/users/hri611/python/nnUNet_results/Dataset219_PETCT/nnUNetTrainer__nnUNetPlans__3d_fullres_maxnum_512_patch_192/crossval_results_folds_0_1_2/PETCT_3c71e8f518_12112000.nii.gz,/well/papiez/users/hri611/python/nnUnet_raw/Dataset219_PETCT/labelsTr/PETCT_3c71e8f518_12112000.nii.gz,0.8359310800070051,3.060491157531738,13.22480528640747
119,0.0,0,57,0.0,94719943,0,57,0,/well/papiez/users/hri611/python/nnUNet_results/Dataset219_PETCT/nnUNetTrainer__nnUNetPlans__3d_fullres_maxnum_512_patch_192/crossval_results_folds_0_1_2/PETCT_3c94a00f90_05112007.nii.gz,/well/papiez/users/hri611/python/nnUnet_raw/Dataset219_PETCT/labelsTr/PETCT_3c94a00f90_05112007.nii.gz,0.0,0.7091381950378418,0.0
120,,0,0,,45440000,0,0,0,/well/papiez/users/hri611/python/nnUNet_results/Dataset219_PETCT/nnUNetTrainer__nnUNetPlans__3d_fullres_maxnum_512_patch_192/crossval_results_folds_0_1_2/PETCT_3cd49210eb_12292002.nii.gz,/well/papiez/users/hri611/python/nnUnet_raw/Dataset219_PETCT/labelsTr/PETCT_3cd49210eb_12292002.nii.gz,,0.0,0.0
121,0.0,0,25,0.0,52159975,0,25,0,/well/papiez/users/hri611/python/nnUNet_results/Dataset219_PETCT/nnUNetTrainer__nnUNetPlans__3d_fullres_maxnum_512_patch_192/crossval_results_folds_0_1_2/PETCT_3cf68da275_03202003.nii.gz,/well/papiez/users/hri611/python/nnUnet_raw/Dataset219_PETCT/labelsTr/PETCT_3cf68da275_03202003.nii.gz,0.0,0.3110255241394043,0.0
122,0.8762441068622315,739,3041,0.7797459503554365,52142838,13382,16423,14121,/well/papiez/users/hri611/python/nnUNet_results/Dataset219_PETCT/nnUNetTrainer__nnUNetPlans__3d_fullres_maxnum_512_patch_192/crossval_results_folds_0_1_2/PETCT_3d6f425a76_01282002.nii.gz,/well/papiez/users/hri611/python/nnUnet_raw/Dataset219_PETCT/labelsTr/PETCT_3d6f425a76_01282002.nii.gz,0.8762441068622315,5.337197994232177,0.4478767547607422
123,0.0,0,80,0.0,52159920,0,80,0,/well/papiez/users/hri611/python/nnUNet_results/Dataset219_PETCT/nnUNetTrainer__nnUNetPlans__3d_fullres_maxnum_512_patch_192/crossval_results_folds_0_1_2/PETCT_3d6f425a76_07222002.nii.gz,/well/papiez/users/hri611/python/nnUnet_raw/Dataset219_PETCT/labelsTr/PETCT_3d6f425a76_07222002.nii.gz,0.0,0.9952816772460937,0.0
124,,0,0,,45440000,0,0,0,/well/papiez/users/hri611/python/nnUNet_results/Dataset219_PETCT/nnUNetTrainer__nnUNetPlans__3d_fullres_maxnum_512_patch_192/crossval_results_folds_0_1_2/PETCT_3d8b79d739_11282004.nii.gz,/well/papiez/users/hri611/python/nnUnet_raw/Dataset219_PETCT/labelsTr/PETCT_3d8b79d739_11282004.nii.gz,,0.0,0.0
125,0.8554122704181321,2139,81,0.7473540457494026,45431213,6567,6648,8706,/well/papiez/users/hri611/python/nnUNet_results/Dataset219_PETCT/nnUNetTrainer__nnUNetPlans__3d_fullres_maxnum_512_patch_192/crossval_results_folds_0_1_2/PETCT_3eac8f16d4_09302001.nii.gz,/well/papiez/users/hri611/python/nnUnet_raw/Dataset219_PETCT/labelsTr/PETCT_3eac8f16d4_09302001.nii.gz,0.8554122704181321,0.07464612579345703,9.741319416046142
126,0.0,0,27,0.0,52159973,0,27,0,/well/papiez/users/hri611/python/nnUNet_results/Dataset219_PETCT/nnUNetTrainer__nnUNetPlans__3d_fullres_maxnum_512_patch_192/crossval_results_folds_0_1_2/PETCT_3f2ee0274d_09162002.nii.gz,/well/papiez/users/hri611/python/nnUnet_raw/Dataset219_PETCT/labelsTr/PETCT_3f2ee0274d_09162002.nii.gz,0.0,0.3359075660705566,0.0
127,,0,0,,52160000,0,0,0,/well/papiez/users/hri611/python/nnUNet_results/Dataset219_PETCT/nnUNetTrainer__nnUNetPlans__3d_fullres_maxnum_512_patch_192/crossval_results_folds_0_1_2/PETCT_3f3df20439_05092005.nii.gz,/well/papiez/users/hri611/python/nnUnet_raw/Dataset219_PETCT/labelsTr/PETCT_3f3df20439_05092005.nii.gz,,0.0,0.0
128,0.7047149122807017,1976,3410,0.5440616270210785,45588187,6427,9837,8403,/well/papiez/users/hri611/python/nnUNet_results/Dataset219_PETCT/nnUNetTrainer__nnUNetPlans__3d_fullres_maxnum_512_patch_192/crossval_results_folds_0_1_2/PETCT_3f5a9f616f_06032007.nii.gz,/well/papiez/users/hri611/python/nnUnet_raw/Dataset219_PETCT/labelsTr/PETCT_3f5a9f616f_06032007.nii.gz,0.7047149122807017,0.11196918869018554,7.688550956726074
129,0.6933577365972698,3893,128,0.5306408310960663,45431433,4546,4674,8439,/well/papiez/users/hri611/python/nnUNet_results/Dataset219_PETCT/nnUNetTrainer__nnUNetPlans__3d_fullres_maxnum_512_patch_192/crossval_results_folds_0_1_2/PETCT_3fd361ec14_10242004.nii.gz,/well/papiez/users/hri611/python/nnUnet_raw/Dataset219_PETCT/labelsTr/PETCT_3fd361ec14_10242004.nii.gz,0.6933577365972698,0.0,1.8412711029052735
130,0.0,0,230,0.0,58879770,0,230,0,/well/papiez/users/hri611/python/nnUNet_results/Dataset219_PETCT/nnUNetTrainer__nnUNetPlans__3d_fullres_maxnum_512_patch_192/crossval_results_folds_0_1_2/PETCT_402c061122_02222003.nii.gz,/well/papiez/users/hri611/python/nnUnet_raw/Dataset219_PETCT/labelsTr/PETCT_402c061122_02222003.nii.gz,0.0,2.8614348220825194,0.0
131,,0,0,,45440000,0,0,0,/well/papiez/users/hri611/python/nnUNet_results/Dataset219_PETCT/nnUNetTrainer__nnUNetPlans__3d_fullres_maxnum_512_patch_192/crossval_results_folds_0_1_2/PETCT_402c061122_08252003.nii.gz,/well/papiez/users/hri611/python/nnUnet_raw/Dataset219_PETCT/labelsTr/PETCT_402c061122_08252003.nii.gz,,0.0,0.0
132,,0,0,,45120000,0,0,0,/well/papiez/users/hri611/python/nnUNet_results/Dataset219_PETCT/nnUNetTrainer__nnUNetPlans__3d_fullres_maxnum_512_patch_192/crossval_results_folds_0_1_2/PETCT_404f8c732f_06142007.nii.gz,/well/papiez/users/hri611/python/nnUnet_raw/Dataset219_PETCT/labelsTr/PETCT_404f8c732f_06142007.nii.gz,,0.0,0.0
133,,0,0,,53600000,0,0,0,/well/papiez/users/hri611/python/nnUNet_results/Dataset219_PETCT/nnUNetTrainer__nnUNetPlans__3d_fullres_maxnum_512_patch_192/crossval_results_folds_0_1_2/PETCT_416d3b9b78_08142006.nii.gz,/well/papiez/users/hri611/python/nnUnet_raw/Dataset219_PETCT/labelsTr/PETCT_416d3b9b78_08142006.nii.gz,,0.0,0.0
134,0.0,0,639,0.0,52159361,0,639,0,/well/papiez/users/hri611/python/nnUNet_results/Dataset219_PETCT/nnUNetTrainer__nnUNetPlans__3d_fullres_maxnum_512_patch_192/crossval_results_folds_0_1_2/PETCT_41f4d41517_11132004.nii.gz,/well/papiez/users/hri611/python/nnUnet_raw/Dataset219_PETCT/labelsTr/PETCT_41f4d41517_11132004.nii.gz,0.0,7.949812397003174,0.0
135,0.7209302325581395,0,24,0.5636363636363636,45439945,31,55,31,/well/papiez/users/hri611/python/nnUNet_results/Dataset219_PETCT/nnUNetTrainer__nnUNetPlans__3d_fullres_maxnum_512_patch_192/crossval_results_folds_0_1_2/PETCT_41fadf6520_02272003.nii.gz,/well/papiez/users/hri611/python/nnUnet_raw/Dataset219_PETCT/labelsTr/PETCT_41fadf6520_02272003.nii.gz,0.7209302325581395,0.09952816772460937,0.0
136,0.8370259906263315,1211,319,0.719728888074739,92314541,3929,4248,5140,/well/papiez/users/hri611/python/nnUNet_results/Dataset219_PETCT/nnUNetTrainer__nnUNetPlans__3d_fullres_maxnum_512_patch_192/crossval_results_folds_0_1_2/PETCT_424e9b79c5_05112003.nii.gz,/well/papiez/users/hri611/python/nnUnet_raw/Dataset219_PETCT/labelsTr/PETCT_424e9b79c5_05112003.nii.gz,0.8370259906263315,3.5581319961547853,0.012441020965576172
137,0.8337205340271969,9095,1641,0.714854851132772,45402349,26915,28556,36010,/well/papiez/users/hri611/python/nnUNet_results/Dataset219_PETCT/nnUNetTrainer__nnUNetPlans__3d_fullres_maxnum_512_patch_192/crossval_results_folds_0_1_2/PETCT_43323b7d42_05272001.nii.gz,/well/papiez/users/hri611/python/nnUnet_raw/Dataset219_PETCT/labelsTr/PETCT_43323b7d42_05272001.nii.gz,0.8337205340271969,0.0,6.705710300445556
138,0.8635724331926864,54,334,0.7599009900990099,50878384,1228,1562,1282,/well/papiez/users/hri611/python/nnUNet_results/Dataset219_PETCT/nnUNetTrainer__nnUNetPlans__3d_fullres_maxnum_512_patch_192/crossval_results_folds_0_1_2/PETCT_43647ff727_03022006.nii.gz,/well/papiez/users/hri611/python/nnUnet_raw/Dataset219_PETCT/labelsTr/PETCT_43647ff727_03022006.nii.gz,0.8635724331926864,0.19905633544921875,0.0
139,,0,0,,45440000,0,0,0,/well/papiez/users/hri611/python/nnUNet_results/Dataset219_PETCT/nnUNetTrainer__nnUNetPlans__3d_fullres_maxnum_512_patch_192/crossval_results_folds_0_1_2/PETCT_437d2c96fe_11162003.nii.gz,/well/papiez/users/hri611/python/nnUnet_raw/Dataset219_PETCT/labelsTr/PETCT_437d2c96fe_11162003.nii.gz,,0.0,0.0
140,0.0,0,137,0.0,46399863,0,137,0,/well/papiez/users/hri611/python/nnUNet_results/Dataset219_PETCT/nnUNetTrainer__nnUNetPlans__3d_fullres_maxnum_512_patch_192/crossval_results_folds_0_1_2/PETCT_43c9c71b31_05142007.nii.gz,/well/papiez/users/hri611/python/nnUnet_raw/Dataset219_PETCT/labelsTr/PETCT_43c9c71b31_05142007.nii.gz,0.0,1.7044198722839354,0.0
141,0.0,0,281,0.0,52159719,0,281,0,/well/papiez/users/hri611/python/nnUNet_results/Dataset219_PETCT/nnUNetTrainer__nnUNetPlans__3d_fullres_maxnum_512_patch_192/crossval_results_folds_0_1_2/PETCT_44bf7dc508_07252002.nii.gz,/well/papiez/users/hri611/python/nnUnet_raw/Dataset219_PETCT/labelsTr/PETCT_44bf7dc508_07252002.nii.gz,0.0,3.495926891326904,0.0
142,0.8442622950819673,601,7,0.7304964539007093,52157744,1648,1655,2249,/well/papiez/users/hri611/python/nnUNet_results/Dataset219_PETCT/nnUNetTrainer__nnUNetPlans__3d_fullres_maxnum_512_patch_192/crossval_results_folds_0_1_2/PETCT_456d14846b_09012003.nii.gz,/well/papiez/users/hri611/python/nnUnet_raw/Dataset219_PETCT/labelsTr/PETCT_456d14846b_09012003.nii.gz,0.8442622950819673,0.0,0.0
143,0.6885245901639344,76,0,0.525,52479840,84,84,160,/well/papiez/users/hri611/python/nnUNet_results/Dataset219_PETCT/nnUNetTrainer__nnUNetPlans__3d_fullres_maxnum_512_patch_192/crossval_results_folds_0_1_2/PETCT_456e6f9dc2_07282005.nii.gz,/well/papiez/users/hri611/python/nnUnet_raw/Dataset219_PETCT/labelsTr/PETCT_456e6f9dc2_07282005.nii.gz,0.6885245901639344,0.0,0.0
144,0.9264097628895532,3301,293,0.8629081476960635,103813784,22622,22915,25923,/well/papiez/users/hri611/python/nnUNet_results/Dataset219_PETCT/nnUNetTrainer__nnUNetPlans__3d_fullres_maxnum_512_patch_192/crossval_results_folds_0_1_2/PETCT_4776e75543_04012007.nii.gz,/well/papiez/users/hri611/python/nnUnet_raw/Dataset219_PETCT/labelsTr/PETCT_4776e75543_04012007.nii.gz,0.9264097628895532,0.6718151321411132,0.0
145,0.0,0,1667,0.0,51838333,0,1667,0,/well/papiez/users/hri611/python/nnUNet_results/Dataset219_PETCT/nnUNetTrainer__nnUNetPlans__3d_fullres_maxnum_512_patch_192/crossval_results_folds_0_1_2/PETCT_4785066413_08242006.nii.gz,/well/papiez/users/hri611/python/nnUnet_raw/Dataset219_PETCT/labelsTr/PETCT_4785066413_08242006.nii.gz,0.0,20.739181949615478,0.0
146,0.6854976987636495,6038,932,0.5214883976383359,52145434,7596,8528,13634,/well/papiez/users/hri611/python/nnUNet_results/Dataset219_PETCT/nnUNetTrainer__nnUNetPlans__3d_fullres_maxnum_512_patch_192/crossval_results_folds_0_1_2/PETCT_47cd731006_01252002.nii.gz,/well/papiez/users/hri611/python/nnUnet_raw/Dataset219_PETCT/labelsTr/PETCT_47cd731006_01252002.nii.gz,0.6854976987636495,1.0326047401428222,0.3981126708984375
147,,0,0,,50400000,0,0,0,/well/papiez/users/hri611/python/nnUNet_results/Dataset219_PETCT/nnUNetTrainer__nnUNetPlans__3d_fullres_maxnum_512_patch_192/crossval_results_folds_0_1_2/PETCT_47f4460050_08062006.nii.gz,/well/papiez/users/hri611/python/nnUnet_raw/Dataset219_PETCT/labelsTr/PETCT_47f4460050_08062006.nii.gz,,0.0,0.0
148,,0,0,,58400000,0,0,0,/well/papiez/users/hri611/python/nnUNet_results/Dataset219_PETCT/nnUNetTrainer__nnUNetPlans__3d_fullres_maxnum_512_patch_192/crossval_results_folds_0_1_2/PETCT_48c70dc4a3_04132007.nii.gz,/well/papiez/users/hri611/python/nnUnet_raw/Dataset219_PETCT/labelsTr/PETCT_48c70dc4a3_04132007.nii.gz,,0.0,0.0
149,0.7094307561597282,637,47,0.5497037524687294,52158481,835,882,1472,/well/papiez/users/hri611/python/nnUNet_results/Dataset219_PETCT/nnUNetTrainer__nnUNetPlans__3d_fullres_maxnum_512_patch_192/crossval_results_folds_0_1_2/PETCT_49f3d297b0_07242003.nii.gz,/well/papiez/users/hri611/python/nnUnet_raw/Dataset219_PETCT/labelsTr/PETCT_49f3d297b0_07242003.nii.gz,0.7094307561597282,0.0,0.8957535095214844
150,0.34884027487233565,3148,110467,0.2112698544929468,52015952,30433,140900,33581,/well/papiez/users/hri611/python/nnUNet_results/Dataset219_PETCT/nnUNetTrainer__nnUNetPlans__3d_fullres_maxnum_512_patch_192/crossval_results_folds_0_1_2/PETCT_4b688f46b0_02182005.nii.gz,/well/papiez/users/hri611/python/nnUnet_raw/Dataset219_PETCT/labelsTr/PETCT_4b688f46b0_02182005.nii.gz,0.34884027487233565,6.1085412940979005,0.0
151,,0,0,,44960000,0,0,0,/well/papiez/users/hri611/python/nnUNet_results/Dataset219_PETCT/nnUNetTrainer__nnUNetPlans__3d_fullres_maxnum_512_patch_192/crossval_results_folds_0_1_2/PETCT_4bab91dccd_01052006.nii.gz,/well/papiez/users/hri611/python/nnUnet_raw/Dataset219_PETCT/labelsTr/PETCT_4bab91dccd_01052006.nii.gz,,0.0,0.0
152,0.2490803993694167,2731,127,0.14225690276110445,45436668,474,601,3205,/well/papiez/users/hri611/python/nnUNet_results/Dataset219_PETCT/nnUNetTrainer__nnUNetPlans__3d_fullres_maxnum_512_patch_192/crossval_results_folds_0_1_2/PETCT_4be28f9cd7_02032002.nii.gz,/well/papiez/users/hri611/python/nnUnet_raw/Dataset219_PETCT/labelsTr/PETCT_4be28f9cd7_02032002.nii.gz,0.2490803993694167,1.2192200546264649,0.6966971740722656
153,0.054827329514192315,116349,463,0.028186356073211315,52039800,3388,3851,119737,/well/papiez/users/hri611/python/nnUNet_results/Dataset219_PETCT/nnUNetTrainer__nnUNetPlans__3d_fullres_maxnum_512_patch_192/crossval_results_folds_0_1_2/PETCT_4c75fa4a5d_04192001.nii.gz,/well/papiez/users/hri611/python/nnUnet_raw/Dataset219_PETCT/labelsTr/PETCT_4c75fa4a5d_04192001.nii.gz,0.054827329514192315,2.0652094802856444,563.1303729858398
154,0.8779231214624175,5892,4439,0.7824090650603425,52112521,37148,41587,43040,/well/papiez/users/hri611/python/nnUNet_results/Dataset219_PETCT/nnUNetTrainer__nnUNetPlans__3d_fullres_maxnum_512_patch_192/crossval_results_folds_0_1_2/PETCT_4c9e7be363_09172000.nii.gz,/well/papiez/users/hri611/python/nnUnet_raw/Dataset219_PETCT/labelsTr/PETCT_4c9e7be363_09172000.nii.gz,0.8779231214624175,4.416562442779541,0.0
155,,0,0,,52160000,0,0,0,/well/papiez/users/hri611/python/nnUNet_results/Dataset219_PETCT/nnUNetTrainer__nnUNetPlans__3d_fullres_maxnum_512_patch_192/crossval_results_folds_0_1_2/PETCT_4ea806706c_10302003.nii.gz,/well/papiez/users/hri611/python/nnUnet_raw/Dataset219_PETCT/labelsTr/PETCT_4ea806706c_10302003.nii.gz,,0.0,0.0
156,,0,0,,42400000,0,0,0,/well/papiez/users/hri611/python/nnUNet_results/Dataset219_PETCT/nnUNetTrainer__nnUNetPlans__3d_fullres_maxnum_512_patch_192/crossval_results_folds_0_1_2/PETCT_4fb1817df3_06062005.nii.gz,/well/papiez/users/hri611/python/nnUnet_raw/Dataset219_PETCT/labelsTr/PETCT_4fb1817df3_06062005.nii.gz,,0.0,0.0
157,0.5990338164251208,166,0,0.42758620689655175,52159710,124,124,290,/well/papiez/users/hri611/python/nnUNet_results/Dataset219_PETCT/nnUNetTrainer__nnUNetPlans__3d_fullres_maxnum_512_patch_192/crossval_results_folds_0_1_2/PETCT_5060603ba4_09192003.nii.gz,/well/papiez/users/hri611/python/nnUnet_raw/Dataset219_PETCT/labelsTr/PETCT_5060603ba4_09192003.nii.gz,0.5990338164251208,0.0,1.953240291595459
158,0.9096232725436991,6725,436,0.8342284365016899,45396802,36037,36473,42762,/well/papiez/users/hri611/python/nnUNet_results/Dataset219_PETCT/nnUNetTrainer__nnUNetPlans__3d_fullres_maxnum_512_patch_192/crossval_results_folds_0_1_2/PETCT_510fb36781_02062003.nii.gz,/well/papiez/users/hri611/python/nnUnet_raw/Dataset219_PETCT/labelsTr/PETCT_510fb36781_02062003.nii.gz,0.9096232725436991,0.0,0.0
159,,0,0,,48480000,0,0,0,/well/papiez/users/hri611/python/nnUNet_results/Dataset219_PETCT/nnUNetTrainer__nnUNetPlans__3d_fullres_maxnum_512_patch_192/crossval_results_folds_0_1_2/PETCT_53ccb9efbb_12152005.nii.gz,/well/papiez/users/hri611/python/nnUnet_raw/Dataset219_PETCT/labelsTr/PETCT_53ccb9efbb_12152005.nii.gz,,0.0,0.0
160,0.7039417063514831,640,9680,0.543140466598787,50057411,12269,21949,12909,/well/papiez/users/hri611/python/nnUNet_results/Dataset219_PETCT/nnUNetTrainer__nnUNetPlans__3d_fullres_maxnum_512_patch_192/crossval_results_folds_0_1_2/PETCT_53dad1785b_12112005.nii.gz,/well/papiez/users/hri611/python/nnUnet_raw/Dataset219_PETCT/labelsTr/PETCT_53dad1785b_12112005.nii.gz,0.7039417063514831,42.08797392654419,6.5439770278930665
161,,0,0,,46080000,0,0,0,/well/papiez/users/hri611/python/nnUNet_results/Dataset219_PETCT/nnUNetTrainer__nnUNetPlans__3d_fullres_maxnum_512_patch_192/crossval_results_folds_0_1_2/PETCT_5420205a5f_12072006.nii.gz,/well/papiez/users/hri611/python/nnUnet_raw/Dataset219_PETCT/labelsTr/PETCT_5420205a5f_12072006.nii.gz,,0.0,0.0
162,,0,0,,50560000,0,0,0,/well/papiez/users/hri611/python/nnUNet_results/Dataset219_PETCT/nnUNetTrainer__nnUNetPlans__3d_fullres_maxnum_512_patch_192/crossval_results_folds_0_1_2/PETCT_544676de40_12152005.nii.gz,/well/papiez/users/hri611/python/nnUnet_raw/Dataset219_PETCT/labelsTr/PETCT_544676de40_12152005.nii.gz,,0.0,0.0
163,0.9236508994003997,933,213,0.8581332012874474,48791922,6932,7145,7865,/well/papiez/users/hri611/python/nnUNet_results/Dataset219_PETCT/nnUNetTrainer__nnUNetPlans__3d_fullres_maxnum_512_patch_192/crossval_results_folds_0_1_2/PETCT_548213edf7_09192005.nii.gz,/well/papiez/users/hri611/python/nnUnet_raw/Dataset219_PETCT/labelsTr/PETCT_548213edf7_09192005.nii.gz,0.9236508994003997,0.0,0.8211073837280274
164,,0,0,,45440000,0,0,0,/well/papiez/users/hri611/python/nnUNet_results/Dataset219_PETCT/nnUNetTrainer__nnUNetPlans__3d_fullres_maxnum_512_patch_192/crossval_results_folds_0_1_2/PETCT_54977a7e76_02212003.nii.gz,/well/papiez/users/hri611/python/nnUnet_raw/Dataset219_PETCT/labelsTr/PETCT_54977a7e76_02212003.nii.gz,,0.0,0.0
165,0.9709779179810726,34,794,0.9435928877988964,58865321,13851,14645,13885,/well/papiez/users/hri611/python/nnUNet_results/Dataset219_PETCT/nnUNetTrainer__nnUNetPlans__3d_fullres_maxnum_512_patch_192/crossval_results_folds_0_1_2/PETCT_556b56485a_08292003.nii.gz,/well/papiez/users/hri611/python/nnUnet_raw/Dataset219_PETCT/labelsTr/PETCT_556b56485a_08292003.nii.gz,0.9709779179810726,0.0,0.024882041931152343
166,0.0,58,28,0.0,52159914,0,28,58,/well/papiez/users/hri611/python/nnUNet_results/Dataset219_PETCT/nnUNetTrainer__nnUNetPlans__3d_fullres_maxnum_512_patch_192/crossval_results_folds_0_1_2/PETCT_55ae7986e1_05102003.nii.gz,/well/papiez/users/hri611/python/nnUnet_raw/Dataset219_PETCT/labelsTr/PETCT_55ae7986e1_05102003.nii.gz,0.0,0.3483485870361328,0.721579216003418
167,,0,0,,51520000,0,0,0,/well/papiez/users/hri611/python/nnUNet_results/Dataset219_PETCT/nnUNetTrainer__nnUNetPlans__3d_fullres_maxnum_512_patch_192/crossval_results_folds_0_1_2/PETCT_55e3e62722_03032007.nii.gz,/well/papiez/users/hri611/python/nnUnet_raw/Dataset219_PETCT/labelsTr/PETCT_55e3e62722_03032007.nii.gz,,0.0,0.0
168,0.2469892708561419,3439,0,0.1408943292530602,52155997,564,564,4003,/well/papiez/users/hri611/python/nnUNet_results/Dataset219_PETCT/nnUNetTrainer__nnUNetPlans__3d_fullres_maxnum_512_patch_192/crossval_results_folds_0_1_2/PETCT_581fa95eb0_03242003.nii.gz,/well/papiez/users/hri611/python/nnUnet_raw/Dataset219_PETCT/labelsTr/PETCT_581fa95eb0_03242003.nii.gz,0.2469892708561419,0.0,0.0
169,,0,0,,52160000,0,0,0,/well/papiez/users/hri611/python/nnUNet_results/Dataset219_PETCT/nnUNetTrainer__nnUNetPlans__3d_fullres_maxnum_512_patch_192/crossval_results_folds_0_1_2/PETCT_591b3025ff_11132004.nii.gz,/well/papiez/users/hri611/python/nnUnet_raw/Dataset219_PETCT/labelsTr/PETCT_591b3025ff_11132004.nii.gz,,0.0,0.0
170,0.0,0,113,0.0,48159887,0,113,0,/well/papiez/users/hri611/python/nnUNet_results/Dataset219_PETCT/nnUNetTrainer__nnUNetPlans__3d_fullres_maxnum_512_patch_192/crossval_results_folds_0_1_2/PETCT_595975bc57_03102006.nii.gz,/well/papiez/users/hri611/python/nnUnet_raw/Dataset219_PETCT/labelsTr/PETCT_595975bc57_03102006.nii.gz,0.0,1.4058353691101073,0.0
171,0.7671675152117223,1700,175,0.6222804190169219,51195036,3089,3264,4789,/well/papiez/users/hri611/python/nnUNet_results/Dataset219_PETCT/nnUNetTrainer__nnUNetPlans__3d_fullres_maxnum_512_patch_192/crossval_results_folds_0_1_2/PETCT_59e6d1de22_08062005.nii.gz,/well/papiez/users/hri611/python/nnUnet_raw/Dataset219_PETCT/labelsTr/PETCT_59e6d1de22_08062005.nii.gz,0.7671675152117223,0.12441020965576172,2.314029899597168
172,0.9079887745556595,4102,816,0.8314830043859649,52130816,24266,25082,28368,/well/papiez/users/hri611/python/nnUNet_results/Dataset219_PETCT/nnUNetTrainer__nnUNetPlans__3d_fullres_maxnum_512_patch_192/crossval_results_folds_0_1_2/PETCT_5ac322455f_05262003.nii.gz,/well/papiez/users/hri611/python/nnUnet_raw/Dataset219_PETCT/labelsTr/PETCT_5ac322455f_05262003.nii.gz,0.9079887745556595,0.0,1.306307201385498
173,,0,0,,52160000,0,0,0,/well/papiez/users/hri611/python/nnUNet_results/Dataset219_PETCT/nnUNetTrainer__nnUNetPlans__3d_fullres_maxnum_512_patch_192/crossval_results_folds_0_1_2/PETCT_5ac4fd9091_11142004.nii.gz,/well/papiez/users/hri611/python/nnUnet_raw/Dataset219_PETCT/labelsTr/PETCT_5ac4fd9091_11142004.nii.gz,,0.0,0.0
174,,0,0,,47520000,0,0,0,/well/papiez/users/hri611/python/nnUNet_results/Dataset219_PETCT/nnUNetTrainer__nnUNetPlans__3d_fullres_maxnum_512_patch_192/crossval_results_folds_0_1_2/PETCT_5b0aa4e971_09102006.nii.gz,/well/papiez/users/hri611/python/nnUnet_raw/Dataset219_PETCT/labelsTr/PETCT_5b0aa4e971_09102006.nii.gz,,0.0,0.0
175,0.0,611,23,0.0,52159366,0,23,611,/well/papiez/users/hri611/python/nnUNet_results/Dataset219_PETCT/nnUNetTrainer__nnUNetPlans__3d_fullres_maxnum_512_patch_192/crossval_results_folds_0_1_2/PETCT_5c1baad5d8_03062003.nii.gz,/well/papiez/users/hri611/python/nnUnet_raw/Dataset219_PETCT/labelsTr/PETCT_5c1baad5d8_03062003.nii.gz,0.0,0.2861434822082519,7.601463809967041
176,0.8213961922030825,177,20,0.696923076923077,45439350,453,473,630,/well/papiez/users/hri611/python/nnUNet_results/Dataset219_PETCT/nnUNetTrainer__nnUNetPlans__3d_fullres_maxnum_512_patch_192/crossval_results_folds_0_1_2/PETCT_5c35fcbe89_08102002.nii.gz,/well/papiez/users/hri611/python/nnUnet_raw/Dataset219_PETCT/labelsTr/PETCT_5c35fcbe89_08102002.nii.gz,0.8213961922030825,0.0,0.0
177,0.8978473990859296,2556,3300,0.8146307492640309,45408409,25735,29035,28291,/well/papiez/users/hri611/python/nnUNet_results/Dataset219_PETCT/nnUNetTrainer__nnUNetPlans__3d_fullres_maxnum_512_patch_192/crossval_results_folds_0_1_2/PETCT_5c55b3087d_12112000.nii.gz,/well/papiez/users/hri611/python/nnUnet_raw/Dataset219_PETCT/labelsTr/PETCT_5c55b3087d_12112000.nii.gz,0.8978473990859296,11.868734001159668,12.217082588195801
178,,0,0,,45440000,0,0,0,/well/papiez/users/hri611/python/nnUNet_results/Dataset219_PETCT/nnUNetTrainer__nnUNetPlans__3d_fullres_maxnum_512_patch_192/crossval_results_folds_0_1_2/PETCT_5c57a98a43_02242005.nii.gz,/well/papiez/users/hri611/python/nnUnet_raw/Dataset219_PETCT/labelsTr/PETCT_5c57a98a43_02242005.nii.gz,,0.0,0.0
179,0.8940642832756182,1491,7197,0.8084233737596472,47314650,36662,43859,38153,/well/papiez/users/hri611/python/nnUNet_results/Dataset219_PETCT/nnUNetTrainer__nnUNetPlans__3d_fullres_maxnum_512_patch_192/crossval_results_folds_0_1_2/PETCT_5d10be5b89_05302005.nii.gz,/well/papiez/users/hri611/python/nnUnet_raw/Dataset219_PETCT/labelsTr/PETCT_5d10be5b89_05302005.nii.gz,0.8940642832756182,3.2719885139465332,1.157014949798584
180,0.10714285714285714,0,200,0.05660377358490566,46719788,12,212,12,/well/papiez/users/hri611/python/nnUNet_results/Dataset219_PETCT/nnUNetTrainer__nnUNetPlans__3d_fullres_maxnum_512_patch_192/crossval_results_folds_0_1_2/PETCT_5d994c3f44_03052006.nii.gz,/well/papiez/users/hri611/python/nnUnet_raw/Dataset219_PETCT/labelsTr/PETCT_5d994c3f44_03052006.nii.gz,0.10714285714285714,2.4259990882873534,0.0
181,0.8645418326693227,340,0,0.7614035087719299,47518575,1085,1085,1425,/well/papiez/users/hri611/python/nnUNet_results/Dataset219_PETCT/nnUNetTrainer__nnUNetPlans__3d_fullres_maxnum_512_patch_192/crossval_results_folds_0_1_2/PETCT_5de3ac617a_11132005.nii.gz,/well/papiez/users/hri611/python/nnUnet_raw/Dataset219_PETCT/labelsTr/PETCT_5de3ac617a_11132005.nii.gz,0.8645418326693227,0.0,0.0
182,0.0,0,2,0.0,46399998,0,2,0,/well/papiez/users/hri611/python/nnUNet_results/Dataset219_PETCT/nnUNetTrainer__nnUNetPlans__3d_fullres_maxnum_512_patch_192/crossval_results_folds_0_1_2/PETCT_5e339b2ecf_05272006.nii.gz,/well/papiez/users/hri611/python/nnUnet_raw/Dataset219_PETCT/labelsTr/PETCT_5e339b2ecf_05272006.nii.gz,0.0,0.024882041931152343,0.0
183,0.4117373078714485,2507,19,0.2592375366568915,45436590,884,903,3391,/well/papiez/users/hri611/python/nnUNet_results/Dataset219_PETCT/nnUNetTrainer__nnUNetPlans__3d_fullres_maxnum_512_patch_192/crossval_results_folds_0_1_2/PETCT_5e8b013935_12162001.nii.gz,/well/papiez/users/hri611/python/nnUnet_raw/Dataset219_PETCT/labelsTr/PETCT_5e8b013935_12162001.nii.gz,0.4117373078714485,0.0,24.434165176391602
184,0.0,0,106,0.0,45439894,0,106,0,/well/papiez/users/hri611/python/nnUNet_results/Dataset219_PETCT/nnUNetTrainer__nnUNetPlans__3d_fullres_maxnum_512_patch_192/crossval_results_folds_0_1_2/PETCT_5fa9d9a820_03242003.nii.gz,/well/papiez/users/hri611/python/nnUnet_raw/Dataset219_PETCT/labelsTr/PETCT_5fa9d9a820_03242003.nii.gz,0.0,1.3187482223510743,0.0
185,0.0,0,123,0.0,45439877,0,123,0,/well/papiez/users/hri611/python/nnUNet_results/Dataset219_PETCT/nnUNetTrainer__nnUNetPlans__3d_fullres_maxnum_512_patch_192/crossval_results_folds_0_1_2/PETCT_5fa9d9a820_09152002.nii.gz,/well/papiez/users/hri611/python/nnUnet_raw/Dataset219_PETCT/labelsTr/PETCT_5fa9d9a820_09152002.nii.gz,0.0,1.530245578765869,0.0
186,0.0,0,53,0.0,52159947,0,53,0,/well/papiez/users/hri611/python/nnUNet_results/Dataset219_PETCT/nnUNetTrainer__nnUNetPlans__3d_fullres_maxnum_512_patch_192/crossval_results_folds_0_1_2/PETCT_5fa9d9a820_09272004.nii.gz,/well/papiez/users/hri611/python/nnUnet_raw/Dataset219_PETCT/labelsTr/PETCT_5fa9d9a820_09272004.nii.gz,0.0,0.6593741111755371,0.0
187,0.0,0,136,0.0,52159864,0,136,0,/well/papiez/users/hri611/python/nnUNet_results/Dataset219_PETCT/nnUNetTrainer__nnUNetPlans__3d_fullres_maxnum_512_patch_192/crossval_results_folds_0_1_2/PETCT_6016a6c3af_07012002.nii.gz,/well/papiez/users/hri611/python/nnUnet_raw/Dataset219_PETCT/labelsTr/PETCT_6016a6c3af_07012002.nii.gz,0.0,1.6919788513183593,0.0
188,0.0,0,117,0.0,50879883,0,117,0,/well/papiez/users/hri611/python/nnUNet_results/Dataset219_PETCT/nnUNetTrainer__nnUNetPlans__3d_fullres_maxnum_512_patch_192/crossval_results_folds_0_1_2/PETCT_607c1b38e3_04142007.nii.gz,/well/papiez/users/hri611/python/nnUnet_raw/Dataset219_PETCT/labelsTr/PETCT_607c1b38e3_04142007.nii.gz,0.0,1.4555994529724121,0.0
189,,0,0,,48640000,0,0,0,/well/papiez/users/hri611/python/nnUNet_results/Dataset219_PETCT/nnUNetTrainer__nnUNetPlans__3d_fullres_maxnum_512_patch_192/crossval_results_folds_0_1_2/PETCT_607c1b38e3_10162006.nii.gz,/well/papiez/users/hri611/python/nnUnet_raw/Dataset219_PETCT/labelsTr/PETCT_607c1b38e3_10162006.nii.gz,,0.0,0.0
190,0.750906892382104,1840,220,0.601161665053243,45434835,3105,3325,4945,/well/papiez/users/hri611/python/nnUNet_results/Dataset219_PETCT/nnUNetTrainer__nnUNetPlans__3d_fullres_maxnum_512_patch_192/crossval_results_folds_0_1_2/PETCT_60baa6979c_08162003.nii.gz,/well/papiez/users/hri611/python/nnUnet_raw/Dataset219_PETCT/labelsTr/PETCT_60baa6979c_08162003.nii.gz,0.750906892382104,0.07464612579345703,2.8365527801513672
191,0.837823275862069,1586,220,0.7209086694483078,45433529,4665,4885,6251,/well/papiez/users/hri611/python/nnUNet_results/Dataset219_PETCT/nnUNetTrainer__nnUNetPlans__3d_fullres_maxnum_512_patch_192/crossval_results_folds_0_1_2/PETCT_61663450f8_08162003.nii.gz,/well/papiez/users/hri611/python/nnUnet_raw/Dataset219_PETCT/labelsTr/PETCT_61663450f8_08162003.nii.gz,0.837823275862069,0.9330765724182128,0.0
192,0.9045460226562588,5325,3076,0.8257270879143676,45391794,39805,42881,45130,/well/papiez/users/hri611/python/nnUNet_results/Dataset219_PETCT/nnUNetTrainer__nnUNetPlans__3d_fullres_maxnum_512_patch_192/crossval_results_folds_0_1_2/PETCT_6170317f2e_02182000.nii.gz,/well/papiez/users/hri611/python/nnUnet_raw/Dataset219_PETCT/labelsTr/PETCT_6170317f2e_02182000.nii.gz,0.9045460226562588,6.705710300445556,6.120982315063476
193,0.0,0,100,0.0,58079900,0,100,0,/well/papiez/users/hri611/python/nnUNet_results/Dataset219_PETCT/nnUNetTrainer__nnUNetPlans__3d_fullres_maxnum_512_patch_192/crossval_results_folds_0_1_2/PETCT_61d5bc58fc_06152007.nii.gz,/well/papiez/users/hri611/python/nnUnet_raw/Dataset219_PETCT/labelsTr/PETCT_61d5bc58fc_06152007.nii.gz,0.0,1.2441020965576173,0.0
194,0.0,0,46,0.0,59839954,0,46,0,/well/papiez/users/hri611/python/nnUNet_results/Dataset219_PETCT/nnUNetTrainer__nnUNetPlans__3d_fullres_maxnum_512_patch_192/crossval_results_folds_0_1_2/PETCT_61d5bc58fc_06182005.nii.gz,/well/papiez/users/hri611/python/nnUnet_raw/Dataset219_PETCT/labelsTr/PETCT_61d5bc58fc_06182005.nii.gz,0.0,0.5722869644165038,0.0
195,0.0,0,296,0.0,55999704,0,296,0,/well/papiez/users/hri611/python/nnUNet_results/Dataset219_PETCT/nnUNetTrainer__nnUNetPlans__3d_fullres_maxnum_512_patch_192/crossval_results_folds_0_1_2/PETCT_61d5bc58fc_12152005.nii.gz,/well/papiez/users/hri611/python/nnUnet_raw/Dataset219_PETCT/labelsTr/PETCT_61d5bc58fc_12152005.nii.gz,0.0,3.682542205810547,0.0
196,0.92221526842256,5806,1527,0.8556581304253685,52109197,43470,44997,49276,/well/papiez/users/hri611/python/nnUNet_results/Dataset219_PETCT/nnUNetTrainer__nnUNetPlans__3d_fullres_maxnum_512_patch_192/crossval_results_folds_0_1_2/PETCT_62011ff15b_05052005.nii.gz,/well/papiez/users/hri611/python/nnUnet_raw/Dataset219_PETCT/labelsTr/PETCT_62011ff15b_05052005.nii.gz,0.92221526842256,0.0870871467590332,12.080231357574462
197,0.0,0,3,0.0,52159997,0,3,0,/well/papiez/users/hri611/python/nnUNet_results/Dataset219_PETCT/nnUNetTrainer__nnUNetPlans__3d_fullres_maxnum_512_patch_192/crossval_results_folds_0_1_2/PETCT_62b114e09b_06092003.nii.gz,/well/papiez/users/hri611/python/nnUnet_raw/Dataset219_PETCT/labelsTr/PETCT_62b114e09b_06092003.nii.gz,0.0,0.037323062896728515,0.0
198,0.9171557422623092,478,2204,0.8469876768598813,52142472,14846,17050,15324,/well/papiez/users/hri611/python/nnUNet_results/Dataset219_PETCT/nnUNetTrainer__nnUNetPlans__3d_fullres_maxnum_512_patch_192/crossval_results_folds_0_1_2/PETCT_62ced197ca_04142003.nii.gz,/well/papiez/users/hri611/python/nnUnet_raw/Dataset219_PETCT/labelsTr/PETCT_62ced197ca_04142003.nii.gz,0.9171557422623092,0.0,0.0
199,,0,0,,52160000,0,0,0,/well/papiez/users/hri611/python/nnUNet_results/Dataset219_PETCT/nnUNetTrainer__nnUNetPlans__3d_fullres_maxnum_512_patch_192/crossval_results_folds_0_1_2/PETCT_63464433c8_01042003.nii.gz,/well/papiez/users/hri611/python/nnUnet_raw/Dataset219_PETCT/labelsTr/PETCT_63464433c8_01042003.nii.gz,,0.0,0.0
200,0.912925234982585,528,1297,0.8397998595505618,45428608,9567,10864,10095,/well/papiez/users/hri611/python/nnUNet_results/Dataset219_PETCT/nnUNetTrainer__nnUNetPlans__3d_fullres_maxnum_512_patch_192/crossval_results_folds_0_1_2/PETCT_63508c679d_02172005.nii.gz,/well/papiez/users/hri611/python/nnUnet_raw/Dataset219_PETCT/labelsTr/PETCT_63508c679d_02172005.nii.gz,0.912925234982585,7.128705013275146,1.1943380126953125
201,0.0,0,41,0.0,45759959,0,41,0,/well/papiez/users/hri611/python/nnUNet_results/Dataset219_PETCT/nnUNetTrainer__nnUNetPlans__3d_fullres_maxnum_512_patch_192/crossval_results_folds_0_1_2/PETCT_63508c679d_08212005.nii.gz,/well/papiez/users/hri611/python/nnUnet_raw/Dataset219_PETCT/labelsTr/PETCT_63508c679d_08212005.nii.gz,0.0,0.5100818595886231,0.0
202,0.8758023433520122,526,693,0.7790465832880189,52154483,4298,4991,4824,/well/papiez/users/hri611/python/nnUNet_results/Dataset219_PETCT/nnUNetTrainer__nnUNetPlans__3d_fullres_maxnum_512_patch_192/crossval_results_folds_0_1_2/PETCT_64909533c5_04142003.nii.gz,/well/papiez/users/hri611/python/nnUnet_raw/Dataset219_PETCT/labelsTr/PETCT_64909533c5_04142003.nii.gz,0.8758023433520122,4.727587966918946,0.0
203,,0,0,,49920000,0,0,0,/well/papiez/users/hri611/python/nnUNet_results/Dataset219_PETCT/nnUNetTrainer__nnUNetPlans__3d_fullres_maxnum_512_patch_192/crossval_results_folds_0_1_2/PETCT_64aff75516_01202006.nii.gz,/well/papiez/users/hri611/python/nnUnet_raw/Dataset219_PETCT/labelsTr/PETCT_64aff75516_01202006.nii.gz,,0.0,0.0
204,,0,0,,47840000,0,0,0,/well/papiez/users/hri611/python/nnUNet_results/Dataset219_PETCT/nnUNetTrainer__nnUNetPlans__3d_fullres_maxnum_512_patch_192/crossval_results_folds_0_1_2/PETCT_64aff75516_10162005.nii.gz,/well/papiez/users/hri611/python/nnUnet_raw/Dataset219_PETCT/labelsTr/PETCT_64aff75516_10162005.nii.gz,,0.0,0.0
205,,0,0,,41920000,0,0,0,/well/papiez/users/hri611/python/nnUNet_results/Dataset219_PETCT/nnUNetTrainer__nnUNetPlans__3d_fullres_maxnum_512_patch_192/crossval_results_folds_0_1_2/PETCT_64c0cba177_08072006.nii.gz,/well/papiez/users/hri611/python/nnUnet_raw/Dataset219_PETCT/labelsTr/PETCT_64c0cba177_08072006.nii.gz,,0.0,0.0
206,0.6946778711484594,193,25,0.5321888412017167,92319534,248,273,441,/well/papiez/users/hri611/python/nnUNet_results/Dataset219_PETCT/nnUNetTrainer__nnUNetPlans__3d_fullres_maxnum_512_patch_192/crossval_results_folds_0_1_2/PETCT_65346b03b8_03142004.nii.gz,/well/papiez/users/hri611/python/nnUnet_raw/Dataset219_PETCT/labelsTr/PETCT_65346b03b8_03142004.nii.gz,0.6946778711484594,0.0870871467590332,0.0
207,0.7050003536317986,3546,625,0.544401966138722,45430845,4984,5609,8530,/well/papiez/users/hri611/python/nnUNet_results/Dataset219_PETCT/nnUNetTrainer__nnUNetPlans__3d_fullres_maxnum_512_patch_192/crossval_results_folds_0_1_2/PETCT_65a1330e90_06162001.nii.gz,/well/papiez/users/hri611/python/nnUnet_raw/Dataset219_PETCT/labelsTr/PETCT_65a1330e90_06162001.nii.gz,0.7050003536317986,0.0,33.030910663604736
208,0.0,0,2384,0.0,52157616,0,2384,0,/well/papiez/users/hri611/python/nnUNet_results/Dataset219_PETCT/nnUNetTrainer__nnUNetPlans__3d_fullres_maxnum_512_patch_192/crossval_results_folds_0_1_2/PETCT_674c49778c_12222002.nii.gz,/well/papiez/users/hri611/python/nnUnet_raw/Dataset219_PETCT/labelsTr/PETCT_674c49778c_12222002.nii.gz,0.0,29.659393981933594,0.0
209,0.7140448191701797,6327,19449,0.5552641568032023,52102042,32182,51631,38509,/well/papiez/users/hri611/python/nnUNet_results/Dataset219_PETCT/nnUNetTrainer__nnUNetPlans__3d_fullres_maxnum_512_patch_192/crossval_results_folds_0_1_2/PETCT_685d7c09b5_12232000.nii.gz,/well/papiez/users/hri611/python/nnUnet_raw/Dataset219_PETCT/labelsTr/PETCT_685d7c09b5_12232000.nii.gz,0.7140448191701797,0.23637939834594726,2.3264709205627443
210,0.9250608711335557,2479,14,0.8605704697986577,45422120,15387,15401,17866,/well/papiez/users/hri611/python/nnUNet_results/Dataset219_PETCT/nnUNetTrainer__nnUNetPlans__3d_fullres_maxnum_512_patch_192/crossval_results_folds_0_1_2/PETCT_68f73c4518_11132004.nii.gz,/well/papiez/users/hri611/python/nnUnet_raw/Dataset219_PETCT/labelsTr/PETCT_68f73c4518_11132004.nii.gz,0.9250608711335557,0.0,0.0
211,,0,0,,50560000,0,0,0,/well/papiez/users/hri611/python/nnUNet_results/Dataset219_PETCT/nnUNetTrainer__nnUNetPlans__3d_fullres_maxnum_512_patch_192/crossval_results_folds_0_1_2/PETCT_69606f6a25_08132006.nii.gz,/well/papiez/users/hri611/python/nnUnet_raw/Dataset219_PETCT/labelsTr/PETCT_69606f6a25_08132006.nii.gz,,0.0,0.0
212,,0,0,,44320000,0,0,0,/well/papiez/users/hri611/python/nnUNet_results/Dataset219_PETCT/nnUNetTrainer__nnUNetPlans__3d_fullres_maxnum_512_patch_192/crossval_results_folds_0_1_2/PETCT_69c90b6820_11212005.nii.gz,/well/papiez/users/hri611/python/nnUnet_raw/Dataset219_PETCT/labelsTr/PETCT_69c90b6820_11212005.nii.gz,,0.0,0.0
213,0.8710359052068863,21453,9185,0.7715355246674223,45305896,103466,112651,124919,/well/papiez/users/hri611/python/nnUNet_results/Dataset219_PETCT/nnUNetTrainer__nnUNetPlans__3d_fullres_maxnum_512_patch_192/crossval_results_folds_0_1_2/PETCT_6a3477cd9a_01152005.nii.gz,/well/papiez/users/hri611/python/nnUnet_raw/Dataset219_PETCT/labelsTr/PETCT_6a3477cd9a_01152005.nii.gz,0.8710359052068863,4.130418960571289,22.94124266052246
214,0.4368911917098446,2707,10,0.2795014584990719,45436229,1054,1064,3761,/well/papiez/users/hri611/python/nnUNet_results/Dataset219_PETCT/nnUNetTrainer__nnUNetPlans__3d_fullres_maxnum_512_patch_192/crossval_results_folds_0_1_2/PETCT_6aea5c3a03_12272001.nii.gz,/well/papiez/users/hri611/python/nnUnet_raw/Dataset219_PETCT/labelsTr/PETCT_6aea5c3a03_12272001.nii.gz,0.4368911917098446,0.0,28.62678924179077
215,,0,0,,51840000,0,0,0,/well/papiez/users/hri611/python/nnUNet_results/Dataset219_PETCT/nnUNetTrainer__nnUNetPlans__3d_fullres_maxnum_512_patch_192/crossval_results_folds_0_1_2/PETCT_6b177a3c28_06302005.nii.gz,/well/papiez/users/hri611/python/nnUnet_raw/Dataset219_PETCT/labelsTr/PETCT_6b177a3c28_06302005.nii.gz,,0.0,0.0
216,,0,0,,38720000,0,0,0,/well/papiez/users/hri611/python/nnUNet_results/Dataset219_PETCT/nnUNetTrainer__nnUNetPlans__3d_fullres_maxnum_512_patch_192/crossval_results_folds_0_1_2/PETCT_6b20c7eabb_07312003.nii.gz,/well/papiez/users/hri611/python/nnUnet_raw/Dataset219_PETCT/labelsTr/PETCT_6b20c7eabb_07312003.nii.gz,,0.0,0.0
217,0.9016683518705764,1302,1032,0.8209436133486766,51666965,10701,11733,12003,/well/papiez/users/hri611/python/nnUNet_results/Dataset219_PETCT/nnUNetTrainer__nnUNetPlans__3d_fullres_maxnum_512_patch_192/crossval_results_folds_0_1_2/PETCT_6c23f2686d_04212007.nii.gz,/well/papiez/users/hri611/python/nnUnet_raw/Dataset219_PETCT/labelsTr/PETCT_6c23f2686d_04212007.nii.gz,0.9016683518705764,0.09952816772460937,0.0
218,0.9232804232804233,53,5,0.8574938574938575,54079593,349,354,402,/well/papiez/users/hri611/python/nnUNet_results/Dataset219_PETCT/nnUNetTrainer__nnUNetPlans__3d_fullres_maxnum_512_patch_192/crossval_results_folds_0_1_2/PETCT_6d62e15c29_02232007.nii.gz,/well/papiez/users/hri611/python/nnUnet_raw/Dataset219_PETCT/labelsTr/PETCT_6d62e15c29_02232007.nii.gz,0.9232804232804233,0.0,0.0
219,0.8669085137739485,1543,805,0.7650825412706354,52150005,7647,8452,9190,/well/papiez/users/hri611/python/nnUNet_results/Dataset219_PETCT/nnUNetTrainer__nnUNetPlans__3d_fullres_maxnum_512_patch_192/crossval_results_folds_0_1_2/PETCT_6d6a193655_11172002.nii.gz,/well/papiez/users/hri611/python/nnUnet_raw/Dataset219_PETCT/labelsTr/PETCT_6d6a193655_11172002.nii.gz,0.8669085137739485,0.0,0.0
220,,0,0,,45440000,0,0,0,/well/papiez/users/hri611/python/nnUNet_results/Dataset219_PETCT/nnUNetTrainer__nnUNetPlans__3d_fullres_maxnum_512_patch_192/crossval_results_folds_0_1_2/PETCT_6dd36a2c19_11282003.nii.gz,/well/papiez/users/hri611/python/nnUnet_raw/Dataset219_PETCT/labelsTr/PETCT_6dd36a2c19_11282003.nii.gz,,0.0,0.0
221,0.909520125374437,2335,2226,0.8340549390576678,52132515,22924,25150,25259,/well/papiez/users/hri611/python/nnUNet_results/Dataset219_PETCT/nnUNetTrainer__nnUNetPlans__3d_fullres_maxnum_512_patch_192/crossval_results_folds_0_1_2/PETCT_6e7c7f8087_03232003.nii.gz,/well/papiez/users/hri611/python/nnUnet_raw/Dataset219_PETCT/labelsTr/PETCT_6e7c7f8087_03232003.nii.gz,0.909520125374437,0.04976408386230469,2.027886417388916
222,0.8,132,58,0.6666666666666666,52159430,380,438,512,/well/papiez/users/hri611/python/nnUNet_results/Dataset219_PETCT/nnUNetTrainer__nnUNetPlans__3d_fullres_maxnum_512_patch_192/crossval_results_folds_0_1_2/PETCT_6efefcb92a_03262005.nii.gz,/well/papiez/users/hri611/python/nnUnet_raw/Dataset219_PETCT/labelsTr/PETCT_6efefcb92a_03262005.nii.gz,0.8,0.42299471282958984,0.8957535095214844
223,,0,0,,94240000,0,0,0,/well/papiez/users/hri611/python/nnUNet_results/Dataset219_PETCT/nnUNetTrainer__nnUNetPlans__3d_fullres_maxnum_512_patch_192/crossval_results_folds_0_1_2/PETCT_6f46454a8d_09032005.nii.gz,/well/papiez/users/hri611/python/nnUnet_raw/Dataset219_PETCT/labelsTr/PETCT_6f46454a8d_09032005.nii.gz,,0.0,0.0
224,0.0,0,123,0.0,99039877,0,123,0,/well/papiez/users/hri611/python/nnUNet_results/Dataset219_PETCT/nnUNetTrainer__nnUNetPlans__3d_fullres_maxnum_512_patch_192/crossval_results_folds_0_1_2/PETCT_6f46454a8d_09122002.nii.gz,/well/papiez/users/hri611/python/nnUnet_raw/Dataset219_PETCT/labelsTr/PETCT_6f46454a8d_09122002.nii.gz,0.0,1.530245578765869,0.0
225,0.8462003780718337,2884,1184,0.7334032374336458,52144741,11191,12375,14075,/well/papiez/users/hri611/python/nnUNet_results/Dataset219_PETCT/nnUNetTrainer__nnUNetPlans__3d_fullres_maxnum_512_patch_192/crossval_results_folds_0_1_2/PETCT_6fe855c937_12292001.nii.gz,/well/papiez/users/hri611/python/nnUnet_raw/Dataset219_PETCT/labelsTr/PETCT_6fe855c937_12292001.nii.gz,0.8462003780718337,0.06220510482788086,1.2192200546264649
226,0.5460091509913574,875,18,0.37552447552447554,52158570,537,555,1412,/well/papiez/users/hri611/python/nnUNet_results/Dataset219_PETCT/nnUNetTrainer__nnUNetPlans__3d_fullres_maxnum_512_patch_192/crossval_results_folds_0_1_2/PETCT_7094acd4c0_08232001.nii.gz,/well/papiez/users/hri611/python/nnUnet_raw/Dataset219_PETCT/labelsTr/PETCT_7094acd4c0_08232001.nii.gz,0.5460091509913574,0.0,9.281001640319824
227,,0,0,,45440000,0,0,0,/well/papiez/users/hri611/python/nnUNet_results/Dataset219_PETCT/nnUNetTrainer__nnUNetPlans__3d_fullres_maxnum_512_patch_192/crossval_results_folds_0_1_2/PETCT_71ae114917_04132003.nii.gz,/well/papiez/users/hri611/python/nnUnet_raw/Dataset219_PETCT/labelsTr/PETCT_71ae114917_04132003.nii.gz,,0.0,0.0
228,,0,0,,50880000,0,0,0,/well/papiez/users/hri611/python/nnUNet_results/Dataset219_PETCT/nnUNetTrainer__nnUNetPlans__3d_fullres_maxnum_512_patch_192/crossval_results_folds_0_1_2/PETCT_72725f2bda_07062007.nii.gz,/well/papiez/users/hri611/python/nnUnet_raw/Dataset219_PETCT/labelsTr/PETCT_72725f2bda_07062007.nii.gz,,0.0,0.0
229,0.0,0,115,0.0,38239885,0,115,0,/well/papiez/users/hri611/python/nnUNet_results/Dataset219_PETCT/nnUNetTrainer__nnUNetPlans__3d_fullres_maxnum_512_patch_192/crossval_results_folds_0_1_2/PETCT_72d2d6de52_08052005.nii.gz,/well/papiez/users/hri611/python/nnUnet_raw/Dataset219_PETCT/labelsTr/PETCT_72d2d6de52_08052005.nii.gz,0.0,1.4307174110412597,0.0
230,0.7357487119827156,10535,8545,0.5819639805442356,45074358,26562,35107,37097,/well/papiez/users/hri611/python/nnUNet_results/Dataset219_PETCT/nnUNetTrainer__nnUNetPlans__3d_fullres_maxnum_512_patch_192/crossval_results_folds_0_1_2/PETCT_7323c415d0_02262006.nii.gz,/well/papiez/users/hri611/python/nnUnet_raw/Dataset219_PETCT/labelsTr/PETCT_7323c415d0_02262006.nii.gz,0.7357487119827156,22.368955696105957,59.841310844421386
231,0.831679521123518,5837,1474,0.7118590627832736,84454627,18062,19536,23899,/well/papiez/users/hri611/python/nnUNet_results/Dataset219_PETCT/nnUNetTrainer__nnUNetPlans__3d_fullres_maxnum_512_patch_192/crossval_results_folds_0_1_2/PETCT_73597f33fe_05172007.nii.gz,/well/papiez/users/hri611/python/nnUnet_raw/Dataset219_PETCT/labelsTr/PETCT_73597f33fe_05172007.nii.gz,0.831679521123518,1.0077226982116698,0.48519981765747067
232,0.0,0,62,0.0,51839938,0,62,0,/well/papiez/users/hri611/python/nnUNet_results/Dataset219_PETCT/nnUNetTrainer__nnUNetPlans__3d_fullres_maxnum_512_patch_192/crossval_results_folds_0_1_2/PETCT_7365362464_03222007.nii.gz,/well/papiez/users/hri611/python/nnUnet_raw/Dataset219_PETCT/labelsTr/PETCT_7365362464_03222007.nii.gz,0.0,0.7713432998657226,0.0
233,0.6338028169014085,10,94,0.4639175257731959,45119806,90,184,100,/well/papiez/users/hri611/python/nnUNet_results/Dataset219_PETCT/nnUNetTrainer__nnUNetPlans__3d_fullres_maxnum_512_patch_192/crossval_results_folds_0_1_2/PETCT_74bbceaeeb_06032005.nii.gz,/well/papiez/users/hri611/python/nnUnet_raw/Dataset219_PETCT/labelsTr/PETCT_74bbceaeeb_06032005.nii.gz,0.6338028169014085,0.0,0.0
234,,0,0,,38720000,0,0,0,/well/papiez/users/hri611/python/nnUNet_results/Dataset219_PETCT/nnUNetTrainer__nnUNetPlans__3d_fullres_maxnum_512_patch_192/crossval_results_folds_0_1_2/PETCT_75d5e740f0_07112002.nii.gz,/well/papiez/users/hri611/python/nnUnet_raw/Dataset219_PETCT/labelsTr/PETCT_75d5e740f0_07112002.nii.gz,,0.0,0.0
235,0.0,0,75,0.0,52159925,0,75,0,/well/papiez/users/hri611/python/nnUNet_results/Dataset219_PETCT/nnUNetTrainer__nnUNetPlans__3d_fullres_maxnum_512_patch_192/crossval_results_folds_0_1_2/PETCT_75e42ff05f_09212002.nii.gz,/well/papiez/users/hri611/python/nnUnet_raw/Dataset219_PETCT/labelsTr/PETCT_75e42ff05f_09212002.nii.gz,0.0,0.9330765724182128,0.0
236,0.0,0,31,0.0,45439969,0,31,0,/well/papiez/users/hri611/python/nnUNet_results/Dataset219_PETCT/nnUNetTrainer__nnUNetPlans__3d_fullres_maxnum_512_patch_192/crossval_results_folds_0_1_2/PETCT_777fa0ba88_11042002.nii.gz,/well/papiez/users/hri611/python/nnUnet_raw/Dataset219_PETCT/labelsTr/PETCT_777fa0ba88_11042002.nii.gz,0.0,0.3856716499328613,0.0
237,0.5901639344262295,122,178,0.4186046511627907,97279484,216,394,338,/well/papiez/users/hri611/python/nnUNet_results/Dataset219_PETCT/nnUNetTrainer__nnUNetPlans__3d_fullres_maxnum_512_patch_192/crossval_results_folds_0_1_2/PETCT_7785c10e91_12152006.nii.gz,/well/papiez/users/hri611/python/nnUnet_raw/Dataset219_PETCT/labelsTr/PETCT_7785c10e91_12152006.nii.gz,0.5901639344262295,1.9407992706298827,0.0
238,0.7891293407146452,5,2928,0.6517040731504572,45431579,5488,8416,5493,/well/papiez/users/hri611/python/nnUNet_results/Dataset219_PETCT/nnUNetTrainer__nnUNetPlans__3d_fullres_maxnum_512_patch_192/crossval_results_folds_0_1_2/PETCT_790246c76c_02072004.nii.gz,/well/papiez/users/hri611/python/nnUnet_raw/Dataset219_PETCT/labelsTr/PETCT_790246c76c_02072004.nii.gz,0.7891293407146452,0.3856716499328613,0.0
239,0.6501379714022911,7675,693,0.48163290590348756,45423857,7775,8468,15450,/well/papiez/users/hri611/python/nnUNet_results/Dataset219_PETCT/nnUNetTrainer__nnUNetPlans__3d_fullres_maxnum_512_patch_192/crossval_results_folds_0_1_2/PETCT_7948aa0e26_08102001.nii.gz,/well/papiez/users/hri611/python/nnUnet_raw/Dataset219_PETCT/labelsTr/PETCT_7948aa0e26_08102001.nii.gz,0.6501379714022911,0.0,13.349215496063232
240,,0,0,,45440000,0,0,0,/well/papiez/users/hri611/python/nnUNet_results/Dataset219_PETCT/nnUNetTrainer__nnUNetPlans__3d_fullres_maxnum_512_patch_192/crossval_results_folds_0_1_2/PETCT_7978e9fe62_03232003.nii.gz,/well/papiez/users/hri611/python/nnUnet_raw/Dataset219_PETCT/labelsTr/PETCT_7978e9fe62_03232003.nii.gz,,0.0,0.0
241,,0,0,,49120000,0,0,0,/well/papiez/users/hri611/python/nnUNet_results/Dataset219_PETCT/nnUNetTrainer__nnUNetPlans__3d_fullres_maxnum_512_patch_192/crossval_results_folds_0_1_2/PETCT_7a262070a9_11252005.nii.gz,/well/papiez/users/hri611/python/nnUnet_raw/Dataset219_PETCT/labelsTr/PETCT_7a262070a9_11252005.nii.gz,,0.0,0.0
242,0.7159579910324697,7954,1485,0.557581438950082,45418665,11896,13381,19850,/well/papiez/users/hri611/python/nnUNet_results/Dataset219_PETCT/nnUNetTrainer__nnUNetPlans__3d_fullres_maxnum_512_patch_192/crossval_results_folds_0_1_2/PETCT_7a77b26403_10202000.nii.gz,/well/papiez/users/hri611/python/nnUnet_raw/Dataset219_PETCT/labelsTr/PETCT_7a77b26403_10202000.nii.gz,0.7159579910324697,0.0,21.199499725341795
243,0.8317971755350735,5561,954,0.7120314710042432,99017376,16109,17063,21670,/well/papiez/users/hri611/python/nnUNet_results/Dataset219_PETCT/nnUNetTrainer__nnUNetPlans__3d_fullres_maxnum_512_patch_192/crossval_results_folds_0_1_2/PETCT_7b477e7e0d_07262002.nii.gz,/well/papiez/users/hri611/python/nnUnet_raw/Dataset219_PETCT/labelsTr/PETCT_7b477e7e0d_07262002.nii.gz,0.8317971755350735,0.9952816772460937,4.752470008850097
244,,0,0,,52160000,0,0,0,/well/papiez/users/hri611/python/nnUNet_results/Dataset219_PETCT/nnUNetTrainer__nnUNetPlans__3d_fullres_maxnum_512_patch_192/crossval_results_folds_0_1_2/PETCT_7b9d625330_11172002.nii.gz,/well/papiez/users/hri611/python/nnUnet_raw/Dataset219_PETCT/labelsTr/PETCT_7b9d625330_11172002.nii.gz,,0.0,0.0
245,0.0,0,7,0.0,99039993,0,7,0,/well/papiez/users/hri611/python/nnUNet_results/Dataset219_PETCT/nnUNetTrainer__nnUNetPlans__3d_fullres_maxnum_512_patch_192/crossval_results_folds_0_1_2/PETCT_7c1e6175e0_01302005.nii.gz,/well/papiez/users/hri611/python/nnUnet_raw/Dataset219_PETCT/labelsTr/PETCT_7c1e6175e0_01302005.nii.gz,0.0,0.0870871467590332,0.0
246,0.0,0,1407,0.0,52158593,0,1407,0,/well/papiez/users/hri611/python/nnUNet_results/Dataset219_PETCT/nnUNetTrainer__nnUNetPlans__3d_fullres_maxnum_512_patch_192/crossval_results_folds_0_1_2/PETCT_7c96c4626d_06302003.nii.gz,/well/papiez/users/hri611/python/nnUnet_raw/Dataset219_PETCT/labelsTr/PETCT_7c96c4626d_06302003.nii.gz,0.0,17.504516498565675,0.0
247,0.746915638546182,824,2212,0.5960617349654072,92152484,4480,6692,5304,/well/papiez/users/hri611/python/nnUNet_results/Dataset219_PETCT/nnUNetTrainer__nnUNetPlans__3d_fullres_maxnum_512_patch_192/crossval_results_folds_0_1_2/PETCT_7cfd708a53_06172005.nii.gz,/well/papiez/users/hri611/python/nnUnet_raw/Dataset219_PETCT/labelsTr/PETCT_7cfd708a53_06172005.nii.gz,0.746915638546182,11.196918869018555,2.9111989059448242
248,0.11880303707012059,1707,266,0.06315289648622982,52157894,133,399,1840,/well/papiez/users/hri611/python/nnUNet_results/Dataset219_PETCT/nnUNetTrainer__nnUNetPlans__3d_fullres_maxnum_512_patch_192/crossval_results_folds_0_1_2/PETCT_7d01eb835d_03312002.nii.gz,/well/papiez/users/hri611/python/nnUnet_raw/Dataset219_PETCT/labelsTr/PETCT_7d01eb835d_03312002.nii.gz,0.11880303707012059,3.1600193252563478,21.211940746307373
249,,0,0,,52160000,0,0,0,/well/papiez/users/hri611/python/nnUNet_results/Dataset219_PETCT/nnUNetTrainer__nnUNetPlans__3d_fullres_maxnum_512_patch_192/crossval_results_folds_0_1_2/PETCT_7d8aa1e94d_10042002.nii.gz,/well/papiez/users/hri611/python/nnUnet_raw/Dataset219_PETCT/labelsTr/PETCT_7d8aa1e94d_10042002.nii.gz,,0.0,0.0
250,0.8198910560534177,2964,111,0.6947587849910661,52149926,6999,7110,9963,/well/papiez/users/hri611/python/nnUNet_results/Dataset219_PETCT/nnUNetTrainer__nnUNetPlans__3d_fullres_maxnum_512_patch_192/crossval_results_folds_0_1_2/PETCT_7d97f7a102_04212002.nii.gz,/well/papiez/users/hri611/python/nnUnet_raw/Dataset219_PETCT/labelsTr/PETCT_7d97f7a102_04212002.nii.gz,0.8198910560534177,0.0,0.0
251,,0,0,,46240000,0,0,0,/well/papiez/users/hri611/python/nnUNet_results/Dataset219_PETCT/nnUNetTrainer__nnUNetPlans__3d_fullres_maxnum_512_patch_192/crossval_results_folds_0_1_2/PETCT_7e56b0b62c_05272006.nii.gz,/well/papiez/users/hri611/python/nnUnet_raw/Dataset219_PETCT/labelsTr/PETCT_7e56b0b62c_05272006.nii.gz,,0.0,0.0
252,0.8396857724759965,540,562,0.7236710130391174,52156012,2886,3448,3426,/well/papiez/users/hri611/python/nnUNet_results/Dataset219_PETCT/nnUNetTrainer__nnUNetPlans__3d_fullres_maxnum_512_patch_192/crossval_results_folds_0_1_2/PETCT_7e5729ea40_02212003.nii.gz,/well/papiez/users/hri611/python/nnUnet_raw/Dataset219_PETCT/labelsTr/PETCT_7e5729ea40_02212003.nii.gz,0.8396857724759965,0.9206355514526368,0.0
253,0.8621190130624092,37,438,0.7576530612244898,52158040,1485,1923,1522,/well/papiez/users/hri611/python/nnUNet_results/Dataset219_PETCT/nnUNetTrainer__nnUNetPlans__3d_fullres_maxnum_512_patch_192/crossval_results_folds_0_1_2/PETCT_7ed037687a_01272003.nii.gz,/well/papiez/users/hri611/python/nnUnet_raw/Dataset219_PETCT/labelsTr/PETCT_7ed037687a_01272003.nii.gz,0.8621190130624092,0.04976408386230469,0.0
254,0.0,0,1036,0.0,52158964,0,1036,0,/well/papiez/users/hri611/python/nnUNet_results/Dataset219_PETCT/nnUNetTrainer__nnUNetPlans__3d_fullres_maxnum_512_patch_192/crossval_results_folds_0_1_2/PETCT_7ef5343426_05122005.nii.gz,/well/papiez/users/hri611/python/nnUnet_raw/Dataset219_PETCT/labelsTr/PETCT_7ef5343426_05122005.nii.gz,0.0,12.888897720336914,0.0
255,0.5012615643397813,484,702,0.3344556677890011,99038218,596,1298,1080,/well/papiez/users/hri611/python/nnUNet_results/Dataset219_PETCT/nnUNetTrainer__nnUNetPlans__3d_fullres_maxnum_512_patch_192/crossval_results_folds_0_1_2/PETCT_7f2a604e03_05052002.nii.gz,/well/papiez/users/hri611/python/nnUnet_raw/Dataset219_PETCT/labelsTr/PETCT_7f2a604e03_05052002.nii.gz,0.5012615643397813,7.365084411621094,1.7915070190429687
256,0.9210805084745762,179,119,0.8537064310260186,45437963,1739,1858,1918,/well/papiez/users/hri611/python/nnUNet_results/Dataset219_PETCT/nnUNetTrainer__nnUNetPlans__3d_fullres_maxnum_512_patch_192/crossval_results_folds_0_1_2/PETCT_7faf36a152_06142002.nii.gz,/well/papiez/users/hri611/python/nnUnet_raw/Dataset219_PETCT/labelsTr/PETCT_7faf36a152_06142002.nii.gz,0.9210805084745762,0.0,0.0
257,,0,0,,45440000,0,0,0,/well/papiez/users/hri611/python/nnUNet_results/Dataset219_PETCT/nnUNetTrainer__nnUNetPlans__3d_fullres_maxnum_512_patch_192/crossval_results_folds_0_1_2/PETCT_7faf36a152_11272005.nii.gz,/well/papiez/users/hri611/python/nnUnet_raw/Dataset219_PETCT/labelsTr/PETCT_7faf36a152_11272005.nii.gz,,0.0,0.0
258,,0,0,,38720000,0,0,0,/well/papiez/users/hri611/python/nnUNet_results/Dataset219_PETCT/nnUNetTrainer__nnUNetPlans__3d_fullres_maxnum_512_patch_192/crossval_results_folds_0_1_2/PETCT_80b8393c44_07222002.nii.gz,/well/papiez/users/hri611/python/nnUnet_raw/Dataset219_PETCT/labelsTr/PETCT_80b8393c44_07222002.nii.gz,,0.0,0.0
259,0.847740019795447,3718,1820,0.7357193987115247,52139045,15417,17237,19135,/well/papiez/users/hri611/python/nnUNet_results/Dataset219_PETCT/nnUNetTrainer__nnUNetPlans__3d_fullres_maxnum_512_patch_192/crossval_results_folds_0_1_2/PETCT_80d7e682f7_02112005.nii.gz,/well/papiez/users/hri611/python/nnUnet_raw/Dataset219_PETCT/labelsTr/PETCT_80d7e682f7_02112005.nii.gz,0.847740019795447,0.14929225158691406,0.19905633544921875
260,0.0,0,48,0.0,50559952,0,48,0,/well/papiez/users/hri611/python/nnUNet_results/Dataset219_PETCT/nnUNetTrainer__nnUNetPlans__3d_fullres_maxnum_512_patch_192/crossval_results_folds_0_1_2/PETCT_80f21e1ed0_11122006.nii.gz,/well/papiez/users/hri611/python/nnUnet_raw/Dataset219_PETCT/labelsTr/PETCT_80f21e1ed0_11122006.nii.gz,0.0,0.5971690063476562,0.0
261,0.0,0,60,0.0,92319940,0,60,0,/well/papiez/users/hri611/python/nnUNet_results/Dataset219_PETCT/nnUNetTrainer__nnUNetPlans__3d_fullres_maxnum_512_patch_192/crossval_results_folds_0_1_2/PETCT_80f7760f65_11142005.nii.gz,/well/papiez/users/hri611/python/nnUnet_raw/Dataset219_PETCT/labelsTr/PETCT_80f7760f65_11142005.nii.gz,0.0,0.7464612579345703,0.0
262,,0,0,,49920000,0,0,0,/well/papiez/users/hri611/python/nnUNet_results/Dataset219_PETCT/nnUNetTrainer__nnUNetPlans__3d_fullres_maxnum_512_patch_192/crossval_results_folds_0_1_2/PETCT_81debf13a1_03092006.nii.gz,/well/papiez/users/hri611/python/nnUnet_raw/Dataset219_PETCT/labelsTr/PETCT_81debf13a1_03092006.nii.gz,,0.0,0.0
263,0.7738427216954824,237,3007,0.6311121219012963,52151206,5550,8557,5787,/well/papiez/users/hri611/python/nnUNet_results/Dataset219_PETCT/nnUNetTrainer__nnUNetPlans__3d_fullres_maxnum_512_patch_192/crossval_results_folds_0_1_2/PETCT_82137245b0_01262002.nii.gz,/well/papiez/users/hri611/python/nnUnet_raw/Dataset219_PETCT/labelsTr/PETCT_82137245b0_01262002.nii.gz,0.7738427216954824,1.2814251594543458,0.012441020965576172
264,0.0,0,1294,0.0,47518706,0,1294,0,/well/papiez/users/hri611/python/nnUNet_results/Dataset219_PETCT/nnUNetTrainer__nnUNetPlans__3d_fullres_maxnum_512_patch_192/crossval_results_folds_0_1_2/PETCT_8311aeddb9_12162005.nii.gz,/well/papiez/users/hri611/python/nnUnet_raw/Dataset219_PETCT/labelsTr/PETCT_8311aeddb9_12162005.nii.gz,0.0,16.098681129455567,0.0
265,0.8888888888888888,1119,641,0.8,51991200,7040,7681,8159,/well/papiez/users/hri611/python/nnUNet_results/Dataset219_PETCT/nnUNetTrainer__nnUNetPlans__3d_fullres_maxnum_512_patch_192/crossval_results_folds_0_1_2/PETCT_84e7715ed9_01042002.nii.gz,/well/papiez/users/hri611/python/nnUnet_raw/Dataset219_PETCT/labelsTr/PETCT_84e7715ed9_01042002.nii.gz,0.8888888888888888,0.0,0.0
266,,0,0,,47360000,0,0,0,/well/papiez/users/hri611/python/nnUNet_results/Dataset219_PETCT/nnUNetTrainer__nnUNetPlans__3d_fullres_maxnum_512_patch_192/crossval_results_folds_0_1_2/PETCT_855c7fca12_07272006.nii.gz,/well/papiez/users/hri611/python/nnUnet_raw/Dataset219_PETCT/labelsTr/PETCT_855c7fca12_07272006.nii.gz,,0.0,0.0
267,,0,0,,46880000,0,0,0,/well/papiez/users/hri611/python/nnUNet_results/Dataset219_PETCT/nnUNetTrainer__nnUNetPlans__3d_fullres_maxnum_512_patch_192/crossval_results_folds_0_1_2/PETCT_85b69fed1c_01212006.nii.gz,/well/papiez/users/hri611/python/nnUnet_raw/Dataset219_PETCT/labelsTr/PETCT_85b69fed1c_01212006.nii.gz,,0.0,0.0
268,0.0,0,6,0.0,53599994,0,6,0,/well/papiez/users/hri611/python/nnUNet_results/Dataset219_PETCT/nnUNetTrainer__nnUNetPlans__3d_fullres_maxnum_512_patch_192/crossval_results_folds_0_1_2/PETCT_86153b2974_03192006.nii.gz,/well/papiez/users/hri611/python/nnUnet_raw/Dataset219_PETCT/labelsTr/PETCT_86153b2974_03192006.nii.gz,0.0,0.07464612579345703,0.0
269,,0,0,,53120000,0,0,0,/well/papiez/users/hri611/python/nnUNet_results/Dataset219_PETCT/nnUNetTrainer__nnUNetPlans__3d_fullres_maxnum_512_patch_192/crossval_results_folds_0_1_2/PETCT_86153b2974_10022005.nii.gz,/well/papiez/users/hri611/python/nnUnet_raw/Dataset219_PETCT/labelsTr/PETCT_86153b2974_10022005.nii.gz,,0.0,0.0
270,0.8512621359223301,83,2598,0.7410412440838404,45429647,7672,10270,7755,/well/papiez/users/hri611/python/nnUNet_results/Dataset219_PETCT/nnUNetTrainer__nnUNetPlans__3d_fullres_maxnum_512_patch_192/crossval_results_folds_0_1_2/PETCT_86e54ea60a_03182002.nii.gz,/well/papiez/users/hri611/python/nnUnet_raw/Dataset219_PETCT/labelsTr/PETCT_86e54ea60a_03182002.nii.gz,0.8512621359223301,5.971690063476562,0.58472798538208
271,0.6773120425815037,0,485,0.5120724346076458,45439006,509,994,509,/well/papiez/users/hri611/python/nnUNet_results/Dataset219_PETCT/nnUNetTrainer__nnUNetPlans__3d_fullres_maxnum_512_patch_192/crossval_results_folds_0_1_2/PETCT_870181d7fd_10312004.nii.gz,/well/papiez/users/hri611/python/nnUnet_raw/Dataset219_PETCT/labelsTr/PETCT_870181d7fd_10312004.nii.gz,0.6773120425815037,2.749465633392334,0.0
272,,0,0,,87200000,0,0,0,/well/papiez/users/hri611/python/nnUNet_results/Dataset219_PETCT/nnUNetTrainer__nnUNetPlans__3d_fullres_maxnum_512_patch_192/crossval_results_folds_0_1_2/PETCT_87afc291ec_01262006.nii.gz,/well/papiez/users/hri611/python/nnUnet_raw/Dataset219_PETCT/labelsTr/PETCT_87afc291ec_01262006.nii.gz,,0.0,0.0
273,0.0,0,314,0.0,85599686,0,314,0,/well/papiez/users/hri611/python/nnUNet_results/Dataset219_PETCT/nnUNetTrainer__nnUNetPlans__3d_fullres_maxnum_512_patch_192/crossval_results_folds_0_1_2/PETCT_87afc291ec_07202003.nii.gz,/well/papiez/users/hri611/python/nnUnet_raw/Dataset219_PETCT/labelsTr/PETCT_87afc291ec_07202003.nii.gz,0.0,3.906480583190918,0.0
274,0.8492745640862116,8974,1425,0.738034058847239,52120304,29297,30722,38271,/well/papiez/users/hri611/python/nnUNet_results/Dataset219_PETCT/nnUNetTrainer__nnUNetPlans__3d_fullres_maxnum_512_patch_192/crossval_results_folds_0_1_2/PETCT_88bcc970b3_02282002.nii.gz,/well/papiez/users/hri611/python/nnUnet_raw/Dataset219_PETCT/labelsTr/PETCT_88bcc970b3_02282002.nii.gz,0.8492745640862116,0.6966971740722656,18.773500637054443
275,0.5933734939759037,3,267,0.42184154175588867,92319533,197,464,200,/well/papiez/users/hri611/python/nnUNet_results/Dataset219_PETCT/nnUNetTrainer__nnUNetPlans__3d_fullres_maxnum_512_patch_192/crossval_results_folds_0_1_2/PETCT_89065bc4ab_02202004.nii.gz,/well/papiez/users/hri611/python/nnUnet_raw/Dataset219_PETCT/labelsTr/PETCT_89065bc4ab_02202004.nii.gz,0.5933734939759037,0.945517593383789,0.0
276,0.7979015050116846,12405,34554,0.6637571782497244,58740342,92699,127253,105104,/well/papiez/users/hri611/python/nnUNet_results/Dataset219_PETCT/nnUNetTrainer__nnUNetPlans__3d_fullres_maxnum_512_patch_192/crossval_results_folds_0_1_2/PETCT_8a52353a72_02172003.nii.gz,/well/papiez/users/hri611/python/nnUnet_raw/Dataset219_PETCT/labelsTr/PETCT_8a52353a72_02172003.nii.gz,0.7979015050116846,10.164314128875732,87.47281840896606
277,0.8902740937223695,2195,287,0.8022468329216795,45427449,10069,10356,12264,/well/papiez/users/hri611/python/nnUNet_results/Dataset219_PETCT/nnUNetTrainer__nnUNetPlans__3d_fullres_maxnum_512_patch_192/crossval_results_folds_0_1_2/PETCT_8aa48809ea_04162001.nii.gz,/well/papiez/users/hri611/python/nnUnet_raw/Dataset219_PETCT/labelsTr/PETCT_8aa48809ea_04162001.nii.gz,0.8902740937223695,0.0,0.04976408386230469
278,0.0,0,15,0.0,40639985,0,15,0,/well/papiez/users/hri611/python/nnUNet_results/Dataset219_PETCT/nnUNetTrainer__nnUNetPlans__3d_fullres_maxnum_512_patch_192/crossval_results_folds_0_1_2/PETCT_8af3757198_12032006.nii.gz,/well/papiez/users/hri611/python/nnUnet_raw/Dataset219_PETCT/labelsTr/PETCT_8af3757198_12032006.nii.gz,0.0,0.18661531448364257,0.0
279,0.0,0,42,0.0,92799958,0,42,0,/well/papiez/users/hri611/python/nnUNet_results/Dataset219_PETCT/nnUNetTrainer__nnUNetPlans__3d_fullres_maxnum_512_patch_192/crossval_results_folds_0_1_2/PETCT_8b14e6a819_01292006.nii.gz,/well/papiez/users/hri611/python/nnUnet_raw/Dataset219_PETCT/labelsTr/PETCT_8b14e6a819_01292006.nii.gz,0.0,0.5225228805541993,0.0
280,0.0,0,210,0.0,99039790,0,210,0,/well/papiez/users/hri611/python/nnUNet_results/Dataset219_PETCT/nnUNetTrainer__nnUNetPlans__3d_fullres_maxnum_512_patch_192/crossval_results_folds_0_1_2/PETCT_8b40e356dc_06182007.nii.gz,/well/papiez/users/hri611/python/nnUnet_raw/Dataset219_PETCT/labelsTr/PETCT_8b40e356dc_06182007.nii.gz,0.0,2.612614402770996,0.0
281,,0,0,,38720000,0,0,0,/well/papiez/users/hri611/python/nnUNet_results/Dataset219_PETCT/nnUNetTrainer__nnUNetPlans__3d_fullres_maxnum_512_patch_192/crossval_results_folds_0_1_2/PETCT_8b73608326_04042003.nii.gz,/well/papiez/users/hri611/python/nnUnet_raw/Dataset219_PETCT/labelsTr/PETCT_8b73608326_04042003.nii.gz,,0.0,0.0
282,0.8776269020982457,518,6953,0.7819386474416976,52125739,26790,33743,27308,/well/papiez/users/hri611/python/nnUNet_results/Dataset219_PETCT/nnUNetTrainer__nnUNetPlans__3d_fullres_maxnum_512_patch_192/crossval_results_folds_0_1_2/PETCT_8b74860ce6_03102005.nii.gz,/well/papiez/users/hri611/python/nnUnet_raw/Dataset219_PETCT/labelsTr/PETCT_8b74860ce6_03102005.nii.gz,0.8776269020982457,2.413558067321777,0.07464612579345703
283,0.0,0,7713,0.0,49272287,0,7713,0,/well/papiez/users/hri611/python/nnUNet_results/Dataset219_PETCT/nnUNetTrainer__nnUNetPlans__3d_fullres_maxnum_512_patch_192/crossval_results_folds_0_1_2/PETCT_8bf08c9a42_06092006.nii.gz,/well/papiez/users/hri611/python/nnUnet_raw/Dataset219_PETCT/labelsTr/PETCT_8bf08c9a42_06092006.nii.gz,0.0,95.95759470748901,0.0
284,0.0,0,50,0.0,49919950,0,50,0,/well/papiez/users/hri611/python/nnUNet_results/Dataset219_PETCT/nnUNetTrainer__nnUNetPlans__3d_fullres_maxnum_512_patch_192/crossval_results_folds_0_1_2/PETCT_8c5d99b459_05042007.nii.gz,/well/papiez/users/hri611/python/nnUnet_raw/Dataset219_PETCT/labelsTr/PETCT_8c5d99b459_05042007.nii.gz,0.0,0.6220510482788086,0.0
285,0.7530207829869502,501,10,0.603875968992248,52158710,779,789,1280,/well/papiez/users/hri611/python/nnUNet_results/Dataset219_PETCT/nnUNetTrainer__nnUNetPlans__3d_fullres_maxnum_512_patch_192/crossval_results_folds_0_1_2/PETCT_8c8cd2699c_01182004.nii.gz,/well/papiez/users/hri611/python/nnUnet_raw/Dataset219_PETCT/labelsTr/PETCT_8c8cd2699c_01182004.nii.gz,0.7530207829869502,0.07464612579345703,0.0
286,0.835186532266445,1536,7980,0.7170131144615933,52126373,24111,32091,25647,/well/papiez/users/hri611/python/nnUNet_results/Dataset219_PETCT/nnUNetTrainer__nnUNetPlans__3d_fullres_maxnum_512_patch_192/crossval_results_folds_0_1_2/PETCT_8de6953d23_01192001.nii.gz,/well/papiez/users/hri611/python/nnUnet_raw/Dataset219_PETCT/labelsTr/PETCT_8de6953d23_01192001.nii.gz,0.835186532266445,1.1196918869018555,0.024882041931152343
287,0.8008752735229759,0,91,0.6678832116788321,52159726,183,274,183,/well/papiez/users/hri611/python/nnUNet_results/Dataset219_PETCT/nnUNetTrainer__nnUNetPlans__3d_fullres_maxnum_512_patch_192/crossval_results_folds_0_1_2/PETCT_8e905366fe_04272001.nii.gz,/well/papiez/users/hri611/python/nnUnet_raw/Dataset219_PETCT/labelsTr/PETCT_8e905366fe_04272001.nii.gz,0.8008752735229759,0.0,0.0
288,0.6793430518953419,57290,384,0.5143978175939647,52041232,61094,61478,118384,/well/papiez/users/hri611/python/nnUNet_results/Dataset219_PETCT/nnUNetTrainer__nnUNetPlans__3d_fullres_maxnum_512_patch_192/crossval_results_folds_0_1_2/PETCT_8ec13728df_10141999.nii.gz,/well/papiez/users/hri611/python/nnUnet_raw/Dataset219_PETCT/labelsTr/PETCT_8ec13728df_10141999.nii.gz,0.6793430518953419,0.0,177.4587230529785
289,,0,0,,52160000,0,0,0,/well/papiez/users/hri611/python/nnUNet_results/Dataset219_PETCT/nnUNetTrainer__nnUNetPlans__3d_fullres_maxnum_512_patch_192/crossval_results_folds_0_1_2/PETCT_8f2878df50_02212003.nii.gz,/well/papiez/users/hri611/python/nnUnet_raw/Dataset219_PETCT/labelsTr/PETCT_8f2878df50_02212003.nii.gz,,0.0,0.0
290,,0,0,,37760000,0,0,0,/well/papiez/users/hri611/python/nnUNet_results/Dataset219_PETCT/nnUNetTrainer__nnUNetPlans__3d_fullres_maxnum_512_patch_192/crossval_results_folds_0_1_2/PETCT_8fea5f0537_09262005.nii.gz,/well/papiez/users/hri611/python/nnUnet_raw/Dataset219_PETCT/labelsTr/PETCT_8fea5f0537_09262005.nii.gz,,0.0,0.0
291,0.6829318089015924,4655,4663,0.5185242598046814,52140647,10035,14698,14690,/well/papiez/users/hri611/python/nnUNet_results/Dataset219_PETCT/nnUNetTrainer__nnUNetPlans__3d_fullres_maxnum_512_patch_192/crossval_results_folds_0_1_2/PETCT_901573a747_05132005.nii.gz,/well/papiez/users/hri611/python/nnUnet_raw/Dataset219_PETCT/labelsTr/PETCT_901573a747_05132005.nii.gz,0.6829318089015924,17.927511211395263,7.651227893829345
292,,0,0,,45440000,0,0,0,/well/papiez/users/hri611/python/nnUNet_results/Dataset219_PETCT/nnUNetTrainer__nnUNetPlans__3d_fullres_maxnum_512_patch_192/crossval_results_folds_0_1_2/PETCT_90d668ed29_06072003.nii.gz,/well/papiez/users/hri611/python/nnUnet_raw/Dataset219_PETCT/labelsTr/PETCT_90d668ed29_06072003.nii.gz,,0.0,0.0
293,0.8342376767290791,4020,318,0.7156155762422971,52144746,10916,11234,14936,/well/papiez/users/hri611/python/nnUNet_results/Dataset219_PETCT/nnUNetTrainer__nnUNetPlans__3d_fullres_maxnum_512_patch_192/crossval_results_folds_0_1_2/PETCT_90ea6a6aaf_07272001.nii.gz,/well/papiez/users/hri611/python/nnUnet_raw/Dataset219_PETCT/labelsTr/PETCT_90ea6a6aaf_07272001.nii.gz,0.8342376767290791,2.3513529624938965,0.19905633544921875
294,0.7331628303495311,35,278,0.5787348586810229,90079257,430,708,465,/well/papiez/users/hri611/python/nnUNet_results/Dataset219_PETCT/nnUNetTrainer__nnUNetPlans__3d_fullres_maxnum_512_patch_192/crossval_results_folds_0_1_2/PETCT_912a25778f_05172007.nii.gz,/well/papiez/users/hri611/python/nnUnet_raw/Dataset219_PETCT/labelsTr/PETCT_912a25778f_05172007.nii.gz,0.7331628303495311,3.1226962623596193,0.0
295,0.8580645161290322,34,10,0.751412429378531,47999823,133,143,167,/well/papiez/users/hri611/python/nnUNet_results/Dataset219_PETCT/nnUNetTrainer__nnUNetPlans__3d_fullres_maxnum_512_patch_192/crossval_results_folds_0_1_2/PETCT_91cfa804b0_09222006.nii.gz,/well/papiez/users/hri611/python/nnUnet_raw/Dataset219_PETCT/labelsTr/PETCT_91cfa804b0_09222006.nii.gz,0.8580645161290322,0.012441020965576172,0.23637939834594726
296,0.7216404200413179,77046,834,0.5645050354804256,45261169,100951,101785,177997,/well/papiez/users/hri611/python/nnUNet_results/Dataset219_PETCT/nnUNetTrainer__nnUNetPlans__3d_fullres_maxnum_512_patch_192/crossval_results_folds_0_1_2/PETCT_92c5c944a5_07152002.nii.gz,/well/papiez/users/hri611/python/nnUnet_raw/Dataset219_PETCT/labelsTr/PETCT_92c5c944a5_07152002.nii.gz,0.7216404200413179,0.0,60.78682843780518
297,0.9103690685413005,2,100,0.8354838709677419,49759380,518,618,520,/well/papiez/users/hri611/python/nnUNet_results/Dataset219_PETCT/nnUNetTrainer__nnUNetPlans__3d_fullres_maxnum_512_patch_192/crossval_results_folds_0_1_2/PETCT_94962fe878_06012007.nii.gz,/well/papiez/users/hri611/python/nnUnet_raw/Dataset219_PETCT/labelsTr/PETCT_94962fe878_06012007.nii.gz,0.9103690685413005,0.8459894256591797,0.0
298,0.0,84,23,0.0,102719893,0,23,84,/well/papiez/users/hri611/python/nnUNet_results/Dataset219_PETCT/nnUNetTrainer__nnUNetPlans__3d_fullres_maxnum_512_patch_192/crossval_results_folds_0_1_2/PETCT_94cc0dac49_03092007.nii.gz,/well/papiez/users/hri611/python/nnUnet_raw/Dataset219_PETCT/labelsTr/PETCT_94cc0dac49_03092007.nii.gz,0.0,0.2861434822082519,1.0450457611083985
299,,0,0,,50880000,0,0,0,/well/papiez/users/hri611/python/nnUNet_results/Dataset219_PETCT/nnUNetTrainer__nnUNetPlans__3d_fullres_maxnum_512_patch_192/crossval_results_folds_0_1_2/PETCT_94cc0dac49_03102006.nii.gz,/well/papiez/users/hri611/python/nnUnet_raw/Dataset219_PETCT/labelsTr/PETCT_94cc0dac49_03102006.nii.gz,,0.0,0.0
300,,0,0,,45440000,0,0,0,/well/papiez/users/hri611/python/nnUNet_results/Dataset219_PETCT/nnUNetTrainer__nnUNetPlans__3d_fullres_maxnum_512_patch_192/crossval_results_folds_0_1_2/PETCT_956520090b_11012003.nii.gz,/well/papiez/users/hri611/python/nnUnet_raw/Dataset219_PETCT/labelsTr/PETCT_956520090b_11012003.nii.gz,,0.0,0.0
301,0.32558139534883723,102,14,0.19444444444444445,85599856,28,42,130,/well/papiez/users/hri611/python/nnUNet_results/Dataset219_PETCT/nnUNetTrainer__nnUNetPlans__3d_fullres_maxnum_512_patch_192/crossval_results_folds_0_1_2/PETCT_95efdaba3c_10112003.nii.gz,/well/papiez/users/hri611/python/nnUnet_raw/Dataset219_PETCT/labelsTr/PETCT_95efdaba3c_10112003.nii.gz,0.32558139534883723,0.09952816772460937,1.2689841384887695
302,,0,0,,58880000,0,0,0,/well/papiez/users/hri611/python/nnUNet_results/Dataset219_PETCT/nnUNetTrainer__nnUNetPlans__3d_fullres_maxnum_512_patch_192/crossval_results_folds_0_1_2/PETCT_960c5f4262_01162003.nii.gz,/well/papiez/users/hri611/python/nnUnet_raw/Dataset219_PETCT/labelsTr/PETCT_960c5f4262_01162003.nii.gz,,0.0,0.0
303,,0,0,,52160000,0,0,0,/well/papiez/users/hri611/python/nnUNet_results/Dataset219_PETCT/nnUNetTrainer__nnUNetPlans__3d_fullres_maxnum_512_patch_192/crossval_results_folds_0_1_2/PETCT_960c5f4262_02252005.nii.gz,/well/papiez/users/hri611/python/nnUnet_raw/Dataset219_PETCT/labelsTr/PETCT_960c5f4262_02252005.nii.gz,,0.0,0.0
304,0.9438236373530416,3226,1213,0.8936231397828848,45398271,37290,38503,40516,/well/papiez/users/hri611/python/nnUNet_results/Dataset219_PETCT/nnUNetTrainer__nnUNetPlans__3d_fullres_maxnum_512_patch_192/crossval_results_folds_0_1_2/PETCT_97320b0b58_04172005.nii.gz,/well/papiez/users/hri611/python/nnUnet_raw/Dataset219_PETCT/labelsTr/PETCT_97320b0b58_04172005.nii.gz,0.9438236373530416,0.5225228805541993,0.870871467590332
305,0.0,0,404,0.0,42879596,0,404,0,/well/papiez/users/hri611/python/nnUNet_results/Dataset219_PETCT/nnUNetTrainer__nnUNetPlans__3d_fullres_maxnum_512_patch_192/crossval_results_folds_0_1_2/PETCT_97320b0b58_07282005.nii.gz,/well/papiez/users/hri611/python/nnUnet_raw/Dataset219_PETCT/labelsTr/PETCT_97320b0b58_07282005.nii.gz,0.0,5.0261724700927735,0.0
306,0.8943140833129769,2534,4821,0.8088319384519416,45401526,31119,35940,33653,/well/papiez/users/hri611/python/nnUNet_results/Dataset219_PETCT/nnUNetTrainer__nnUNetPlans__3d_fullres_maxnum_512_patch_192/crossval_results_folds_0_1_2/PETCT_9775598501_05042001.nii.gz,/well/papiez/users/hri611/python/nnUnet_raw/Dataset219_PETCT/labelsTr/PETCT_9775598501_05042001.nii.gz,0.8943140833129769,1.7168608932495117,4.93908532333374
307,0.9030714000797766,187,56,0.8232727272727273,88158625,1132,1188,1319,/well/papiez/users/hri611/python/nnUNet_results/Dataset219_PETCT/nnUNetTrainer__nnUNetPlans__3d_fullres_maxnum_512_patch_192/crossval_results_folds_0_1_2/PETCT_979f9c3dba_06222006.nii.gz,/well/papiez/users/hri611/python/nnUnet_raw/Dataset219_PETCT/labelsTr/PETCT_979f9c3dba_06222006.nii.gz,0.9030714000797766,0.012441020965576172,0.0
308,0.0,0,163,0.0,52159837,0,163,0,/well/papiez/users/hri611/python/nnUNet_results/Dataset219_PETCT/nnUNetTrainer__nnUNetPlans__3d_fullres_maxnum_512_patch_192/crossval_results_folds_0_1_2/PETCT_9860ffe82d_11192004.nii.gz,/well/papiez/users/hri611/python/nnUnet_raw/Dataset219_PETCT/labelsTr/PETCT_9860ffe82d_11192004.nii.gz,0.0,2.027886417388916,0.0
309,0.9250963489256993,7453,1740,0.8606318789606137,45374038,56769,58509,64222,/well/papiez/users/hri611/python/nnUNet_results/Dataset219_PETCT/nnUNetTrainer__nnUNetPlans__3d_fullres_maxnum_512_patch_192/crossval_results_folds_0_1_2/PETCT_98c6af8b90_05262003.nii.gz,/well/papiez/users/hri611/python/nnUnet_raw/Dataset219_PETCT/labelsTr/PETCT_98c6af8b90_05262003.nii.gz,0.9250963489256993,0.0,0.0
310,0.0,0,16,0.0,52159984,0,16,0,/well/papiez/users/hri611/python/nnUNet_results/Dataset219_PETCT/nnUNetTrainer__nnUNetPlans__3d_fullres_maxnum_512_patch_192/crossval_results_folds_0_1_2/PETCT_98cd91d44e_09062003.nii.gz,/well/papiez/users/hri611/python/nnUnet_raw/Dataset219_PETCT/labelsTr/PETCT_98cd91d44e_09062003.nii.gz,0.0,0.19905633544921875,0.0
311,0.0,0,42,0.0,58879958,0,42,0,/well/papiez/users/hri611/python/nnUNet_results/Dataset219_PETCT/nnUNetTrainer__nnUNetPlans__3d_fullres_maxnum_512_patch_192/crossval_results_folds_0_1_2/PETCT_9902caa7ec_08132006.nii.gz,/well/papiez/users/hri611/python/nnUnet_raw/Dataset219_PETCT/labelsTr/PETCT_9902caa7ec_08132006.nii.gz,0.0,0.5225228805541993,0.0
312,,0,0,,48160000,0,0,0,/well/papiez/users/hri611/python/nnUNet_results/Dataset219_PETCT/nnUNetTrainer__nnUNetPlans__3d_fullres_maxnum_512_patch_192/crossval_results_folds_0_1_2/PETCT_9a2bfe901f_08062005.nii.gz,/well/papiez/users/hri611/python/nnUnet_raw/Dataset219_PETCT/labelsTr/PETCT_9a2bfe901f_08062005.nii.gz,,0.0,0.0
313,0.7931871542838951,183,5014,0.6572577985886698,45424837,9966,14980,10149,/well/papiez/users/hri611/python/nnUNet_results/Dataset219_PETCT/nnUNetTrainer__nnUNetPlans__3d_fullres_maxnum_512_patch_192/crossval_results_folds_0_1_2/PETCT_9a2c6e618a_02142000.nii.gz,/well/papiez/users/hri611/python/nnUnet_raw/Dataset219_PETCT/labelsTr/PETCT_9a2c6e618a_02142000.nii.gz,0.7931871542838951,0.7837843208312988,0.012441020965576172
314,,0,0,,45440000,0,0,0,/well/papiez/users/hri611/python/nnUNet_results/Dataset219_PETCT/nnUNetTrainer__nnUNetPlans__3d_fullres_maxnum_512_patch_192/crossval_results_folds_0_1_2/PETCT_9a418f3b3a_05112003.nii.gz,/well/papiez/users/hri611/python/nnUnet_raw/Dataset219_PETCT/labelsTr/PETCT_9a418f3b3a_05112003.nii.gz,,0.0,0.0
315,0.0,0,97,0.0,51679903,0,97,0,/well/papiez/users/hri611/python/nnUNet_results/Dataset219_PETCT/nnUNetTrainer__nnUNetPlans__3d_fullres_maxnum_512_patch_192/crossval_results_folds_0_1_2/PETCT_9a66a81ad1_05132006.nii.gz,/well/papiez/users/hri611/python/nnUnet_raw/Dataset219_PETCT/labelsTr/PETCT_9a66a81ad1_05132006.nii.gz,0.0,1.2067790336608886,0.0
316,,0,0,,52960000,0,0,0,/well/papiez/users/hri611/python/nnUNet_results/Dataset219_PETCT/nnUNetTrainer__nnUNetPlans__3d_fullres_maxnum_512_patch_192/crossval_results_folds_0_1_2/PETCT_9a66a81ad1_10212005.nii.gz,/well/papiez/users/hri611/python/nnUnet_raw/Dataset219_PETCT/labelsTr/PETCT_9a66a81ad1_10212005.nii.gz,,0.0,0.0
317,,0,0,,105760000,0,0,0,/well/papiez/users/hri611/python/nnUNet_results/Dataset219_PETCT/nnUNetTrainer__nnUNetPlans__3d_fullres_maxnum_512_patch_192/crossval_results_folds_0_1_2/PETCT_9a66a81ad1_10312004.nii.gz,/well/papiez/users/hri611/python/nnUnet_raw/Dataset219_PETCT/labelsTr/PETCT_9a66a81ad1_10312004.nii.gz,,0.0,0.0
318,0.0,0,319,0.0,52159681,0,319,0,/well/papiez/users/hri611/python/nnUNet_results/Dataset219_PETCT/nnUNetTrainer__nnUNetPlans__3d_fullres_maxnum_512_patch_192/crossval_results_folds_0_1_2/PETCT_9a83943958_08032003.nii.gz,/well/papiez/users/hri611/python/nnUnet_raw/Dataset219_PETCT/labelsTr/PETCT_9a83943958_08032003.nii.gz,0.0,3.9686856880187986,0.0
319,0.7730262376825359,7832,1727,0.6300267058869063,52134163,16278,18005,24110,/well/papiez/users/hri611/python/nnUNet_results/Dataset219_PETCT/nnUNetTrainer__nnUNetPlans__3d_fullres_maxnum_512_patch_192/crossval_results_folds_0_1_2/PETCT_9aa97cf103_07182004.nii.gz,/well/papiez/users/hri611/python/nnUnet_raw/Dataset219_PETCT/labelsTr/PETCT_9aa97cf103_07182004.nii.gz,0.7730262376825359,1.0326047401428222,1.3809533271789551
320,0.7993827160493827,99,161,0.6658097686375322,52159222,518,679,617,/well/papiez/users/hri611/python/nnUNet_results/Dataset219_PETCT/nnUNetTrainer__nnUNetPlans__3d_fullres_maxnum_512_patch_192/crossval_results_folds_0_1_2/PETCT_9abb9583ec_05302002.nii.gz,/well/papiez/users/hri611/python/nnUnet_raw/Dataset219_PETCT/labelsTr/PETCT_9abb9583ec_05302002.nii.gz,0.7993827160493827,0.0,0.3981126708984375
321,,0,0,,52160000,0,0,0,/well/papiez/users/hri611/python/nnUNet_results/Dataset219_PETCT/nnUNetTrainer__nnUNetPlans__3d_fullres_maxnum_512_patch_192/crossval_results_folds_0_1_2/PETCT_9ad7dffae6_05222003.nii.gz,/well/papiez/users/hri611/python/nnUnet_raw/Dataset219_PETCT/labelsTr/PETCT_9ad7dffae6_05222003.nii.gz,,0.0,0.0
322,,0,0,,52160000,0,0,0,/well/papiez/users/hri611/python/nnUNet_results/Dataset219_PETCT/nnUNetTrainer__nnUNetPlans__3d_fullres_maxnum_512_patch_192/crossval_results_folds_0_1_2/PETCT_9b1bb2165a_10132002.nii.gz,/well/papiez/users/hri611/python/nnUnet_raw/Dataset219_PETCT/labelsTr/PETCT_9b1bb2165a_10132002.nii.gz,,0.0,0.0
323,,0,0,,99040000,0,0,0,/well/papiez/users/hri611/python/nnUNet_results/Dataset219_PETCT/nnUNetTrainer__nnUNetPlans__3d_fullres_maxnum_512_patch_192/crossval_results_folds_0_1_2/PETCT_9c68e484a7_08142003.nii.gz,/well/papiez/users/hri611/python/nnUnet_raw/Dataset219_PETCT/labelsTr/PETCT_9c68e484a7_08142003.nii.gz,,0.0,0.0
324,0.9324210170636932,230,1370,0.8733976895078335,45427362,11038,12408,11268,/well/papiez/users/hri611/python/nnUNet_results/Dataset219_PETCT/nnUNetTrainer__nnUNetPlans__3d_fullres_maxnum_512_patch_192/crossval_results_folds_0_1_2/PETCT_9c8842d12e_01252004.nii.gz,/well/papiez/users/hri611/python/nnUnet_raw/Dataset219_PETCT/labelsTr/PETCT_9c8842d12e_01252004.nii.gz,0.9324210170636932,0.9828406562805175,0.04976408386230469
325,0.7213735793718685,4293,267,0.564178533881296,52149537,5903,6170,10196,/well/papiez/users/hri611/python/nnUNet_results/Dataset219_PETCT/nnUNetTrainer__nnUNetPlans__3d_fullres_maxnum_512_patch_192/crossval_results_folds_0_1_2/PETCT_9c9a347388_09092000.nii.gz,/well/papiez/users/hri611/python/nnUnet_raw/Dataset219_PETCT/labelsTr/PETCT_9c9a347388_09092000.nii.gz,0.7213735793718685,0.0,1.8288300819396972
326,0.35650941486130794,15821,70,0.21692209136155324,52139707,4402,4472,20223,/well/papiez/users/hri611/python/nnUNet_results/Dataset219_PETCT/nnUNetTrainer__nnUNetPlans__3d_fullres_maxnum_512_patch_192/crossval_results_folds_0_1_2/PETCT_9da159b835_03232002.nii.gz,/well/papiez/users/hri611/python/nnUnet_raw/Dataset219_PETCT/labelsTr/PETCT_9da159b835_03232002.nii.gz,0.35650941486130794,0.0,74.73321294021606
327,0.0,0,119,0.0,52159881,0,119,0,/well/papiez/users/hri611/python/nnUNet_results/Dataset219_PETCT/nnUNetTrainer__nnUNetPlans__3d_fullres_maxnum_512_patch_192/crossval_results_folds_0_1_2/PETCT_9e864bb710_09142003.nii.gz,/well/papiez/users/hri611/python/nnUnet_raw/Dataset219_PETCT/labelsTr/PETCT_9e864bb710_09142003.nii.gz,0.0,1.4804814949035645,0.0
328,0.9593936112615051,1989,1836,0.9219562955254943,52110989,45186,47022,47175,/well/papiez/users/hri611/python/nnUNet_results/Dataset219_PETCT/nnUNetTrainer__nnUNetPlans__3d_fullres_maxnum_512_patch_192/crossval_results_folds_0_1_2/PETCT_9f206193d3_04072003.nii.gz,/well/papiez/users/hri611/python/nnUnet_raw/Dataset219_PETCT/labelsTr/PETCT_9f206193d3_04072003.nii.gz,0.9593936112615051,0.4105536918640137,0.5474049224853516
329,,0,0,,48160000,0,0,0,/well/papiez/users/hri611/python/nnUNet_results/Dataset219_PETCT/nnUNetTrainer__nnUNetPlans__3d_fullres_maxnum_512_patch_192/crossval_results_folds_0_1_2/PETCT_9f491f1481_02122006.nii.gz,/well/papiez/users/hri611/python/nnUnet_raw/Dataset219_PETCT/labelsTr/PETCT_9f491f1481_02122006.nii.gz,,0.0,0.0
330,,0,0,,52160000,0,0,0,/well/papiez/users/hri611/python/nnUNet_results/Dataset219_PETCT/nnUNetTrainer__nnUNetPlans__3d_fullres_maxnum_512_patch_192/crossval_results_folds_0_1_2/PETCT_9f6e8b1b43_11162002.nii.gz,/well/papiez/users/hri611/python/nnUnet_raw/Dataset219_PETCT/labelsTr/PETCT_9f6e8b1b43_11162002.nii.gz,,0.0,0.0
331,0.8,58,18,0.6666666666666666,52159772,152,170,210,/well/papiez/users/hri611/python/nnUNet_results/Dataset219_PETCT/nnUNetTrainer__nnUNetPlans__3d_fullres_maxnum_512_patch_192/crossval_results_folds_0_1_2/PETCT_9f7c68f5ca_12212001.nii.gz,/well/papiez/users/hri611/python/nnUnet_raw/Dataset219_PETCT/labelsTr/PETCT_9f7c68f5ca_12212001.nii.gz,0.8,0.0,0.0
332,0.8267347807577693,398,9,0.704644412191582,49758622,971,980,1369,/well/papiez/users/hri611/python/nnUNet_results/Dataset219_PETCT/nnUNetTrainer__nnUNetPlans__3d_fullres_maxnum_512_patch_192/crossval_results_folds_0_1_2/PETCT_9ffd8409b3_07152005.nii.gz,/well/papiez/users/hri611/python/nnUnet_raw/Dataset219_PETCT/labelsTr/PETCT_9ffd8409b3_07152005.nii.gz,0.8267347807577693,0.07464612579345703,1.7666249771118163
333,,0,0,,51040000,0,0,0,/well/papiez/users/hri611/python/nnUNet_results/Dataset219_PETCT/nnUNetTrainer__nnUNetPlans__3d_fullres_maxnum_512_patch_192/crossval_results_folds_0_1_2/PETCT_a09210d96b_12112005.nii.gz,/well/papiez/users/hri611/python/nnUnet_raw/Dataset219_PETCT/labelsTr/PETCT_a09210d96b_12112005.nii.gz,,0.0,0.0
334,0.9362885508495787,1134,1157,0.8802091503267974,52140875,16834,17991,17968,/well/papiez/users/hri611/python/nnUNet_results/Dataset219_PETCT/nnUNetTrainer__nnUNetPlans__3d_fullres_maxnum_512_patch_192/crossval_results_folds_0_1_2/PETCT_a0c4dc1ef1_01192003.nii.gz,/well/papiez/users/hri611/python/nnUnet_raw/Dataset219_PETCT/labelsTr/PETCT_a0c4dc1ef1_01192003.nii.gz,0.9362885508495787,0.2737024612426758,3.6576601638793944
335,,0,0,,47200000,0,0,0,/well/papiez/users/hri611/python/nnUNet_results/Dataset219_PETCT/nnUNetTrainer__nnUNetPlans__3d_fullres_maxnum_512_patch_192/crossval_results_folds_0_1_2/PETCT_a19c2a0c65_03052006.nii.gz,/well/papiez/users/hri611/python/nnUnet_raw/Dataset219_PETCT/labelsTr/PETCT_a19c2a0c65_03052006.nii.gz,,0.0,0.0
336,0.0830997302545581,121335,14,0.04335109737638749,52033152,5499,5513,126834,/well/papiez/users/hri611/python/nnUNet_results/Dataset219_PETCT/nnUNetTrainer__nnUNetPlans__3d_fullres_maxnum_512_patch_192/crossval_results_folds_0_1_2/PETCT_a19ef8e0d2_12261999.nii.gz,/well/papiez/users/hri611/python/nnUnet_raw/Dataset219_PETCT/labelsTr/PETCT_a19ef8e0d2_12261999.nii.gz,0.0830997302545581,0.14929225158691406,58.062244846343994
337,0.0,0,65,0.0,85599935,0,65,0,/well/papiez/users/hri611/python/nnUNet_results/Dataset219_PETCT/nnUNetTrainer__nnUNetPlans__3d_fullres_maxnum_512_patch_192/crossval_results_folds_0_1_2/PETCT_a1d93ebc74_09012003.nii.gz,/well/papiez/users/hri611/python/nnUnet_raw/Dataset219_PETCT/labelsTr/PETCT_a1d93ebc74_09012003.nii.gz,0.0,0.8086663627624512,0.0
338,0.9522102747909199,72,8,0.9087799315849487,52159123,797,805,869,/well/papiez/users/hri611/python/nnUNet_results/Dataset219_PETCT/nnUNetTrainer__nnUNetPlans__3d_fullres_maxnum_512_patch_192/crossval_results_folds_0_1_2/PETCT_a1db71e797_03252005.nii.gz,/well/papiez/users/hri611/python/nnUnet_raw/Dataset219_PETCT/labelsTr/PETCT_a1db71e797_03252005.nii.gz,0.9522102747909199,0.0,0.0
339,,0,0,,91680000,0,0,0,/well/papiez/users/hri611/python/nnUNet_results/Dataset219_PETCT/nnUNetTrainer__nnUNetPlans__3d_fullres_maxnum_512_patch_192/crossval_results_folds_0_1_2/PETCT_a22ec7f62b_06302007.nii.gz,/well/papiez/users/hri611/python/nnUnet_raw/Dataset219_PETCT/labelsTr/PETCT_a22ec7f62b_06302007.nii.gz,,0.0,0.0
340,,0,0,,72160000,0,0,0,/well/papiez/users/hri611/python/nnUNet_results/Dataset219_PETCT/nnUNetTrainer__nnUNetPlans__3d_fullres_maxnum_512_patch_192/crossval_results_folds_0_1_2/PETCT_a2676f03c0_05092003.nii.gz,/well/papiez/users/hri611/python/nnUnet_raw/Dataset219_PETCT/labelsTr/PETCT_a2676f03c0_05092003.nii.gz,,0.0,0.0
341,,0,0,,48480000,0,0,0,/well/papiez/users/hri611/python/nnUNet_results/Dataset219_PETCT/nnUNetTrainer__nnUNetPlans__3d_fullres_maxnum_512_patch_192/crossval_results_folds_0_1_2/PETCT_a29cae0316_06292006.nii.gz,/well/papiez/users/hri611/python/nnUnet_raw/Dataset219_PETCT/labelsTr/PETCT_a29cae0316_06292006.nii.gz,,0.0,0.0
342,0.950187466523835,27,66,0.9051020408163265,52159020,887,953,914,/well/papiez/users/hri611/python/nnUNet_results/Dataset219_PETCT/nnUNetTrainer__nnUNetPlans__3d_fullres_maxnum_512_patch_192/crossval_results_folds_0_1_2/PETCT_a2a68bbe97_08212003.nii.gz,/well/papiez/users/hri611/python/nnUnet_raw/Dataset219_PETCT/labelsTr/PETCT_a2a68bbe97_08212003.nii.gz,0.950187466523835,0.0,0.0
343,,0,0,,45440000,0,0,0,/well/papiez/users/hri611/python/nnUNet_results/Dataset219_PETCT/nnUNetTrainer__nnUNetPlans__3d_fullres_maxnum_512_patch_192/crossval_results_folds_0_1_2/PETCT_a37c4e231f_12132002.nii.gz,/well/papiez/users/hri611/python/nnUnet_raw/Dataset219_PETCT/labelsTr/PETCT_a37c4e231f_12132002.nii.gz,,0.0,0.0
344,0.869374089503412,9662,560,0.7689316876893169,45395762,34016,34576,43678,/well/papiez/users/hri611/python/nnUNet_results/Dataset219_PETCT/nnUNetTrainer__nnUNetPlans__3d_fullres_maxnum_512_patch_192/crossval_results_folds_0_1_2/PETCT_a37da9e85d_03022002.nii.gz,/well/papiez/users/hri611/python/nnUnet_raw/Dataset219_PETCT/labelsTr/PETCT_a37da9e85d_03022002.nii.gz,0.869374089503412,0.0,6.95453071975708
345,0.8789992981876729,5379,483,0.7841202032849672,52132846,21292,21775,26671,/well/papiez/users/hri611/python/nnUNet_results/Dataset219_PETCT/nnUNetTrainer__nnUNetPlans__3d_fullres_maxnum_512_patch_192/crossval_results_folds_0_1_2/PETCT_a3df01d3a3_10052002.nii.gz,/well/papiez/users/hri611/python/nnUnet_raw/Dataset219_PETCT/labelsTr/PETCT_a3df01d3a3_10052002.nii.gz,0.8789992981876729,0.19905633544921875,6.170746398925781
346,0.7879890809827116,434,498,0.6501501501501501,52157336,1732,2230,2166,/well/papiez/users/hri611/python/nnUNet_results/Dataset219_PETCT/nnUNetTrainer__nnUNetPlans__3d_fullres_maxnum_512_patch_192/crossval_results_folds_0_1_2/PETCT_a471649d35_05062002.nii.gz,/well/papiez/users/hri611/python/nnUnet_raw/Dataset219_PETCT/labelsTr/PETCT_a471649d35_05062002.nii.gz,0.7879890809827116,4.764911029815674,0.26126144027709963
347,,0,0,,49120000,0,0,0,/well/papiez/users/hri611/python/nnUNet_results/Dataset219_PETCT/nnUNetTrainer__nnUNetPlans__3d_fullres_maxnum_512_patch_192/crossval_results_folds_0_1_2/PETCT_a4a66c4fa7_07072006.nii.gz,/well/papiez/users/hri611/python/nnUnet_raw/Dataset219_PETCT/labelsTr/PETCT_a4a66c4fa7_07072006.nii.gz,,0.0,0.0
348,0.0,0,29411,0.0,45410589,0,29411,0,/well/papiez/users/hri611/python/nnUNet_results/Dataset219_PETCT/nnUNetTrainer__nnUNetPlans__3d_fullres_maxnum_512_patch_192/crossval_results_folds_0_1_2/PETCT_a4ccc397a9_11302002.nii.gz,/well/papiez/users/hri611/python/nnUnet_raw/Dataset219_PETCT/labelsTr/PETCT_a4ccc397a9_11302002.nii.gz,0.0,365.9028676185608,0.0
349,0.7789291882556131,213,43,0.637906647807638,58879293,451,494,664,/well/papiez/users/hri611/python/nnUNet_results/Dataset219_PETCT/nnUNetTrainer__nnUNetPlans__3d_fullres_maxnum_512_patch_192/crossval_results_folds_0_1_2/PETCT_a4cd2b10de_12292001.nii.gz,/well/papiez/users/hri611/python/nnUnet_raw/Dataset219_PETCT/labelsTr/PETCT_a4cd2b10de_12292001.nii.gz,0.7789291882556131,0.21149735641479492,0.09952816772460937
350,0.9567035456050179,400,594,0.917000668002672,92308024,10982,11576,11382,/well/papiez/users/hri611/python/nnUNet_results/Dataset219_PETCT/nnUNetTrainer__nnUNetPlans__3d_fullres_maxnum_512_patch_192/crossval_results_folds_0_1_2/PETCT_a61d8768d0_03262004.nii.gz,/well/papiez/users/hri611/python/nnUnet_raw/Dataset219_PETCT/labelsTr/PETCT_a61d8768d0_03262004.nii.gz,0.9567035456050179,0.14929225158691406,0.5474049224853516
351,0.0,0,4576,0.0,52155424,0,4576,0,/well/papiez/users/hri611/python/nnUNet_results/Dataset219_PETCT/nnUNetTrainer__nnUNetPlans__3d_fullres_maxnum_512_patch_192/crossval_results_folds_0_1_2/PETCT_a627fc68a1_02142003.nii.gz,/well/papiez/users/hri611/python/nnUnet_raw/Dataset219_PETCT/labelsTr/PETCT_a627fc68a1_02142003.nii.gz,0.0,56.930111938476564,0.0
352,0.7827956989247312,0,101,0.6431095406360424,99039717,182,283,182,/well/papiez/users/hri611/python/nnUNet_results/Dataset219_PETCT/nnUNetTrainer__nnUNetPlans__3d_fullres_maxnum_512_patch_192/crossval_results_folds_0_1_2/PETCT_a86b2dc6ce_10142002.nii.gz,/well/papiez/users/hri611/python/nnUnet_raw/Dataset219_PETCT/labelsTr/PETCT_a86b2dc6ce_10142002.nii.gz,0.7827956989247312,0.024882041931152343,0.0
353,,0,0,,45440000,0,0,0,/well/papiez/users/hri611/python/nnUNet_results/Dataset219_PETCT/nnUNetTrainer__nnUNetPlans__3d_fullres_maxnum_512_patch_192/crossval_results_folds_0_1_2/PETCT_a87dda9193_01262003.nii.gz,/well/papiez/users/hri611/python/nnUnet_raw/Dataset219_PETCT/labelsTr/PETCT_a87dda9193_01262003.nii.gz,,0.0,0.0
354,0.0,0,29,0.0,52159971,0,29,0,/well/papiez/users/hri611/python/nnUNet_results/Dataset219_PETCT/nnUNetTrainer__nnUNetPlans__3d_fullres_maxnum_512_patch_192/crossval_results_folds_0_1_2/PETCT_a8a5e96821_03112005.nii.gz,/well/papiez/users/hri611/python/nnUnet_raw/Dataset219_PETCT/labelsTr/PETCT_a8a5e96821_03112005.nii.gz,0.0,0.360789608001709,0.0
355,,0,0,,46720000,0,0,0,/well/papiez/users/hri611/python/nnUNet_results/Dataset219_PETCT/nnUNetTrainer__nnUNetPlans__3d_fullres_maxnum_512_patch_192/crossval_results_folds_0_1_2/PETCT_a8a5e96821_09302005.nii.gz,/well/papiez/users/hri611/python/nnUnet_raw/Dataset219_PETCT/labelsTr/PETCT_a8a5e96821_09302005.nii.gz,,0.0,0.0
356,0.0,0,188,0.0,52159812,0,188,0,/well/papiez/users/hri611/python/nnUNet_results/Dataset219_PETCT/nnUNetTrainer__nnUNetPlans__3d_fullres_maxnum_512_patch_192/crossval_results_folds_0_1_2/PETCT_a90955352e_05162003.nii.gz,/well/papiez/users/hri611/python/nnUnet_raw/Dataset219_PETCT/labelsTr/PETCT_a90955352e_05162003.nii.gz,0.0,2.33891194152832,0.0
357,0.660201891741515,3761,514,0.49276222116753676,45431572,4153,4667,7914,/well/papiez/users/hri611/python/nnUNet_results/Dataset219_PETCT/nnUNetTrainer__nnUNetPlans__3d_fullres_maxnum_512_patch_192/crossval_results_folds_0_1_2/PETCT_ab1fa26e5e_06232001.nii.gz,/well/papiez/users/hri611/python/nnUnet_raw/Dataset219_PETCT/labelsTr/PETCT_ab1fa26e5e_06232001.nii.gz,0.660201891741515,0.0,2.052768459320068
358,0.9022726443658119,1409,1270,0.8219460321680181,105744954,12367,13637,13776,/well/papiez/users/hri611/python/nnUNet_results/Dataset219_PETCT/nnUNetTrainer__nnUNetPlans__3d_fullres_maxnum_512_patch_192/crossval_results_folds_0_1_2/PETCT_ab953a5230_11032003.nii.gz,/well/papiez/users/hri611/python/nnUnet_raw/Dataset219_PETCT/labelsTr/PETCT_ab953a5230_11032003.nii.gz,0.9022726443658119,1.7293019142150878,3.408839744567871
359,0.8690060962664159,2677,1642,0.7683561276481631,45421355,14326,15968,17003,/well/papiez/users/hri611/python/nnUNet_results/Dataset219_PETCT/nnUNetTrainer__nnUNetPlans__3d_fullres_maxnum_512_patch_192/crossval_results_folds_0_1_2/PETCT_ac11b344b6_11032002.nii.gz,/well/papiez/users/hri611/python/nnUnet_raw/Dataset219_PETCT/labelsTr/PETCT_ac11b344b6_11032002.nii.gz,0.8690060962664159,0.0,2.0652094802856444
360,0.725347511658819,10418,1773,0.5690551097599774,52131711,16098,17871,26516,/well/papiez/users/hri611/python/nnUNet_results/Dataset219_PETCT/nnUNetTrainer__nnUNetPlans__3d_fullres_maxnum_512_patch_192/crossval_results_folds_0_1_2/PETCT_ad7c6a4a58_03282003.nii.gz,/well/papiez/users/hri611/python/nnUnet_raw/Dataset219_PETCT/labelsTr/PETCT_ad7c6a4a58_03282003.nii.gz,0.725347511658819,0.1368512306213379,22.331632633209228
361,0.0,0,83,0.0,52799917,0,83,0,/well/papiez/users/hri611/python/nnUNet_results/Dataset219_PETCT/nnUNetTrainer__nnUNetPlans__3d_fullres_maxnum_512_patch_192/crossval_results_folds_0_1_2/PETCT_ad99263bec_01292006.nii.gz,/well/papiez/users/hri611/python/nnUnet_raw/Dataset219_PETCT/labelsTr/PETCT_ad99263bec_01292006.nii.gz,0.0,1.0326047401428222,0.0
362,0.0,0,182828,0.0,51977172,0,182828,0,/well/papiez/users/hri611/python/nnUNet_results/Dataset219_PETCT/nnUNetTrainer__nnUNetPlans__3d_fullres_maxnum_512_patch_192/crossval_results_folds_0_1_2/PETCT_adc49adb3d_09222002.nii.gz,/well/papiez/users/hri611/python/nnUnet_raw/Dataset219_PETCT/labelsTr/PETCT_adc49adb3d_09222002.nii.gz,0.0,2274.5669810943605,0.0
363,0.9535609234334611,37,1005,0.9112436115843271,45428260,10698,11703,10735,/well/papiez/users/hri611/python/nnUNet_results/Dataset219_PETCT/nnUNetTrainer__nnUNetPlans__3d_fullres_maxnum_512_patch_192/crossval_results_folds_0_1_2/PETCT_ae3074834a_07262003.nii.gz,/well/papiez/users/hri611/python/nnUnet_raw/Dataset219_PETCT/labelsTr/PETCT_ae3074834a_07262003.nii.gz,0.9535609234334611,0.0,0.0
364,,0,0,,52160000,0,0,0,/well/papiez/users/hri611/python/nnUNet_results/Dataset219_PETCT/nnUNetTrainer__nnUNetPlans__3d_fullres_maxnum_512_patch_192/crossval_results_folds_0_1_2/PETCT_ae46202abb_02282003.nii.gz,/well/papiez/users/hri611/python/nnUnet_raw/Dataset219_PETCT/labelsTr/PETCT_ae46202abb_02282003.nii.gz,,0.0,0.0
365,,0,0,,38720000,0,0,0,/well/papiez/users/hri611/python/nnUNet_results/Dataset219_PETCT/nnUNetTrainer__nnUNetPlans__3d_fullres_maxnum_512_patch_192/crossval_results_folds_0_1_2/PETCT_ae4dcc5dd3_10082004.nii.gz,/well/papiez/users/hri611/python/nnUnet_raw/Dataset219_PETCT/labelsTr/PETCT_ae4dcc5dd3_10082004.nii.gz,,0.0,0.0
366,,0,0,,52160000,0,0,0,/well/papiez/users/hri611/python/nnUNet_results/Dataset219_PETCT/nnUNetTrainer__nnUNetPlans__3d_fullres_maxnum_512_patch_192/crossval_results_folds_0_1_2/PETCT_ae6a37a9d6_02102005.nii.gz,/well/papiez/users/hri611/python/nnUnet_raw/Dataset219_PETCT/labelsTr/PETCT_ae6a37a9d6_02102005.nii.gz,,0.0,0.0
367,,0,0,,48160000,0,0,0,/well/papiez/users/hri611/python/nnUNet_results/Dataset219_PETCT/nnUNetTrainer__nnUNetPlans__3d_fullres_maxnum_512_patch_192/crossval_results_folds_0_1_2/PETCT_ae6a37a9d6_08182005.nii.gz,/well/papiez/users/hri611/python/nnUnet_raw/Dataset219_PETCT/labelsTr/PETCT_ae6a37a9d6_08182005.nii.gz,,0.0,0.0
368,,0,0,,52160000,0,0,0,/well/papiez/users/hri611/python/nnUNet_results/Dataset219_PETCT/nnUNetTrainer__nnUNetPlans__3d_fullres_maxnum_512_patch_192/crossval_results_folds_0_1_2/PETCT_ae6a37a9d6_09132003.nii.gz,/well/papiez/users/hri611/python/nnUnet_raw/Dataset219_PETCT/labelsTr/PETCT_ae6a37a9d6_09132003.nii.gz,,0.0,0.0
369,,0,0,,52160000,0,0,0,/well/papiez/users/hri611/python/nnUNet_results/Dataset219_PETCT/nnUNetTrainer__nnUNetPlans__3d_fullres_maxnum_512_patch_192/crossval_results_folds_0_1_2/PETCT_ae6a37a9d6_09152002.nii.gz,/well/papiez/users/hri611/python/nnUnet_raw/Dataset219_PETCT/labelsTr/PETCT_ae6a37a9d6_09152002.nii.gz,,0.0,0.0
370,,0,0,,52160000,0,0,0,/well/papiez/users/hri611/python/nnUNet_results/Dataset219_PETCT/nnUNetTrainer__nnUNetPlans__3d_fullres_maxnum_512_patch_192/crossval_results_folds_0_1_2/PETCT_ae96f738c0_09112003.nii.gz,/well/papiez/users/hri611/python/nnUnet_raw/Dataset219_PETCT/labelsTr/PETCT_ae96f738c0_09112003.nii.gz,,0.0,0.0
371,,0,0,,99040000,0,0,0,/well/papiez/users/hri611/python/nnUNet_results/Dataset219_PETCT/nnUNetTrainer__nnUNetPlans__3d_fullres_maxnum_512_patch_192/crossval_results_folds_0_1_2/PETCT_af119148fe_02112005.nii.gz,/well/papiez/users/hri611/python/nnUnet_raw/Dataset219_PETCT/labelsTr/PETCT_af119148fe_02112005.nii.gz,,0.0,0.0
372,,0,0,,99040000,0,0,0,/well/papiez/users/hri611/python/nnUNet_results/Dataset219_PETCT/nnUNetTrainer__nnUNetPlans__3d_fullres_maxnum_512_patch_192/crossval_results_folds_0_1_2/PETCT_af119148fe_12052002.nii.gz,/well/papiez/users/hri611/python/nnUnet_raw/Dataset219_PETCT/labelsTr/PETCT_af119148fe_12052002.nii.gz,,0.0,0.0
373,0.0,0,1095,0.0,45438905,0,1095,0,/well/papiez/users/hri611/python/nnUNet_results/Dataset219_PETCT/nnUNetTrainer__nnUNetPlans__3d_fullres_maxnum_512_patch_192/crossval_results_folds_0_1_2/PETCT_af547fa618_03112006.nii.gz,/well/papiez/users/hri611/python/nnUnet_raw/Dataset219_PETCT/labelsTr/PETCT_af547fa618_03112006.nii.gz,0.0,13.622917957305908,0.0
374,0.9205125015549198,625,14,0.8527310440193593,99035661,3700,3714,4325,/well/papiez/users/hri611/python/nnUNet_results/Dataset219_PETCT/nnUNetTrainer__nnUNetPlans__3d_fullres_maxnum_512_patch_192/crossval_results_folds_0_1_2/PETCT_af73b85f2c_06192003.nii.gz,/well/papiez/users/hri611/python/nnUnet_raw/Dataset219_PETCT/labelsTr/PETCT_af73b85f2c_06192003.nii.gz,0.9205125015549198,0.0,0.0
375,,0,0,,49440000,0,0,0,/well/papiez/users/hri611/python/nnUNet_results/Dataset219_PETCT/nnUNetTrainer__nnUNetPlans__3d_fullres_maxnum_512_patch_192/crossval_results_folds_0_1_2/PETCT_b0e002e974_03112007.nii.gz,/well/papiez/users/hri611/python/nnUnet_raw/Dataset219_PETCT/labelsTr/PETCT_b0e002e974_03112007.nii.gz,,0.0,0.0
376,,0,0,,52800000,0,0,0,/well/papiez/users/hri611/python/nnUNet_results/Dataset219_PETCT/nnUNetTrainer__nnUNetPlans__3d_fullres_maxnum_512_patch_192/crossval_results_folds_0_1_2/PETCT_b0e002e974_09232005.nii.gz,/well/papiez/users/hri611/python/nnUnet_raw/Dataset219_PETCT/labelsTr/PETCT_b0e002e974_09232005.nii.gz,,0.0,0.0
377,0.8483290488431876,1016,223,0.7366071428571429,52155296,3465,3688,4481,/well/papiez/users/hri611/python/nnUNet_results/Dataset219_PETCT/nnUNetTrainer__nnUNetPlans__3d_fullres_maxnum_512_patch_192/crossval_results_folds_0_1_2/PETCT_b1aa7ce13e_03092003.nii.gz,/well/papiez/users/hri611/python/nnUnet_raw/Dataset219_PETCT/labelsTr/PETCT_b1aa7ce13e_03092003.nii.gz,0.8483290488431876,0.0,2.749465633392334
378,,0,0,,50080000,0,0,0,/well/papiez/users/hri611/python/nnUNet_results/Dataset219_PETCT/nnUNetTrainer__nnUNetPlans__3d_fullres_maxnum_512_patch_192/crossval_results_folds_0_1_2/PETCT_b1d6679284_05282007.nii.gz,/well/papiez/users/hri611/python/nnUnet_raw/Dataset219_PETCT/labelsTr/PETCT_b1d6679284_05282007.nii.gz,,0.0,0.0
379,0.0,0,1,0.0,45439999,0,1,0,/well/papiez/users/hri611/python/nnUNet_results/Dataset219_PETCT/nnUNetTrainer__nnUNetPlans__3d_fullres_maxnum_512_patch_192/crossval_results_folds_0_1_2/PETCT_b2f82ed4b9_04172003.nii.gz,/well/papiez/users/hri611/python/nnUnet_raw/Dataset219_PETCT/labelsTr/PETCT_b2f82ed4b9_04172003.nii.gz,0.0,0.012441020965576172,0.0
380,0.7746567985521534,5742,9573,0.6321957779965898,45398361,26324,35897,32066,/well/papiez/users/hri611/python/nnUNet_results/Dataset219_PETCT/nnUNetTrainer__nnUNetPlans__3d_fullres_maxnum_512_patch_192/crossval_results_folds_0_1_2/PETCT_b327726c24_08272000.nii.gz,/well/papiez/users/hri611/python/nnUnet_raw/Dataset219_PETCT/labelsTr/PETCT_b327726c24_08272000.nii.gz,0.7746567985521534,16.919788513183594,0.012441020965576172
381,0.5109439415189766,11087,420,0.34313277771435097,52142482,6011,6431,17098,/well/papiez/users/hri611/python/nnUNet_results/Dataset219_PETCT/nnUNetTrainer__nnUNetPlans__3d_fullres_maxnum_512_patch_192/crossval_results_folds_0_1_2/PETCT_b3d4773f85_11042000.nii.gz,/well/papiez/users/hri611/python/nnUnet_raw/Dataset219_PETCT/labelsTr/PETCT_b3d4773f85_11042000.nii.gz,0.5109439415189766,1.0326047401428222,17.47963445663452
382,,0,0,,52160000,0,0,0,/well/papiez/users/hri611/python/nnUNet_results/Dataset219_PETCT/nnUNetTrainer__nnUNetPlans__3d_fullres_maxnum_512_patch_192/crossval_results_folds_0_1_2/PETCT_b3e923029c_11212003.nii.gz,/well/papiez/users/hri611/python/nnUnet_raw/Dataset219_PETCT/labelsTr/PETCT_b3e923029c_11212003.nii.gz,,0.0,0.0
383,0.8862973760932945,1,38,0.7958115183246073,58879809,152,190,153,/well/papiez/users/hri611/python/nnUNet_results/Dataset219_PETCT/nnUNetTrainer__nnUNetPlans__3d_fullres_maxnum_512_patch_192/crossval_results_folds_0_1_2/PETCT_b41bc7c1e5_03122005.nii.gz,/well/papiez/users/hri611/python/nnUnet_raw/Dataset219_PETCT/labelsTr/PETCT_b41bc7c1e5_03122005.nii.gz,0.8862973760932945,0.0,0.0
384,,0,0,,45120000,0,0,0,/well/papiez/users/hri611/python/nnUNet_results/Dataset219_PETCT/nnUNetTrainer__nnUNetPlans__3d_fullres_maxnum_512_patch_192/crossval_results_folds_0_1_2/PETCT_b4247b8ecd_10202006.nii.gz,/well/papiez/users/hri611/python/nnUnet_raw/Dataset219_PETCT/labelsTr/PETCT_b4247b8ecd_10202006.nii.gz,,0.0,0.0
385,0.0,0,1494,0.0,52158506,0,1494,0,/well/papiez/users/hri611/python/nnUNet_results/Dataset219_PETCT/nnUNetTrainer__nnUNetPlans__3d_fullres_maxnum_512_patch_192/crossval_results_folds_0_1_2/PETCT_b42adab18e_09052003.nii.gz,/well/papiez/users/hri611/python/nnUnet_raw/Dataset219_PETCT/labelsTr/PETCT_b42adab18e_09052003.nii.gz,0.0,18.5868853225708,0.0
386,,0,0,,52160000,0,0,0,/well/papiez/users/hri611/python/nnUNet_results/Dataset219_PETCT/nnUNetTrainer__nnUNetPlans__3d_fullres_maxnum_512_patch_192/crossval_results_folds_0_1_2/PETCT_b4e5c1047c_10102004.nii.gz,/well/papiez/users/hri611/python/nnUnet_raw/Dataset219_PETCT/labelsTr/PETCT_b4e5c1047c_10102004.nii.gz,,0.0,0.0
387,0.8459922996149808,89,4311,0.7330906885047013,52143515,12085,16396,12174,/well/papiez/users/hri611/python/nnUNet_results/Dataset219_PETCT/nnUNetTrainer__nnUNetPlans__3d_fullres_maxnum_512_patch_192/crossval_results_folds_0_1_2/PETCT_b509ace2a2_05272002.nii.gz,/well/papiez/users/hri611/python/nnUnet_raw/Dataset219_PETCT/labelsTr/PETCT_b509ace2a2_05272002.nii.gz,0.8459922996149808,0.2239383773803711,0.48519981765747067
388,0.6742857142857143,0,228,0.5086206896551724,52159536,236,464,236,/well/papiez/users/hri611/python/nnUNet_results/Dataset219_PETCT/nnUNetTrainer__nnUNetPlans__3d_fullres_maxnum_512_patch_192/crossval_results_folds_0_1_2/PETCT_b510436d83_11102002.nii.gz,/well/papiez/users/hri611/python/nnUnet_raw/Dataset219_PETCT/labelsTr/PETCT_b510436d83_11102002.nii.gz,0.6742857142857143,2.251824794769287,0.0
389,0.0,137,0,0.0,45439863,0,0,137,/well/papiez/users/hri611/python/nnUNet_results/Dataset219_PETCT/nnUNetTrainer__nnUNetPlans__3d_fullres_maxnum_512_patch_192/crossval_results_folds_0_1_2/PETCT_b510436d83_11142003.nii.gz,/well/papiez/users/hri611/python/nnUnet_raw/Dataset219_PETCT/labelsTr/PETCT_b510436d83_11142003.nii.gz,0.0,0.0,1.7044198722839354
390,,0,0,,55520000,0,0,0,/well/papiez/users/hri611/python/nnUNet_results/Dataset219_PETCT/nnUNetTrainer__nnUNetPlans__3d_fullres_maxnum_512_patch_192/crossval_results_folds_0_1_2/PETCT_b57e1c1f5f_06252006.nii.gz,/well/papiez/users/hri611/python/nnUnet_raw/Dataset219_PETCT/labelsTr/PETCT_b57e1c1f5f_06252006.nii.gz,,0.0,0.0
391,0.9465209890741806,12,81,0.898471615720524,52799084,823,904,835,/well/papiez/users/hri611/python/nnUNet_results/Dataset219_PETCT/nnUNetTrainer__nnUNetPlans__3d_fullres_maxnum_512_patch_192/crossval_results_folds_0_1_2/PETCT_b5923963ac_02172007.nii.gz,/well/papiez/users/hri611/python/nnUnet_raw/Dataset219_PETCT/labelsTr/PETCT_b5923963ac_02172007.nii.gz,0.9465209890741806,0.0,0.0
392,0.0,0,10,0.0,52159990,0,10,0,/well/papiez/users/hri611/python/nnUNet_results/Dataset219_PETCT/nnUNetTrainer__nnUNetPlans__3d_fullres_maxnum_512_patch_192/crossval_results_folds_0_1_2/PETCT_b62864161e_07282002.nii.gz,/well/papiez/users/hri611/python/nnUnet_raw/Dataset219_PETCT/labelsTr/PETCT_b62864161e_07282002.nii.gz,0.0,0.12441020965576172,0.0
393,0.0,0,4,0.0,52159996,0,4,0,/well/papiez/users/hri611/python/nnUNet_results/Dataset219_PETCT/nnUNetTrainer__nnUNetPlans__3d_fullres_maxnum_512_patch_192/crossval_results_folds_0_1_2/PETCT_b66ba83594_03132003.nii.gz,/well/papiez/users/hri611/python/nnUnet_raw/Dataset219_PETCT/labelsTr/PETCT_b66ba83594_03132003.nii.gz,0.0,0.04976408386230469,0.0
394,0.4607250755287009,704,10,0.29931305201177627,52158981,305,315,1009,/well/papiez/users/hri611/python/nnUNet_results/Dataset219_PETCT/nnUNetTrainer__nnUNetPlans__3d_fullres_maxnum_512_patch_192/crossval_results_folds_0_1_2/PETCT_b6a3c72db6_07132002.nii.gz,/well/papiez/users/hri611/python/nnUnet_raw/Dataset219_PETCT/labelsTr/PETCT_b6a3c72db6_07132002.nii.gz,0.4607250755287009,0.0,7.825402187347412
395,0.8974376834668392,8063,2244,0.8139564267793,45384599,45094,47338,53157,/well/papiez/users/hri611/python/nnUNet_results/Dataset219_PETCT/nnUNetTrainer__nnUNetPlans__3d_fullres_maxnum_512_patch_192/crossval_results_folds_0_1_2/PETCT_b6fc20942c_12282001.nii.gz,/well/papiez/users/hri611/python/nnUnet_raw/Dataset219_PETCT/labelsTr/PETCT_b6fc20942c_12282001.nii.gz,0.8974376834668392,0.1368512306213379,0.012441020965576172
396,0.8002857434432085,2922,992,0.6670636270840422,38708244,7842,8834,10764,/well/papiez/users/hri611/python/nnUNet_results/Dataset219_PETCT/nnUNetTrainer__nnUNetPlans__3d_fullres_maxnum_512_patch_192/crossval_results_folds_0_1_2/PETCT_b899150306_08112002.nii.gz,/well/papiez/users/hri611/python/nnUnet_raw/Dataset219_PETCT/labelsTr/PETCT_b899150306_08112002.nii.gz,0.8002857434432085,0.0,10.251401275634766
397,0.0,0,52,0.0,52159948,0,52,0,/well/papiez/users/hri611/python/nnUNet_results/Dataset219_PETCT/nnUNetTrainer__nnUNetPlans__3d_fullres_maxnum_512_patch_192/crossval_results_folds_0_1_2/PETCT_b926177c87_10102004.nii.gz,/well/papiez/users/hri611/python/nnUnet_raw/Dataset219_PETCT/labelsTr/PETCT_b926177c87_10102004.nii.gz,0.0,0.6469330902099609,0.0
398,,0,0,,51520000,0,0,0,/well/papiez/users/hri611/python/nnUNet_results/Dataset219_PETCT/nnUNetTrainer__nnUNetPlans__3d_fullres_maxnum_512_patch_192/crossval_results_folds_0_1_2/PETCT_ba81e4b04b_12022005.nii.gz,/well/papiez/users/hri611/python/nnUnet_raw/Dataset219_PETCT/labelsTr/PETCT_ba81e4b04b_12022005.nii.gz,,0.0,0.0
399,0.8625759028443593,5,855,0.7583590896319191,92316441,2699,3554,2704,/well/papiez/users/hri611/python/nnUNet_results/Dataset219_PETCT/nnUNetTrainer__nnUNetPlans__3d_fullres_maxnum_512_patch_192/crossval_results_folds_0_1_2/PETCT_bc80d06f97_02182002.nii.gz,/well/papiez/users/hri611/python/nnUnet_raw/Dataset219_PETCT/labelsTr/PETCT_bc80d06f97_02182002.nii.gz,0.8625759028443593,0.0,0.0
400,0.9315586844131558,1377,1734,0.8718856813408558,45415717,21172,22906,22549,/well/papiez/users/hri611/python/nnUNet_results/Dataset219_PETCT/nnUNetTrainer__nnUNetPlans__3d_fullres_maxnum_512_patch_192/crossval_results_folds_0_1_2/PETCT_bca97006e4_05062001.nii.gz,/well/papiez/users/hri611/python/nnUnet_raw/Dataset219_PETCT/labelsTr/PETCT_bca97006e4_05062001.nii.gz,0.9315586844131558,1.3311892433166503,0.0
401,0.5991759858740435,673,8,0.42773109243697477,45438810,509,517,1182,/well/papiez/users/hri611/python/nnUNet_results/Dataset219_PETCT/nnUNetTrainer__nnUNetPlans__3d_fullres_maxnum_512_patch_192/crossval_results_folds_0_1_2/PETCT_bd52fdf529_12032000.nii.gz,/well/papiez/users/hri611/python/nnUnet_raw/Dataset219_PETCT/labelsTr/PETCT_bd52fdf529_12032000.nii.gz,0.5991759858740435,0.0,6.979412761688232
402,0.0,0,1929,0.0,45438071,0,1929,0,/well/papiez/users/hri611/python/nnUNet_results/Dataset219_PETCT/nnUNetTrainer__nnUNetPlans__3d_fullres_maxnum_512_patch_192/crossval_results_folds_0_1_2/PETCT_bd76c8d299_10252002.nii.gz,/well/papiez/users/hri611/python/nnUnet_raw/Dataset219_PETCT/labelsTr/PETCT_bd76c8d299_10252002.nii.gz,0.0,23.998729442596435,0.0
403,0.841646910832648,2239,1034,0.7265892573719823,45428029,8698,9732,10937,/well/papiez/users/hri611/python/nnUNet_results/Dataset219_PETCT/nnUNetTrainer__nnUNetPlans__3d_fullres_maxnum_512_patch_192/crossval_results_folds_0_1_2/PETCT_bd7c02faa9_05042002.nii.gz,/well/papiez/users/hri611/python/nnUnet_raw/Dataset219_PETCT/labelsTr/PETCT_bd7c02faa9_05042002.nii.gz,0.841646910832648,0.3110255241394043,3.3839577026367187
404,,0,0,,50400000,0,0,0,/well/papiez/users/hri611/python/nnUNet_results/Dataset219_PETCT/nnUNetTrainer__nnUNetPlans__3d_fullres_maxnum_512_patch_192/crossval_results_folds_0_1_2/PETCT_be0d3c767e_05292006.nii.gz,/well/papiez/users/hri611/python/nnUnet_raw/Dataset219_PETCT/labelsTr/PETCT_be0d3c767e_05292006.nii.gz,,0.0,0.0
405,0.8794403759973768,651,452,0.7848224736636754,45434874,4023,4475,4674,/well/papiez/users/hri611/python/nnUNet_results/Dataset219_PETCT/nnUNetTrainer__nnUNetPlans__3d_fullres_maxnum_512_patch_192/crossval_results_folds_0_1_2/PETCT_be3e55a32f_04052001.nii.gz,/well/papiez/users/hri611/python/nnUnet_raw/Dataset219_PETCT/labelsTr/PETCT_be3e55a32f_04052001.nii.gz,0.8794403759973768,0.0,0.3110255241394043
406,0.0,0,509,0.0,51679491,0,509,0,/well/papiez/users/hri611/python/nnUNet_results/Dataset219_PETCT/nnUNetTrainer__nnUNetPlans__3d_fullres_maxnum_512_patch_192/crossval_results_folds_0_1_2/PETCT_bef465b4ad_05042007.nii.gz,/well/papiez/users/hri611/python/nnUnet_raw/Dataset219_PETCT/labelsTr/PETCT_bef465b4ad_05042007.nii.gz,0.0,6.332479671478271,0.0
407,0.3823256706205838,18804,515,0.23634279389675072,45414702,5979,6494,24783,/well/papiez/users/hri611/python/nnUNet_results/Dataset219_PETCT/nnUNetTrainer__nnUNetPlans__3d_fullres_maxnum_512_patch_192/crossval_results_folds_0_1_2/PETCT_bf178a41b2_06082002.nii.gz,/well/papiez/users/hri611/python/nnUnet_raw/Dataset219_PETCT/labelsTr/PETCT_bf178a41b2_06082002.nii.gz,0.3823256706205838,0.0,78.4779602508545
408,,0,0,,47360000,0,0,0,/well/papiez/users/hri611/python/nnUNet_results/Dataset219_PETCT/nnUNetTrainer__nnUNetPlans__3d_fullres_maxnum_512_patch_192/crossval_results_folds_0_1_2/PETCT_bfd89440db_03112007.nii.gz,/well/papiez/users/hri611/python/nnUnet_raw/Dataset219_PETCT/labelsTr/PETCT_bfd89440db_03112007.nii.gz,,0.0,0.0
409,0.0,0,53,0.0,48159947,0,53,0,/well/papiez/users/hri611/python/nnUNet_results/Dataset219_PETCT/nnUNetTrainer__nnUNetPlans__3d_fullres_maxnum_512_patch_192/crossval_results_folds_0_1_2/PETCT_c018b45a49_11262006.nii.gz,/well/papiez/users/hri611/python/nnUnet_raw/Dataset219_PETCT/labelsTr/PETCT_c018b45a49_11262006.nii.gz,0.0,0.6593741111755371,0.0
410,,0,0,,52800000,0,0,0,/well/papiez/users/hri611/python/nnUNet_results/Dataset219_PETCT/nnUNetTrainer__nnUNetPlans__3d_fullres_maxnum_512_patch_192/crossval_results_folds_0_1_2/PETCT_c08293f2b2_07132006.nii.gz,/well/papiez/users/hri611/python/nnUnet_raw/Dataset219_PETCT/labelsTr/PETCT_c08293f2b2_07132006.nii.gz,,0.0,0.0
411,,0,0,,50400000,0,0,0,/well/papiez/users/hri611/python/nnUNet_results/Dataset219_PETCT/nnUNetTrainer__nnUNetPlans__3d_fullres_maxnum_512_patch_192/crossval_results_folds_0_1_2/PETCT_c094a24c03_01292006.nii.gz,/well/papiez/users/hri611/python/nnUnet_raw/Dataset219_PETCT/labelsTr/PETCT_c094a24c03_01292006.nii.gz,,0.0,0.0
412,0.0,0,17,0.0,52159983,0,17,0,/well/papiez/users/hri611/python/nnUNet_results/Dataset219_PETCT/nnUNetTrainer__nnUNetPlans__3d_fullres_maxnum_512_patch_192/crossval_results_folds_0_1_2/PETCT_c094a24c03_03042007.nii.gz,/well/papiez/users/hri611/python/nnUnet_raw/Dataset219_PETCT/labelsTr/PETCT_c094a24c03_03042007.nii.gz,0.0,0.21149735641479492,0.0
413,,0,0,,52160000,0,0,0,/well/papiez/users/hri611/python/nnUNet_results/Dataset219_PETCT/nnUNetTrainer__nnUNetPlans__3d_fullres_maxnum_512_patch_192/crossval_results_folds_0_1_2/PETCT_c10f48b173_11272004.nii.gz,/well/papiez/users/hri611/python/nnUnet_raw/Dataset219_PETCT/labelsTr/PETCT_c10f48b173_11272004.nii.gz,,0.0,0.0
414,0.7791446983011131,147,230,0.6381957773512476,45438958,665,895,812,/well/papiez/users/hri611/python/nnUNet_results/Dataset219_PETCT/nnUNetTrainer__nnUNetPlans__3d_fullres_maxnum_512_patch_192/crossval_results_folds_0_1_2/PETCT_c16c13211c_10262003.nii.gz,/well/papiez/users/hri611/python/nnUnet_raw/Dataset219_PETCT/labelsTr/PETCT_c16c13211c_10262003.nii.gz,0.7791446983011131,0.06220510482788086,0.0
415,0.9278617012682769,362,1424,0.8654309825195902,72146728,11486,12910,11848,/well/papiez/users/hri611/python/nnUNet_results/Dataset219_PETCT/nnUNetTrainer__nnUNetPlans__3d_fullres_maxnum_512_patch_192/crossval_results_folds_0_1_2/PETCT_c16d325d12_02152003.nii.gz,/well/papiez/users/hri611/python/nnUnet_raw/Dataset219_PETCT/labelsTr/PETCT_c16d325d12_02152003.nii.gz,0.9278617012682769,0.37323062896728515,0.11196918869018554
416,,0,0,,51040000,0,0,0,/well/papiez/users/hri611/python/nnUNet_results/Dataset219_PETCT/nnUNetTrainer__nnUNetPlans__3d_fullres_maxnum_512_patch_192/crossval_results_folds_0_1_2/PETCT_c1c9e78e0e_05142007.nii.gz,/well/papiez/users/hri611/python/nnUnet_raw/Dataset219_PETCT/labelsTr/PETCT_c1c9e78e0e_05142007.nii.gz,,0.0,0.0
417,0.6638193702961015,12701,208,0.496803617369611,52134346,12745,12953,25446,/well/papiez/users/hri611/python/nnUNet_results/Dataset219_PETCT/nnUNetTrainer__nnUNetPlans__3d_fullres_maxnum_512_patch_192/crossval_results_folds_0_1_2/PETCT_c29aba73da_08232002.nii.gz,/well/papiez/users/hri611/python/nnUnet_raw/Dataset219_PETCT/labelsTr/PETCT_c29aba73da_08232002.nii.gz,0.6638193702961015,0.0,14.220086963653564
418,0.0,0,236,0.0,72159764,0,236,0,/well/papiez/users/hri611/python/nnUNet_results/Dataset219_PETCT/nnUNetTrainer__nnUNetPlans__3d_fullres_maxnum_512_patch_192/crossval_results_folds_0_1_2/PETCT_c2b776974a_05092005.nii.gz,/well/papiez/users/hri611/python/nnUnet_raw/Dataset219_PETCT/labelsTr/PETCT_c2b776974a_05092005.nii.gz,0.0,2.9360809478759764,0.0
419,,0,0,,38720000,0,0,0,/well/papiez/users/hri611/python/nnUNet_results/Dataset219_PETCT/nnUNetTrainer__nnUNetPlans__3d_fullres_maxnum_512_patch_192/crossval_results_folds_0_1_2/PETCT_c2ffda4725_04112003.nii.gz,/well/papiez/users/hri611/python/nnUnet_raw/Dataset219_PETCT/labelsTr/PETCT_c2ffda4725_04112003.nii.gz,,0.0,0.0
420,0.0,0,446,0.0,38719554,0,446,0,/well/papiez/users/hri611/python/nnUNet_results/Dataset219_PETCT/nnUNetTrainer__nnUNetPlans__3d_fullres_maxnum_512_patch_192/crossval_results_folds_0_1_2/PETCT_c2ffda4725_09192003.nii.gz,/well/papiez/users/hri611/python/nnUnet_raw/Dataset219_PETCT/labelsTr/PETCT_c2ffda4725_09192003.nii.gz,0.0,5.548695350646972,0.0
421,,0,0,,58880000,0,0,0,/well/papiez/users/hri611/python/nnUNet_results/Dataset219_PETCT/nnUNetTrainer__nnUNetPlans__3d_fullres_maxnum_512_patch_192/crossval_results_folds_0_1_2/PETCT_c395306306_08242002.nii.gz,/well/papiez/users/hri611/python/nnUnet_raw/Dataset219_PETCT/labelsTr/PETCT_c395306306_08242002.nii.gz,,0.0,0.0
422,0.9133615343023441,2915,2533,0.8405385628567247,52125835,28717,31250,31632,/well/papiez/users/hri611/python/nnUNet_results/Dataset219_PETCT/nnUNetTrainer__nnUNetPlans__3d_fullres_maxnum_512_patch_192/crossval_results_folds_0_1_2/PETCT_c517c47bed_02062003.nii.gz,/well/papiez/users/hri611/python/nnUnet_raw/Dataset219_PETCT/labelsTr/PETCT_c517c47bed_02062003.nii.gz,0.9133615343023441,0.6220510482788086,0.0
423,0.31480817497310865,1892,19,0.18680851063829787,45437650,439,458,2331,/well/papiez/users/hri611/python/nnUNet_results/Dataset219_PETCT/nnUNetTrainer__nnUNetPlans__3d_fullres_maxnum_512_patch_192/crossval_results_folds_0_1_2/PETCT_c58477f3b4_12072002.nii.gz,/well/papiez/users/hri611/python/nnUnet_raw/Dataset219_PETCT/labelsTr/PETCT_c58477f3b4_12072002.nii.gz,0.31480817497310865,0.037323062896728515,20.017602733612062
424,,0,0,,43680000,0,0,0,/well/papiez/users/hri611/python/nnUNet_results/Dataset219_PETCT/nnUNetTrainer__nnUNetPlans__3d_fullres_maxnum_512_patch_192/crossval_results_folds_0_1_2/PETCT_c5a143a604_08122006.nii.gz,/well/papiez/users/hri611/python/nnUnet_raw/Dataset219_PETCT/labelsTr/PETCT_c5a143a604_08122006.nii.gz,,0.0,0.0
425,0.6659498689604193,3981,990,0.499194035865404,52150074,4955,5945,8936,/well/papiez/users/hri611/python/nnUNet_results/Dataset219_PETCT/nnUNetTrainer__nnUNetPlans__3d_fullres_maxnum_512_patch_192/crossval_results_folds_0_1_2/PETCT_c73c2685c0_02012001.nii.gz,/well/papiez/users/hri611/python/nnUnet_raw/Dataset219_PETCT/labelsTr/PETCT_c73c2685c0_02012001.nii.gz,0.6659498689604193,0.58472798538208,3.0729321784973145
426,0.9202577839894401,564,463,0.8522939738242485,45433047,5926,6389,6490,/well/papiez/users/hri611/python/nnUNet_results/Dataset219_PETCT/nnUNetTrainer__nnUNetPlans__3d_fullres_maxnum_512_patch_192/crossval_results_folds_0_1_2/PETCT_c799ccc2f6_08262002.nii.gz,/well/papiez/users/hri611/python/nnUnet_raw/Dataset219_PETCT/labelsTr/PETCT_c799ccc2f6_08262002.nii.gz,0.9202577839894401,0.0,0.5971690063476562
427,0.0,0,153,0.0,45439847,0,153,0,/well/papiez/users/hri611/python/nnUNet_results/Dataset219_PETCT/nnUNetTrainer__nnUNetPlans__3d_fullres_maxnum_512_patch_192/crossval_results_folds_0_1_2/PETCT_c7fd7e3e30_11132003.nii.gz,/well/papiez/users/hri611/python/nnUnet_raw/Dataset219_PETCT/labelsTr/PETCT_c7fd7e3e30_11132003.nii.gz,0.0,1.9034762077331542,0.0
428,0.0,0,48,0.0,45439952,0,48,0,/well/papiez/users/hri611/python/nnUNet_results/Dataset219_PETCT/nnUNetTrainer__nnUNetPlans__3d_fullres_maxnum_512_patch_192/crossval_results_folds_0_1_2/PETCT_ca16242e89_09132002.nii.gz,/well/papiez/users/hri611/python/nnUnet_raw/Dataset219_PETCT/labelsTr/PETCT_ca16242e89_09132002.nii.gz,0.0,0.5971690063476562,0.0
429,,0,0,,45440000,0,0,0,/well/papiez/users/hri611/python/nnUNet_results/Dataset219_PETCT/nnUNetTrainer__nnUNetPlans__3d_fullres_maxnum_512_patch_192/crossval_results_folds_0_1_2/PETCT_ca16242e89_09182003.nii.gz,/well/papiez/users/hri611/python/nnUnet_raw/Dataset219_PETCT/labelsTr/PETCT_ca16242e89_09182003.nii.gz,,0.0,0.0
430,0.0,0,330,0.0,45439670,0,330,0,/well/papiez/users/hri611/python/nnUNet_results/Dataset219_PETCT/nnUNetTrainer__nnUNetPlans__3d_fullres_maxnum_512_patch_192/crossval_results_folds_0_1_2/PETCT_ca29501275_11042004.nii.gz,/well/papiez/users/hri611/python/nnUnet_raw/Dataset219_PETCT/labelsTr/PETCT_ca29501275_11042004.nii.gz,0.0,4.105536918640136,0.0
431,0.8118811881188119,1,75,0.6833333333333333,101439760,164,239,165,/well/papiez/users/hri611/python/nnUNet_results/Dataset219_PETCT/nnUNetTrainer__nnUNetPlans__3d_fullres_maxnum_512_patch_192/crossval_results_folds_0_1_2/PETCT_cab58c1fee_03192007.nii.gz,/well/papiez/users/hri611/python/nnUnet_raw/Dataset219_PETCT/labelsTr/PETCT_cab58c1fee_03192007.nii.gz,0.8118811881188119,0.360789608001709,0.0
432,,0,0,,91040000,0,0,0,/well/papiez/users/hri611/python/nnUNet_results/Dataset219_PETCT/nnUNetTrainer__nnUNetPlans__3d_fullres_maxnum_512_patch_192/crossval_results_folds_0_1_2/PETCT_cb240e6f0f_04192007.nii.gz,/well/papiez/users/hri611/python/nnUnet_raw/Dataset219_PETCT/labelsTr/PETCT_cb240e6f0f_04192007.nii.gz,,0.0,0.0
433,0.7631439409389403,9980,1634,0.6170030339005408,48129676,18710,20344,28690,/well/papiez/users/hri611/python/nnUNet_results/Dataset219_PETCT/nnUNetTrainer__nnUNetPlans__3d_fullres_maxnum_512_patch_192/crossval_results_folds_0_1_2/PETCT_cbbc9e2879_01162006.nii.gz,/well/papiez/users/hri611/python/nnUnet_raw/Dataset219_PETCT/labelsTr/PETCT_cbbc9e2879_01162006.nii.gz,0.7631439409389403,0.7589022789001465,2.363793983459473
434,,0,0,,47200000,0,0,0,/well/papiez/users/hri611/python/nnUNet_results/Dataset219_PETCT/nnUNetTrainer__nnUNetPlans__3d_fullres_maxnum_512_patch_192/crossval_results_folds_0_1_2/PETCT_cbbc9e2879_03312006.nii.gz,/well/papiez/users/hri611/python/nnUnet_raw/Dataset219_PETCT/labelsTr/PETCT_cbbc9e2879_03312006.nii.gz,,0.0,0.0
435,,0,0,,46880000,0,0,0,/well/papiez/users/hri611/python/nnUNet_results/Dataset219_PETCT/nnUNetTrainer__nnUNetPlans__3d_fullres_maxnum_512_patch_192/crossval_results_folds_0_1_2/PETCT_cbbc9e2879_06282007.nii.gz,/well/papiez/users/hri611/python/nnUnet_raw/Dataset219_PETCT/labelsTr/PETCT_cbbc9e2879_06282007.nii.gz,,0.0,0.0
436,0.0,0,1717,0.0,45438283,0,1717,0,/well/papiez/users/hri611/python/nnUNet_results/Dataset219_PETCT/nnUNetTrainer__nnUNetPlans__3d_fullres_maxnum_512_patch_192/crossval_results_folds_0_1_2/PETCT_cc7cb73213_12182004.nii.gz,/well/papiez/users/hri611/python/nnUnet_raw/Dataset219_PETCT/labelsTr/PETCT_cc7cb73213_12182004.nii.gz,0.0,21.361232997894287,0.0
437,0.0,0,102,0.0,44159898,0,102,0,/well/papiez/users/hri611/python/nnUNet_results/Dataset219_PETCT/nnUNetTrainer__nnUNetPlans__3d_fullres_maxnum_512_patch_192/crossval_results_folds_0_1_2/PETCT_ccb9c375b2_10012005.nii.gz,/well/papiez/users/hri611/python/nnUnet_raw/Dataset219_PETCT/labelsTr/PETCT_ccb9c375b2_10012005.nii.gz,0.0,1.2689841384887695,0.0
438,0.0,0,4000,0.0,50876000,0,4000,0,/well/papiez/users/hri611/python/nnUNet_results/Dataset219_PETCT/nnUNetTrainer__nnUNetPlans__3d_fullres_maxnum_512_patch_192/crossval_results_folds_0_1_2/PETCT_ccd8f5ff71_10292006.nii.gz,/well/papiez/users/hri611/python/nnUnet_raw/Dataset219_PETCT/labelsTr/PETCT_ccd8f5ff71_10292006.nii.gz,0.0,49.76408386230469,0.0
439,,0,0,,52160000,0,0,0,/well/papiez/users/hri611/python/nnUNet_results/Dataset219_PETCT/nnUNetTrainer__nnUNetPlans__3d_fullres_maxnum_512_patch_192/crossval_results_folds_0_1_2/PETCT_cd50f3fec4_12012002.nii.gz,/well/papiez/users/hri611/python/nnUnet_raw/Dataset219_PETCT/labelsTr/PETCT_cd50f3fec4_12012002.nii.gz,,0.0,0.0
440,,0,0,,54400000,0,0,0,/well/papiez/users/hri611/python/nnUNet_results/Dataset219_PETCT/nnUNetTrainer__nnUNetPlans__3d_fullres_maxnum_512_patch_192/crossval_results_folds_0_1_2/PETCT_cd9bdca46b_10052006.nii.gz,/well/papiez/users/hri611/python/nnUnet_raw/Dataset219_PETCT/labelsTr/PETCT_cd9bdca46b_10052006.nii.gz,,0.0,0.0
441,0.6933735914164015,4318,1369,0.5306594041429397,72147883,6430,7799,10748,/well/papiez/users/hri611/python/nnUNet_results/Dataset219_PETCT/nnUNetTrainer__nnUNetPlans__3d_fullres_maxnum_512_patch_192/crossval_results_folds_0_1_2/PETCT_cf20ad1656_02182005.nii.gz,/well/papiez/users/hri611/python/nnUnet_raw/Dataset219_PETCT/labelsTr/PETCT_cf20ad1656_02182005.nii.gz,0.6933735914164015,0.0,4.055772834777832
442,0.0,0,54,0.0,89759946,0,54,0,/well/papiez/users/hri611/python/nnUNet_results/Dataset219_PETCT/nnUNetTrainer__nnUNetPlans__3d_fullres_maxnum_512_patch_192/crossval_results_folds_0_1_2/PETCT_cf3725edf0_10072005.nii.gz,/well/papiez/users/hri611/python/nnUnet_raw/Dataset219_PETCT/labelsTr/PETCT_cf3725edf0_10072005.nii.gz,0.0,0.6718151321411132,0.0
443,,0,0,,45440000,0,0,0,/well/papiez/users/hri611/python/nnUNet_results/Dataset219_PETCT/nnUNetTrainer__nnUNetPlans__3d_fullres_maxnum_512_patch_192/crossval_results_folds_0_1_2/PETCT_d098458d29_08012003.nii.gz,/well/papiez/users/hri611/python/nnUnet_raw/Dataset219_PETCT/labelsTr/PETCT_d098458d29_08012003.nii.gz,,0.0,0.0
444,0.0,0,21,0.0,52159979,0,21,0,/well/papiez/users/hri611/python/nnUNet_results/Dataset219_PETCT/nnUNetTrainer__nnUNetPlans__3d_fullres_maxnum_512_patch_192/crossval_results_folds_0_1_2/PETCT_d103e57f0e_12122002.nii.gz,/well/papiez/users/hri611/python/nnUnet_raw/Dataset219_PETCT/labelsTr/PETCT_d103e57f0e_12122002.nii.gz,0.0,0.26126144027709963,0.0
445,0.8006789102619898,498,22402,0.6676101313593149,52091105,45995,68397,46493,/well/papiez/users/hri611/python/nnUNet_results/Dataset219_PETCT/nnUNetTrainer__nnUNetPlans__3d_fullres_maxnum_512_patch_192/crossval_results_folds_0_1_2/PETCT_d31c9ebd93_07212003.nii.gz,/well/papiez/users/hri611/python/nnUnet_raw/Dataset219_PETCT/labelsTr/PETCT_d31c9ebd93_07212003.nii.gz,0.8006789102619898,0.945517593383789,0.5598459434509278
446,0.4552048617918055,2612,167,0.29467005076142133,45436060,1161,1328,3773,/well/papiez/users/hri611/python/nnUNet_results/Dataset219_PETCT/nnUNetTrainer__nnUNetPlans__3d_fullres_maxnum_512_patch_192/crossval_results_folds_0_1_2/PETCT_d393ab6c7b_09222002.nii.gz,/well/papiez/users/hri611/python/nnUnet_raw/Dataset219_PETCT/labelsTr/PETCT_d393ab6c7b_09222002.nii.gz,0.4552048617918055,1.8288300819396972,27.905210025787355
447,,0,0,,48480000,0,0,0,/well/papiez/users/hri611/python/nnUNet_results/Dataset219_PETCT/nnUNetTrainer__nnUNetPlans__3d_fullres_maxnum_512_patch_192/crossval_results_folds_0_1_2/PETCT_d3d3b7d4ff_08312006.nii.gz,/well/papiez/users/hri611/python/nnUnet_raw/Dataset219_PETCT/labelsTr/PETCT_d3d3b7d4ff_08312006.nii.gz,,0.0,0.0
448,0.8759877029396073,2806,2075,0.7793399638336347,52137880,17239,19314,20045,/well/papiez/users/hri611/python/nnUNet_results/Dataset219_PETCT/nnUNetTrainer__nnUNetPlans__3d_fullres_maxnum_512_patch_192/crossval_results_folds_0_1_2/PETCT_d3d61785e6_10192001.nii.gz,/well/papiez/users/hri611/python/nnUnet_raw/Dataset219_PETCT/labelsTr/PETCT_d3d61785e6_10192001.nii.gz,0.8759877029396073,0.0,19.880751502990723
449,,0,0,,45440000,0,0,0,/well/papiez/users/hri611/python/nnUNet_results/Dataset219_PETCT/nnUNetTrainer__nnUNetPlans__3d_fullres_maxnum_512_patch_192/crossval_results_folds_0_1_2/PETCT_d3f13dff4b_08242003.nii.gz,/well/papiez/users/hri611/python/nnUnet_raw/Dataset219_PETCT/labelsTr/PETCT_d3f13dff4b_08242003.nii.gz,,0.0,0.0
450,0.014249073810202337,8755,1622,0.007175660160734788,52149548,75,1697,8830,/well/papiez/users/hri611/python/nnUNet_results/Dataset219_PETCT/nnUNetTrainer__nnUNetPlans__3d_fullres_maxnum_512_patch_192/crossval_results_folds_0_1_2/PETCT_d40a16781a_09132003.nii.gz,/well/papiez/users/hri611/python/nnUnet_raw/Dataset219_PETCT/labelsTr/PETCT_d40a16781a_09132003.nii.gz,0.014249073810202337,19.07208514022827,108.9086975326538
451,0.7203107658157603,5145,399,0.5628794449262793,52147317,7139,7538,12284,/well/papiez/users/hri611/python/nnUNet_results/Dataset219_PETCT/nnUNetTrainer__nnUNetPlans__3d_fullres_maxnum_512_patch_192/crossval_results_folds_0_1_2/PETCT_d46f0109f8_09092000.nii.gz,/well/papiez/users/hri611/python/nnUnet_raw/Dataset219_PETCT/labelsTr/PETCT_d46f0109f8_09092000.nii.gz,0.7203107658157603,0.0,2.027886417388916
452,0.0,0,125,0.0,45439875,0,125,0,/well/papiez/users/hri611/python/nnUNet_results/Dataset219_PETCT/nnUNetTrainer__nnUNetPlans__3d_fullres_maxnum_512_patch_192/crossval_results_folds_0_1_2/PETCT_d472033d3b_09282002.nii.gz,/well/papiez/users/hri611/python/nnUnet_raw/Dataset219_PETCT/labelsTr/PETCT_d472033d3b_09282002.nii.gz,0.0,1.5551276206970215,0.0
453,,0,0,,50080000,0,0,0,/well/papiez/users/hri611/python/nnUNet_results/Dataset219_PETCT/nnUNetTrainer__nnUNetPlans__3d_fullres_maxnum_512_patch_192/crossval_results_folds_0_1_2/PETCT_d4a08e4bde_03162006.nii.gz,/well/papiez/users/hri611/python/nnUnet_raw/Dataset219_PETCT/labelsTr/PETCT_d4a08e4bde_03162006.nii.gz,,0.0,0.0
454,0.44116028614102665,2360,4749,0.28300554715078163,91830085,2806,7555,5166,/well/papiez/users/hri611/python/nnUNet_results/Dataset219_PETCT/nnUNetTrainer__nnUNetPlans__3d_fullres_maxnum_512_patch_192/crossval_results_folds_0_1_2/PETCT_d4f3375362_05272005.nii.gz,/well/papiez/users/hri611/python/nnUnet_raw/Dataset219_PETCT/labelsTr/PETCT_d4f3375362_05272005.nii.gz,0.44116028614102665,56.99231704330444,4.889321239471435
455,0.9128070504406526,634,1226,0.8395998620213867,75188404,9736,10962,10370,/well/papiez/users/hri611/python/nnUNet_results/Dataset219_PETCT/nnUNetTrainer__nnUNetPlans__3d_fullres_maxnum_512_patch_192/crossval_results_folds_0_1_2/PETCT_d5103c8fbf_04142006.nii.gz,/well/papiez/users/hri611/python/nnUnet_raw/Dataset219_PETCT/labelsTr/PETCT_d5103c8fbf_04142006.nii.gz,0.9128070504406526,0.012441020965576172,0.0
456,0.0,0,3,0.0,85599997,0,3,0,/well/papiez/users/hri611/python/nnUNet_results/Dataset219_PETCT/nnUNetTrainer__nnUNetPlans__3d_fullres_maxnum_512_patch_192/crossval_results_folds_0_1_2/PETCT_d539f5a88b_06232003.nii.gz,/well/papiez/users/hri611/python/nnUnet_raw/Dataset219_PETCT/labelsTr/PETCT_d539f5a88b_06232003.nii.gz,0.0,0.037323062896728515,0.0
457,0.0,0,23,0.0,72159977,0,23,0,/well/papiez/users/hri611/python/nnUNet_results/Dataset219_PETCT/nnUNetTrainer__nnUNetPlans__3d_fullres_maxnum_512_patch_192/crossval_results_folds_0_1_2/PETCT_d5e2aa7feb_04172003.nii.gz,/well/papiez/users/hri611/python/nnUnet_raw/Dataset219_PETCT/labelsTr/PETCT_d5e2aa7feb_04172003.nii.gz,0.0,0.2861434822082519,0.0
458,0.0,0,330,0.0,58879670,0,330,0,/well/papiez/users/hri611/python/nnUNet_results/Dataset219_PETCT/nnUNetTrainer__nnUNetPlans__3d_fullres_maxnum_512_patch_192/crossval_results_folds_0_1_2/PETCT_d626611daf_04032003.nii.gz,/well/papiez/users/hri611/python/nnUnet_raw/Dataset219_PETCT/labelsTr/PETCT_d626611daf_04032003.nii.gz,0.0,4.105536918640136,0.0
459,,0,0,,55360000,0,0,0,/well/papiez/users/hri611/python/nnUNet_results/Dataset219_PETCT/nnUNetTrainer__nnUNetPlans__3d_fullres_maxnum_512_patch_192/crossval_results_folds_0_1_2/PETCT_d626611daf_06192005.nii.gz,/well/papiez/users/hri611/python/nnUnet_raw/Dataset219_PETCT/labelsTr/PETCT_d626611daf_06192005.nii.gz,,0.0,0.0
460,0.0,0,820,0.0,58879180,0,820,0,/well/papiez/users/hri611/python/nnUNet_results/Dataset219_PETCT/nnUNetTrainer__nnUNetPlans__3d_fullres_maxnum_512_patch_192/crossval_results_folds_0_1_2/PETCT_d626611daf_11122004.nii.gz,/well/papiez/users/hri611/python/nnUnet_raw/Dataset219_PETCT/labelsTr/PETCT_d626611daf_11122004.nii.gz,0.0,10.20163719177246,0.0
461,0.851063829787234,0,35,0.7407407407407407,52479865,100,135,100,/well/papiez/users/hri611/python/nnUNet_results/Dataset219_PETCT/nnUNetTrainer__nnUNetPlans__3d_fullres_maxnum_512_patch_192/crossval_results_folds_0_1_2/PETCT_d65cf203be_04282007.nii.gz,/well/papiez/users/hri611/python/nnUnet_raw/Dataset219_PETCT/labelsTr/PETCT_d65cf203be_04282007.nii.gz,0.851063829787234,0.0,0.0
462,,0,0,,58880000,0,0,0,/well/papiez/users/hri611/python/nnUNet_results/Dataset219_PETCT/nnUNetTrainer__nnUNetPlans__3d_fullres_maxnum_512_patch_192/crossval_results_folds_0_1_2/PETCT_d6a48a629d_03062003.nii.gz,/well/papiez/users/hri611/python/nnUnet_raw/Dataset219_PETCT/labelsTr/PETCT_d6a48a629d_03062003.nii.gz,,0.0,0.0
463,,0,0,,52160000,0,0,0,/well/papiez/users/hri611/python/nnUNet_results/Dataset219_PETCT/nnUNetTrainer__nnUNetPlans__3d_fullres_maxnum_512_patch_192/crossval_results_folds_0_1_2/PETCT_d6a48a629d_07272002.nii.gz,/well/papiez/users/hri611/python/nnUnet_raw/Dataset219_PETCT/labelsTr/PETCT_d6a48a629d_07272002.nii.gz,,0.0,0.0
464,0.0,0,1587,0.0,99038413,0,1587,0,/well/papiez/users/hri611/python/nnUNet_results/Dataset219_PETCT/nnUNetTrainer__nnUNetPlans__3d_fullres_maxnum_512_patch_192/crossval_results_folds_0_1_2/PETCT_d6a491e16d_05302003.nii.gz,/well/papiez/users/hri611/python/nnUnet_raw/Dataset219_PETCT/labelsTr/PETCT_d6a491e16d_05302003.nii.gz,0.0,19.743900272369384,0.0
465,,0,0,,45440000,0,0,0,/well/papiez/users/hri611/python/nnUNet_results/Dataset219_PETCT/nnUNetTrainer__nnUNetPlans__3d_fullres_maxnum_512_patch_192/crossval_results_folds_0_1_2/PETCT_d6b2218bf3_12182004.nii.gz,/well/papiez/users/hri611/python/nnUnet_raw/Dataset219_PETCT/labelsTr/PETCT_d6b2218bf3_12182004.nii.gz,,0.0,0.0
466,0.6068447412353923,732,210,0.4355901737567406,47838331,727,937,1459,/well/papiez/users/hri611/python/nnUNet_results/Dataset219_PETCT/nnUNetTrainer__nnUNetPlans__3d_fullres_maxnum_512_patch_192/crossval_results_folds_0_1_2/PETCT_d8a92bafe3_03182007.nii.gz,/well/papiez/users/hri611/python/nnUnet_raw/Dataset219_PETCT/labelsTr/PETCT_d8a92bafe3_03182007.nii.gz,0.6068447412353923,0.0,8.945094074249267
467,0.8038605230386052,10,620,0.6720458094742322,92318079,1291,1911,1301,/well/papiez/users/hri611/python/nnUNet_results/Dataset219_PETCT/nnUNetTrainer__nnUNetPlans__3d_fullres_maxnum_512_patch_192/crossval_results_folds_0_1_2/PETCT_d8d9e52cd5_03132005.nii.gz,/well/papiez/users/hri611/python/nnUnet_raw/Dataset219_PETCT/labelsTr/PETCT_d8d9e52cd5_03132005.nii.gz,0.8038605230386052,0.6344920692443847,0.012441020965576172
468,0.7164082687338501,534,344,0.5581278309008556,92318013,1109,1453,1643,/well/papiez/users/hri611/python/nnUNet_results/Dataset219_PETCT/nnUNetTrainer__nnUNetPlans__3d_fullres_maxnum_512_patch_192/crossval_results_folds_0_1_2/PETCT_d8d9e52cd5_07042004.nii.gz,/well/papiez/users/hri611/python/nnUnet_raw/Dataset219_PETCT/labelsTr/PETCT_d8d9e52cd5_07042004.nii.gz,0.7164082687338501,1.443158432006836,5.760192707061767
469,0.3212838385475766,8067,307,0.19138663576670528,94069644,1982,2289,10049,/well/papiez/users/hri611/python/nnUNet_results/Dataset219_PETCT/nnUNetTrainer__nnUNetPlans__3d_fullres_maxnum_512_patch_192/crossval_results_folds_0_1_2/PETCT_d8d9e52cd5_10072005.nii.gz,/well/papiez/users/hri611/python/nnUnet_raw/Dataset219_PETCT/labelsTr/PETCT_d8d9e52cd5_10072005.nii.gz,0.3212838385475766,1.0699278030395507,96.86578923797607
470,0.0,0,38,0.0,52159962,0,38,0,/well/papiez/users/hri611/python/nnUNet_results/Dataset219_PETCT/nnUNetTrainer__nnUNetPlans__3d_fullres_maxnum_512_patch_192/crossval_results_folds_0_1_2/PETCT_d8e3aa97a0_05192005.nii.gz,/well/papiez/users/hri611/python/nnUnet_raw/Dataset219_PETCT/labelsTr/PETCT_d8e3aa97a0_05192005.nii.gz,0.0,0.4727587966918945,0.0
471,0.7950492972519404,484,493,0.6598189415041783,45437128,1895,2388,2379,/well/papiez/users/hri611/python/nnUNet_results/Dataset219_PETCT/nnUNetTrainer__nnUNetPlans__3d_fullres_maxnum_512_patch_192/crossval_results_folds_0_1_2/PETCT_da6161d7eb_06202003.nii.gz,/well/papiez/users/hri611/python/nnUnet_raw/Dataset219_PETCT/labelsTr/PETCT_da6161d7eb_06202003.nii.gz,0.7950492972519404,1.604891704559326,2.898757884979248
472,0.0,0,2,0.0,52159998,0,2,0,/well/papiez/users/hri611/python/nnUNet_results/Dataset219_PETCT/nnUNetTrainer__nnUNetPlans__3d_fullres_maxnum_512_patch_192/crossval_results_folds_0_1_2/PETCT_dae86b88e2_06212003.nii.gz,/well/papiez/users/hri611/python/nnUnet_raw/Dataset219_PETCT/labelsTr/PETCT_dae86b88e2_06212003.nii.gz,0.0,0.024882041931152343,0.0
473,0.0,0,3,0.0,51039997,0,3,0,/well/papiez/users/hri611/python/nnUNet_results/Dataset219_PETCT/nnUNetTrainer__nnUNetPlans__3d_fullres_maxnum_512_patch_192/crossval_results_folds_0_1_2/PETCT_db3bac356a_08212005.nii.gz,/well/papiez/users/hri611/python/nnUnet_raw/Dataset219_PETCT/labelsTr/PETCT_db3bac356a_08212005.nii.gz,0.0,0.037323062896728515,0.0
474,0.9268947963800905,696,338,0.8637501647120833,52152411,6555,6893,7251,/well/papiez/users/hri611/python/nnUNet_results/Dataset219_PETCT/nnUNetTrainer__nnUNetPlans__3d_fullres_maxnum_512_patch_192/crossval_results_folds_0_1_2/PETCT_db3daf78d2_10302000.nii.gz,/well/papiez/users/hri611/python/nnUnet_raw/Dataset219_PETCT/labelsTr/PETCT_db3daf78d2_10302000.nii.gz,0.9268947963800905,0.6344920692443847,0.0
475,,0,0,,48000000,0,0,0,/well/papiez/users/hri611/python/nnUNet_results/Dataset219_PETCT/nnUNetTrainer__nnUNetPlans__3d_fullres_maxnum_512_patch_192/crossval_results_folds_0_1_2/PETCT_dc15c1d9bb_06032005.nii.gz,/well/papiez/users/hri611/python/nnUnet_raw/Dataset219_PETCT/labelsTr/PETCT_dc15c1d9bb_06032005.nii.gz,,0.0,0.0
476,0.8398957730167921,835,12437,0.7239830296980284,45391916,34812,47249,35647,/well/papiez/users/hri611/python/nnUNet_results/Dataset219_PETCT/nnUNetTrainer__nnUNetPlans__3d_fullres_maxnum_512_patch_192/crossval_results_folds_0_1_2/PETCT_dc6174cb5d_03292003.nii.gz,/well/papiez/users/hri611/python/nnUnet_raw/Dataset219_PETCT/labelsTr/PETCT_dc6174cb5d_03292003.nii.gz,0.8398957730167921,1.8537121238708496,7.352643390655517
477,0.8150470219435737,227,9,0.6878306878306878,45439244,520,529,747,/well/papiez/users/hri611/python/nnUNet_results/Dataset219_PETCT/nnUNetTrainer__nnUNetPlans__3d_fullres_maxnum_512_patch_192/crossval_results_folds_0_1_2/PETCT_dd68a71e0a_11202004.nii.gz,/well/papiez/users/hri611/python/nnUnet_raw/Dataset219_PETCT/labelsTr/PETCT_dd68a71e0a_11202004.nii.gz,0.8150470219435737,0.0,0.4105536918640137
478,,0,0,,48000000,0,0,0,/well/papiez/users/hri611/python/nnUNet_results/Dataset219_PETCT/nnUNetTrainer__nnUNetPlans__3d_fullres_maxnum_512_patch_192/crossval_results_folds_0_1_2/PETCT_dd887591a9_05062006.nii.gz,/well/papiez/users/hri611/python/nnUnet_raw/Dataset219_PETCT/labelsTr/PETCT_dd887591a9_05062006.nii.gz,,0.0,0.0
479,0.8652072714416192,3551,1024,0.7624363900716585,45420742,14683,15707,18234,/well/papiez/users/hri611/python/nnUNet_results/Dataset219_PETCT/nnUNetTrainer__nnUNetPlans__3d_fullres_maxnum_512_patch_192/crossval_results_folds_0_1_2/PETCT_dd975744e7_09232001.nii.gz,/well/papiez/users/hri611/python/nnUnet_raw/Dataset219_PETCT/labelsTr/PETCT_dd975744e7_09232001.nii.gz,0.8652072714416192,0.37323062896728515,0.435435733795166
480,0.712482966287538,1012,94567,0.5533775069624867,51945996,118425,212992,119437,/well/papiez/users/hri611/python/nnUNet_results/Dataset219_PETCT/nnUNetTrainer__nnUNetPlans__3d_fullres_maxnum_512_patch_192/crossval_results_folds_0_1_2/PETCT_ddbb3c69f0_08112003.nii.gz,/well/papiez/users/hri611/python/nnUnet_raw/Dataset219_PETCT/labelsTr/PETCT_ddbb3c69f0_08112003.nii.gz,0.712482966287538,96.15665104293824,1.231661075592041
481,0.2716170004885198,1491,0,0.15715093273035613,45438231,278,278,1769,/well/papiez/users/hri611/python/nnUNet_results/Dataset219_PETCT/nnUNetTrainer__nnUNetPlans__3d_fullres_maxnum_512_patch_192/crossval_results_folds_0_1_2/PETCT_de118d7ab9_06022001.nii.gz,/well/papiez/users/hri611/python/nnUnet_raw/Dataset219_PETCT/labelsTr/PETCT_de118d7ab9_06022001.nii.gz,0.2716170004885198,0.0,0.0
482,,0,0,,52160000,0,0,0,/well/papiez/users/hri611/python/nnUNet_results/Dataset219_PETCT/nnUNetTrainer__nnUNetPlans__3d_fullres_maxnum_512_patch_192/crossval_results_folds_0_1_2/PETCT_dec9ff6a91_03032003.nii.gz,/well/papiez/users/hri611/python/nnUnet_raw/Dataset219_PETCT/labelsTr/PETCT_dec9ff6a91_03032003.nii.gz,,0.0,0.0
483,,0,0,,52160000,0,0,0,/well/papiez/users/hri611/python/nnUNet_results/Dataset219_PETCT/nnUNetTrainer__nnUNetPlans__3d_fullres_maxnum_512_patch_192/crossval_results_folds_0_1_2/PETCT_df2e16771a_11142003.nii.gz,/well/papiez/users/hri611/python/nnUnet_raw/Dataset219_PETCT/labelsTr/PETCT_df2e16771a_11142003.nii.gz,,0.0,0.0
484,0.7941616766467066,22052,2148,0.6585971446306642,38649116,46684,48832,68736,/well/papiez/users/hri611/python/nnUNet_results/Dataset219_PETCT/nnUNetTrainer__nnUNetPlans__3d_fullres_maxnum_512_patch_192/crossval_results_folds_0_1_2/PETCT_e03b96666f_05172001.nii.gz,/well/papiez/users/hri611/python/nnUnet_raw/Dataset219_PETCT/labelsTr/PETCT_e03b96666f_05172001.nii.gz,0.7941616766467066,0.11196918869018554,38.069524154663085
485,0.7752119263373283,734,35,0.6329355608591886,52157905,1326,1361,2060,/well/papiez/users/hri611/python/nnUNet_results/Dataset219_PETCT/nnUNetTrainer__nnUNetPlans__3d_fullres_maxnum_512_patch_192/crossval_results_folds_0_1_2/PETCT_e04b7fa860_06012002.nii.gz,/well/papiez/users/hri611/python/nnUnet_raw/Dataset219_PETCT/labelsTr/PETCT_e04b7fa860_06012002.nii.gz,0.7752119263373283,0.11196918869018554,4.988849407196045
486,,0,0,,47360000,0,0,0,/well/papiez/users/hri611/python/nnUNet_results/Dataset219_PETCT/nnUNetTrainer__nnUNetPlans__3d_fullres_maxnum_512_patch_192/crossval_results_folds_0_1_2/PETCT_e09a20d8fc_03162006.nii.gz,/well/papiez/users/hri611/python/nnUnet_raw/Dataset219_PETCT/labelsTr/PETCT_e09a20d8fc_03162006.nii.gz,,0.0,0.0
487,,0,0,,45440000,0,0,0,/well/papiez/users/hri611/python/nnUNet_results/Dataset219_PETCT/nnUNetTrainer__nnUNetPlans__3d_fullres_maxnum_512_patch_192/crossval_results_folds_0_1_2/PETCT_e0fdc6212a_05292003.nii.gz,/well/papiez/users/hri611/python/nnUnet_raw/Dataset219_PETCT/labelsTr/PETCT_e0fdc6212a_05292003.nii.gz,,0.0,0.0
488,0.8978134761267291,23,206,0.8145748987854251,51678765,1006,1212,1029,/well/papiez/users/hri611/python/nnUNet_results/Dataset219_PETCT/nnUNetTrainer__nnUNetPlans__3d_fullres_maxnum_512_patch_192/crossval_results_folds_0_1_2/PETCT_e1a4145b63_03052006.nii.gz,/well/papiez/users/hri611/python/nnUnet_raw/Dataset219_PETCT/labelsTr/PETCT_e1a4145b63_03052006.nii.gz,0.8978134761267291,2.2767068367004395,0.0
489,0.0,0,121,0.0,45439879,0,121,0,/well/papiez/users/hri611/python/nnUNet_results/Dataset219_PETCT/nnUNetTrainer__nnUNetPlans__3d_fullres_maxnum_512_patch_192/crossval_results_folds_0_1_2/PETCT_e1a5b05186_02272005.nii.gz,/well/papiez/users/hri611/python/nnUnet_raw/Dataset219_PETCT/labelsTr/PETCT_e1a5b05186_02272005.nii.gz,0.0,1.5053635368347167,0.0
490,,0,0,,38720000,0,0,0,/well/papiez/users/hri611/python/nnUNet_results/Dataset219_PETCT/nnUNetTrainer__nnUNetPlans__3d_fullres_maxnum_512_patch_192/crossval_results_folds_0_1_2/PETCT_e207c7a1a4_12232005.nii.gz,/well/papiez/users/hri611/python/nnUnet_raw/Dataset219_PETCT/labelsTr/PETCT_e207c7a1a4_12232005.nii.gz,,0.0,0.0
491,0.8217622159120898,3632,30138,0.697450232041427,52048382,77848,107986,81480,/well/papiez/users/hri611/python/nnUNet_results/Dataset219_PETCT/nnUNetTrainer__nnUNetPlans__3d_fullres_maxnum_512_patch_192/crossval_results_folds_0_1_2/PETCT_e252be4334_07092004.nii.gz,/well/papiez/users/hri611/python/nnUnet_raw/Dataset219_PETCT/labelsTr/PETCT_e252be4334_07092004.nii.gz,0.8217622159120898,9.641791248321534,3.9686856880187986
492,0.0,0,183,0.0,49919817,0,183,0,/well/papiez/users/hri611/python/nnUNet_results/Dataset219_PETCT/nnUNetTrainer__nnUNetPlans__3d_fullres_maxnum_512_patch_192/crossval_results_folds_0_1_2/PETCT_e344879c2e_11172006.nii.gz,/well/papiez/users/hri611/python/nnUnet_raw/Dataset219_PETCT/labelsTr/PETCT_e344879c2e_11172006.nii.gz,0.0,2.2767068367004395,0.0
493,0.7535862288810966,2211,108,0.6046035805626598,52154135,3546,3654,5757,/well/papiez/users/hri611/python/nnUNet_results/Dataset219_PETCT/nnUNetTrainer__nnUNetPlans__3d_fullres_maxnum_512_patch_192/crossval_results_folds_0_1_2/PETCT_e4712dc58c_02121999.nii.gz,/well/papiez/users/hri611/python/nnUnet_raw/Dataset219_PETCT/labelsTr/PETCT_e4712dc58c_02121999.nii.gz,0.7535862288810966,0.0,3.421280765533447
494,,0,0,,52160000,0,0,0,/well/papiez/users/hri611/python/nnUNet_results/Dataset219_PETCT/nnUNetTrainer__nnUNetPlans__3d_fullres_maxnum_512_patch_192/crossval_results_folds_0_1_2/PETCT_e4e5baf901_02142005.nii.gz,/well/papiez/users/hri611/python/nnUnet_raw/Dataset219_PETCT/labelsTr/PETCT_e4e5baf901_02142005.nii.gz,,0.0,0.0
495,,0,0,,47360000,0,0,0,/well/papiez/users/hri611/python/nnUNet_results/Dataset219_PETCT/nnUNetTrainer__nnUNetPlans__3d_fullres_maxnum_512_patch_192/crossval_results_folds_0_1_2/PETCT_e52eca67d7_03132006.nii.gz,/well/papiez/users/hri611/python/nnUnet_raw/Dataset219_PETCT/labelsTr/PETCT_e52eca67d7_03132006.nii.gz,,0.0,0.0
496,0.0,0,7,0.0,45439993,0,7,0,/well/papiez/users/hri611/python/nnUNet_results/Dataset219_PETCT/nnUNetTrainer__nnUNetPlans__3d_fullres_maxnum_512_patch_192/crossval_results_folds_0_1_2/PETCT_e5b1d6b4bd_10232004.nii.gz,/well/papiez/users/hri611/python/nnUnet_raw/Dataset219_PETCT/labelsTr/PETCT_e5b1d6b4bd_10232004.nii.gz,0.0,0.0870871467590332,0.0
497,,0,0,,92320000,0,0,0,/well/papiez/users/hri611/python/nnUNet_results/Dataset219_PETCT/nnUNetTrainer__nnUNetPlans__3d_fullres_maxnum_512_patch_192/crossval_results_folds_0_1_2/PETCT_e5c7be07a8_04082005.nii.gz,/well/papiez/users/hri611/python/nnUnet_raw/Dataset219_PETCT/labelsTr/PETCT_e5c7be07a8_04082005.nii.gz,,0.0,0.0
498,,0,0,,45440000,0,0,0,/well/papiez/users/hri611/python/nnUNet_results/Dataset219_PETCT/nnUNetTrainer__nnUNetPlans__3d_fullres_maxnum_512_patch_192/crossval_results_folds_0_1_2/PETCT_e5e1918765_07242003.nii.gz,/well/papiez/users/hri611/python/nnUnet_raw/Dataset219_PETCT/labelsTr/PETCT_e5e1918765_07242003.nii.gz,,0.0,0.0
499,0.9299936319252813,1328,321,0.8691477543247104,52147398,10953,11274,12281,/well/papiez/users/hri611/python/nnUNet_results/Dataset219_PETCT/nnUNetTrainer__nnUNetPlans__3d_fullres_maxnum_512_patch_192/crossval_results_folds_0_1_2/PETCT_e61c9da258_12132002.nii.gz,/well/papiez/users/hri611/python/nnUnet_raw/Dataset219_PETCT/labelsTr/PETCT_e61c9da258_12132002.nii.gz,0.9299936319252813,0.5474049224853516,0.024882041931152343
500,0.0,0,192,0.0,51839808,0,192,0,/well/papiez/users/hri611/python/nnUNet_results/Dataset219_PETCT/nnUNetTrainer__nnUNetPlans__3d_fullres_maxnum_512_patch_192/crossval_results_folds_0_1_2/PETCT_e664932bbc_06092007.nii.gz,/well/papiez/users/hri611/python/nnUnet_raw/Dataset219_PETCT/labelsTr/PETCT_e664932bbc_06092007.nii.gz,0.0,2.388676025390625,0.0
501,,0,0,,51200000,0,0,0,/well/papiez/users/hri611/python/nnUNet_results/Dataset219_PETCT/nnUNetTrainer__nnUNetPlans__3d_fullres_maxnum_512_patch_192/crossval_results_folds_0_1_2/PETCT_e68c4577d8_05252007.nii.gz,/well/papiez/users/hri611/python/nnUnet_raw/Dataset219_PETCT/labelsTr/PETCT_e68c4577d8_05252007.nii.gz,,0.0,0.0
502,,0,0,,48160000,0,0,0,/well/papiez/users/hri611/python/nnUNet_results/Dataset219_PETCT/nnUNetTrainer__nnUNetPlans__3d_fullres_maxnum_512_patch_192/crossval_results_folds_0_1_2/PETCT_e6a91fef70_03022006.nii.gz,/well/papiez/users/hri611/python/nnUnet_raw/Dataset219_PETCT/labelsTr/PETCT_e6a91fef70_03022006.nii.gz,,0.0,0.0
503,0.46808510638297873,125,0,0.3055555555555556,89759820,55,55,180,/well/papiez/users/hri611/python/nnUNet_results/Dataset219_PETCT/nnUNetTrainer__nnUNetPlans__3d_fullres_maxnum_512_patch_192/crossval_results_folds_0_1_2/PETCT_e79291780d_05142007.nii.gz,/well/papiez/users/hri611/python/nnUnet_raw/Dataset219_PETCT/labelsTr/PETCT_e79291780d_05142007.nii.gz,0.46808510638297873,0.0,0.0
504,0.0,0,170,0.0,92319830,0,170,0,/well/papiez/users/hri611/python/nnUNet_results/Dataset219_PETCT/nnUNetTrainer__nnUNetPlans__3d_fullres_maxnum_512_patch_192/crossval_results_folds_0_1_2/PETCT_e90a287d09_08222002.nii.gz,/well/papiez/users/hri611/python/nnUnet_raw/Dataset219_PETCT/labelsTr/PETCT_e90a287d09_08222002.nii.gz,0.0,2.1149735641479492,0.0
505,0.8042906719949522,1504,357,0.6726473175021987,45434315,3824,4181,5328,/well/papiez/users/hri611/python/nnUNet_results/Dataset219_PETCT/nnUNetTrainer__nnUNetPlans__3d_fullres_maxnum_512_patch_192/crossval_results_folds_0_1_2/PETCT_e9e1a391b5_10112001.nii.gz,/well/papiez/users/hri611/python/nnUnet_raw/Dataset219_PETCT/labelsTr/PETCT_e9e1a391b5_10112001.nii.gz,0.8042906719949522,0.0,0.0
506,0.8805175724614334,8243,1028,0.7865398784306502,52116568,34161,35189,42404,/well/papiez/users/hri611/python/nnUNet_results/Dataset219_PETCT/nnUNetTrainer__nnUNetPlans__3d_fullres_maxnum_512_patch_192/crossval_results_folds_0_1_2/PETCT_ea0fd89f0f_10252003.nii.gz,/well/papiez/users/hri611/python/nnUnet_raw/Dataset219_PETCT/labelsTr/PETCT_ea0fd89f0f_10252003.nii.gz,0.8805175724614334,0.4603177757263184,7.576581768035888
507,0.8929894724460389,11636,2920,0.8066675521317572,47124710,60734,63654,72370,/well/papiez/users/hri611/python/nnUNet_results/Dataset219_PETCT/nnUNetTrainer__nnUNetPlans__3d_fullres_maxnum_512_patch_192/crossval_results_folds_0_1_2/PETCT_ea42c88cc7_02262006.nii.gz,/well/papiez/users/hri611/python/nnUnet_raw/Dataset219_PETCT/labelsTr/PETCT_ea42c88cc7_02262006.nii.gz,0.8929894724460389,5.94680802154541,2.5752913398742674
508,0.7523144388500893,41,1484,0.6029679770892996,51516159,2316,3800,2357,/well/papiez/users/hri611/python/nnUNet_results/Dataset219_PETCT/nnUNetTrainer__nnUNetPlans__3d_fullres_maxnum_512_patch_192/crossval_results_folds_0_1_2/PETCT_ea6c621616_08082005.nii.gz,/well/papiez/users/hri611/python/nnUnet_raw/Dataset219_PETCT/labelsTr/PETCT_ea6c621616_08082005.nii.gz,0.7523144388500893,2.0403274383544923,0.0
509,0.9243632621559043,646,530,0.8593637885673284,45431638,7186,7716,7832,/well/papiez/users/hri611/python/nnUNet_results/Dataset219_PETCT/nnUNetTrainer__nnUNetPlans__3d_fullres_maxnum_512_patch_192/crossval_results_folds_0_1_2/PETCT_ec6b934720_10252002.nii.gz,/well/papiez/users/hri611/python/nnUnet_raw/Dataset219_PETCT/labelsTr/PETCT_ec6b934720_10252002.nii.gz,0.9243632621559043,0.0,0.0
510,,0,0,,56480000,0,0,0,/well/papiez/users/hri611/python/nnUNet_results/Dataset219_PETCT/nnUNetTrainer__nnUNetPlans__3d_fullres_maxnum_512_patch_192/crossval_results_folds_0_1_2/PETCT_eda00de6b0_06242006.nii.gz,/well/papiez/users/hri611/python/nnUnet_raw/Dataset219_PETCT/labelsTr/PETCT_eda00de6b0_06242006.nii.gz,,0.0,0.0
511,0.7111194590533434,2975,101,0.5517341882832993,52153138,3786,3887,6761,/well/papiez/users/hri611/python/nnUNet_results/Dataset219_PETCT/nnUNetTrainer__nnUNetPlans__3d_fullres_maxnum_512_patch_192/crossval_results_folds_0_1_2/PETCT_ee97822c60_03032003.nii.gz,/well/papiez/users/hri611/python/nnUnet_raw/Dataset219_PETCT/labelsTr/PETCT_ee97822c60_03032003.nii.gz,0.7111194590533434,0.2239383773803711,5.586018413543701
512,,0,0,,48160000,0,0,0,/well/papiez/users/hri611/python/nnUNet_results/Dataset219_PETCT/nnUNetTrainer__nnUNetPlans__3d_fullres_maxnum_512_patch_192/crossval_results_folds_0_1_2/PETCT_eee2ede9ad_11242006.nii.gz,/well/papiez/users/hri611/python/nnUnet_raw/Dataset219_PETCT/labelsTr/PETCT_eee2ede9ad_11242006.nii.gz,,0.0,0.0
513,0.9002975656974869,1873,908,0.818673795396753,45424663,12556,13464,14429,/well/papiez/users/hri611/python/nnUNet_results/Dataset219_PETCT/nnUNetTrainer__nnUNetPlans__3d_fullres_maxnum_512_patch_192/crossval_results_folds_0_1_2/PETCT_eeeda112bb_06072003.nii.gz,/well/papiez/users/hri611/python/nnUnet_raw/Dataset219_PETCT/labelsTr/PETCT_eeeda112bb_06072003.nii.gz,0.9002975656974869,0.0,0.0
514,0.0,0,4729,0.0,92475271,0,4729,0,/well/papiez/users/hri611/python/nnUNet_results/Dataset219_PETCT/nnUNetTrainer__nnUNetPlans__3d_fullres_maxnum_512_patch_192/crossval_results_folds_0_1_2/PETCT_f068e22258_05142007.nii.gz,/well/papiez/users/hri611/python/nnUnet_raw/Dataset219_PETCT/labelsTr/PETCT_f068e22258_05142007.nii.gz,0.0,58.83358814620971,0.0
515,0.7055478115416783,2459,2822,0.5450551343900758,52148392,6327,9149,8786,/well/papiez/users/hri611/python/nnUNet_results/Dataset219_PETCT/nnUNetTrainer__nnUNetPlans__3d_fullres_maxnum_512_patch_192/crossval_results_folds_0_1_2/PETCT_f11f3d3692_10242003.nii.gz,/well/papiez/users/hri611/python/nnUnet_raw/Dataset219_PETCT/labelsTr/PETCT_f11f3d3692_10242003.nii.gz,0.7055478115416783,1.0077226982116698,17.51695751953125
516,0.9369493651042483,1506,505,0.8813779272105232,45423047,14942,15447,16448,/well/papiez/users/hri611/python/nnUNet_results/Dataset219_PETCT/nnUNetTrainer__nnUNetPlans__3d_fullres_maxnum_512_patch_192/crossval_results_folds_0_1_2/PETCT_f1501b1f45_03202005.nii.gz,/well/papiez/users/hri611/python/nnUnet_raw/Dataset219_PETCT/labelsTr/PETCT_f1501b1f45_03202005.nii.gz,0.9369493651042483,0.07464612579345703,1.443158432006836
517,0.0,0,346,0.0,72159654,0,346,0,/well/papiez/users/hri611/python/nnUNet_results/Dataset219_PETCT/nnUNetTrainer__nnUNetPlans__3d_fullres_maxnum_512_patch_192/crossval_results_folds_0_1_2/PETCT_f1594a7d8a_04252003.nii.gz,/well/papiez/users/hri611/python/nnUnet_raw/Dataset219_PETCT/labelsTr/PETCT_f1594a7d8a_04252003.nii.gz,0.0,4.3045932540893554,0.0
518,0.0,0,5,0.0,47519995,0,5,0,/well/papiez/users/hri611/python/nnUNet_results/Dataset219_PETCT/nnUNetTrainer__nnUNetPlans__3d_fullres_maxnum_512_patch_192/crossval_results_folds_0_1_2/PETCT_f15b868db6_02032006.nii.gz,/well/papiez/users/hri611/python/nnUnet_raw/Dataset219_PETCT/labelsTr/PETCT_f15b868db6_02032006.nii.gz,0.0,0.06220510482788086,0.0
519,0.7392721347093971,825,135,0.5863851788022404,99037679,1361,1496,2186,/well/papiez/users/hri611/python/nnUNet_results/Dataset219_PETCT/nnUNetTrainer__nnUNetPlans__3d_fullres_maxnum_512_patch_192/crossval_results_folds_0_1_2/PETCT_f1ca0f7c4c_12222001.nii.gz,/well/papiez/users/hri611/python/nnUnet_raw/Dataset219_PETCT/labelsTr/PETCT_f1ca0f7c4c_12222001.nii.gz,0.7392721347093971,0.360789608001709,1.667096809387207
520,0.9136638577263093,6620,6740,0.8410507780897539,45355948,70692,77432,77312,/well/papiez/users/hri611/python/nnUNet_results/Dataset219_PETCT/nnUNetTrainer__nnUNetPlans__3d_fullres_maxnum_512_patch_192/crossval_results_folds_0_1_2/PETCT_f21755a99b_05052005.nii.gz,/well/papiez/users/hri611/python/nnUnet_raw/Dataset219_PETCT/labelsTr/PETCT_f21755a99b_05052005.nii.gz,0.9136638577263093,1.0699278030395507,0.435435733795166
521,0.7478094194961665,1665,177,0.5972009621692543,52155427,2731,2908,4396,/well/papiez/users/hri611/python/nnUNet_results/Dataset219_PETCT/nnUNetTrainer__nnUNetPlans__3d_fullres_maxnum_512_patch_192/crossval_results_folds_0_1_2/PETCT_f2f28337ba_05032001.nii.gz,/well/papiez/users/hri611/python/nnUnet_raw/Dataset219_PETCT/labelsTr/PETCT_f2f28337ba_05032001.nii.gz,0.7478094194961665,0.04976408386230469,0.0
522,0.0,0,271,0.0,99039729,0,271,0,/well/papiez/users/hri611/python/nnUNet_results/Dataset219_PETCT/nnUNetTrainer__nnUNetPlans__3d_fullres_maxnum_512_patch_192/crossval_results_folds_0_1_2/PETCT_f4a5ebd915_10032003.nii.gz,/well/papiez/users/hri611/python/nnUnet_raw/Dataset219_PETCT/labelsTr/PETCT_f4a5ebd915_10032003.nii.gz,0.0,3.3715166816711424,0.0
523,0.9228760445682451,1778,880,0.8567965088087927,52141439,15903,16783,17681,/well/papiez/users/hri611/python/nnUNet_results/Dataset219_PETCT/nnUNetTrainer__nnUNetPlans__3d_fullres_maxnum_512_patch_192/crossval_results_folds_0_1_2/PETCT_f5c2c09846_10282002.nii.gz,/well/papiez/users/hri611/python/nnUnet_raw/Dataset219_PETCT/labelsTr/PETCT_f5c2c09846_10282002.nii.gz,0.9228760445682451,0.0,7.4024074745178225
524,0.6872315746575127,16669,3285,0.5234979463176999,92278124,21922,25207,38591,/well/papiez/users/hri611/python/nnUNet_results/Dataset219_PETCT/nnUNetTrainer__nnUNetPlans__3d_fullres_maxnum_512_patch_192/crossval_results_folds_0_1_2/PETCT_f5c9b0de6c_04022004.nii.gz,/well/papiez/users/hri611/python/nnUnet_raw/Dataset219_PETCT/labelsTr/PETCT_f5c9b0de6c_04022004.nii.gz,0.6872315746575127,21.28658687210083,72.17036262130738
525,,0,0,,65280000,0,0,0,/well/papiez/users/hri611/python/nnUNet_results/Dataset219_PETCT/nnUNetTrainer__nnUNetPlans__3d_fullres_maxnum_512_patch_192/crossval_results_folds_0_1_2/PETCT_f5cff2e59d_05102007.nii.gz,/well/papiez/users/hri611/python/nnUnet_raw/Dataset219_PETCT/labelsTr/PETCT_f5cff2e59d_05102007.nii.gz,,0.0,0.0
526,,0,0,,52160000,0,0,0,/well/papiez/users/hri611/python/nnUNet_results/Dataset219_PETCT/nnUNetTrainer__nnUNetPlans__3d_fullres_maxnum_512_patch_192/crossval_results_folds_0_1_2/PETCT_f603eeceba_03172003.nii.gz,/well/papiez/users/hri611/python/nnUnet_raw/Dataset219_PETCT/labelsTr/PETCT_f603eeceba_03172003.nii.gz,,0.0,0.0
527,0.8825324357690247,8604,1482,0.7897611206069954,52112026,37888,39370,46492,/well/papiez/users/hri611/python/nnUNet_results/Dataset219_PETCT/nnUNetTrainer__nnUNetPlans__3d_fullres_maxnum_512_patch_192/crossval_results_folds_0_1_2/PETCT_f60ea3abc5_05032003.nii.gz,/well/papiez/users/hri611/python/nnUnet_raw/Dataset219_PETCT/labelsTr/PETCT_f60ea3abc5_05032003.nii.gz,0.8825324357690247,0.0,1.6297737464904785
528,0.0,0,8767,0.0,47191233,0,8767,0,/well/papiez/users/hri611/python/nnUNet_results/Dataset219_PETCT/nnUNetTrainer__nnUNetPlans__3d_fullres_maxnum_512_patch_192/crossval_results_folds_0_1_2/PETCT_f6295a93a6_10092006.nii.gz,/well/papiez/users/hri611/python/nnUnet_raw/Dataset219_PETCT/labelsTr/PETCT_f6295a93a6_10092006.nii.gz,0.0,109.0704308052063,0.0
529,0.0,0,2,0.0,47519998,0,2,0,/well/papiez/users/hri611/python/nnUNet_results/Dataset219_PETCT/nnUNetTrainer__nnUNetPlans__3d_fullres_maxnum_512_patch_192/crossval_results_folds_0_1_2/PETCT_f650c87621_12082005.nii.gz,/well/papiez/users/hri611/python/nnUnet_raw/Dataset219_PETCT/labelsTr/PETCT_f650c87621_12082005.nii.gz,0.0,0.024882041931152343,0.0
530,0.8574596946174188,844,827,0.7504852919217561,52313303,5026,5853,5870,/well/papiez/users/hri611/python/nnUNet_results/Dataset219_PETCT/nnUNetTrainer__nnUNetPlans__3d_fullres_maxnum_512_patch_192/crossval_results_folds_0_1_2/PETCT_f65602d938_03252007.nii.gz,/well/papiez/users/hri611/python/nnUnet_raw/Dataset219_PETCT/labelsTr/PETCT_f65602d938_03252007.nii.gz,0.8574596946174188,2.699701549530029,3.620337100982666
531,0.7701375245579568,4702,1499,0.6261980830670927,52143411,10388,11887,15090,/well/papiez/users/hri611/python/nnUNet_results/Dataset219_PETCT/nnUNetTrainer__nnUNetPlans__3d_fullres_maxnum_512_patch_192/crossval_results_folds_0_1_2/PETCT_f7067b7bbb_05262001.nii.gz,/well/papiez/users/hri611/python/nnUnet_raw/Dataset219_PETCT/labelsTr/PETCT_f7067b7bbb_05262001.nii.gz,0.7701375245579568,0.0,21.099971557617188
532,,0,0,,52160000,0,0,0,/well/papiez/users/hri611/python/nnUNet_results/Dataset219_PETCT/nnUNetTrainer__nnUNetPlans__3d_fullres_maxnum_512_patch_192/crossval_results_folds_0_1_2/PETCT_f7a9267a69_02012003.nii.gz,/well/papiez/users/hri611/python/nnUnet_raw/Dataset219_PETCT/labelsTr/PETCT_f7a9267a69_02012003.nii.gz,,0.0,0.0
533,0.0,0,175,0.0,52159825,0,175,0,/well/papiez/users/hri611/python/nnUNet_results/Dataset219_PETCT/nnUNetTrainer__nnUNetPlans__3d_fullres_maxnum_512_patch_192/crossval_results_folds_0_1_2/PETCT_f7a9267a69_11012002.nii.gz,/well/papiez/users/hri611/python/nnUnet_raw/Dataset219_PETCT/labelsTr/PETCT_f7a9267a69_11012002.nii.gz,0.0,2.17717866897583,0.0
534,,0,0,,45440000,0,0,0,/well/papiez/users/hri611/python/nnUNet_results/Dataset219_PETCT/nnUNetTrainer__nnUNetPlans__3d_fullres_maxnum_512_patch_192/crossval_results_folds_0_1_2/PETCT_f8314eb3f7_03142003.nii.gz,/well/papiez/users/hri611/python/nnUnet_raw/Dataset219_PETCT/labelsTr/PETCT_f8314eb3f7_03142003.nii.gz,,0.0,0.0
535,,0,0,,45440000,0,0,0,/well/papiez/users/hri611/python/nnUNet_results/Dataset219_PETCT/nnUNetTrainer__nnUNetPlans__3d_fullres_maxnum_512_patch_192/crossval_results_folds_0_1_2/PETCT_f8314eb3f7_09202003.nii.gz,/well/papiez/users/hri611/python/nnUnet_raw/Dataset219_PETCT/labelsTr/PETCT_f8314eb3f7_09202003.nii.gz,,0.0,0.0
536,,0,0,,52320000,0,0,0,/well/papiez/users/hri611/python/nnUNet_results/Dataset219_PETCT/nnUNetTrainer__nnUNetPlans__3d_fullres_maxnum_512_patch_192/crossval_results_folds_0_1_2/PETCT_f8aac0e202_02262006.nii.gz,/well/papiez/users/hri611/python/nnUnet_raw/Dataset219_PETCT/labelsTr/PETCT_f8aac0e202_02262006.nii.gz,,0.0,0.0
537,,0,0,,50880000,0,0,0,/well/papiez/users/hri611/python/nnUNet_results/Dataset219_PETCT/nnUNetTrainer__nnUNetPlans__3d_fullres_maxnum_512_patch_192/crossval_results_folds_0_1_2/PETCT_f8aac0e202_07302006.nii.gz,/well/papiez/users/hri611/python/nnUnet_raw/Dataset219_PETCT/labelsTr/PETCT_f8aac0e202_07302006.nii.gz,,0.0,0.0
538,,0,0,,53440000,0,0,0,/well/papiez/users/hri611/python/nnUNet_results/Dataset219_PETCT/nnUNetTrainer__nnUNetPlans__3d_fullres_maxnum_512_patch_192/crossval_results_folds_0_1_2/PETCT_f8de0cde56_12052005.nii.gz,/well/papiez/users/hri611/python/nnUnet_raw/Dataset219_PETCT/labelsTr/PETCT_f8de0cde56_12052005.nii.gz,,0.0,0.0
539,0.7258047734981377,1426,11751,0.5696181859751118,63489383,17440,29191,18866,/well/papiez/users/hri611/python/nnUNet_results/Dataset219_PETCT/nnUNetTrainer__nnUNetPlans__3d_fullres_maxnum_512_patch_192/crossval_results_folds_0_1_2/PETCT_f9c4d4f9ab_03222007.nii.gz,/well/papiez/users/hri611/python/nnUnet_raw/Dataset219_PETCT/labelsTr/PETCT_f9c4d4f9ab_03222007.nii.gz,0.7258047734981377,3.4461628074645994,0.0
540,0.9693366708385481,37,61,0.9404978749241044,52158353,1549,1610,1586,/well/papiez/users/hri611/python/nnUNet_results/Dataset219_PETCT/nnUNetTrainer__nnUNetPlans__3d_fullres_maxnum_512_patch_192/crossval_results_folds_0_1_2/PETCT_f9e0c504af_06292003.nii.gz,/well/papiez/users/hri611/python/nnUnet_raw/Dataset219_PETCT/labelsTr/PETCT_f9e0c504af_06292003.nii.gz,0.9693366708385481,0.0,0.012441020965576172
541,,0,0,,45440000,0,0,0,/well/papiez/users/hri611/python/nnUNet_results/Dataset219_PETCT/nnUNetTrainer__nnUNetPlans__3d_fullres_maxnum_512_patch_192/crossval_results_folds_0_1_2/PETCT_fa45f610c4_10072004.nii.gz,/well/papiez/users/hri611/python/nnUnet_raw/Dataset219_PETCT/labelsTr/PETCT_fa45f610c4_10072004.nii.gz,,0.0,0.0
542,0.6433854735055171,2937,4,0.47425813371469433,52154406,2653,2657,5590,/well/papiez/users/hri611/python/nnUNet_results/Dataset219_PETCT/nnUNetTrainer__nnUNetPlans__3d_fullres_maxnum_512_patch_192/crossval_results_folds_0_1_2/PETCT_faf4a6dbaa_01102003.nii.gz,/well/papiez/users/hri611/python/nnUnet_raw/Dataset219_PETCT/labelsTr/PETCT_faf4a6dbaa_01102003.nii.gz,0.6433854735055171,0.0,8.609186508178711
543,0.42627173213135866,0,1782,0.27086743044189854,47997556,662,2444,662,/well/papiez/users/hri611/python/nnUNet_results/Dataset219_PETCT/nnUNetTrainer__nnUNetPlans__3d_fullres_maxnum_512_patch_192/crossval_results_folds_0_1_2/PETCT_fb014a1ea0_12012005.nii.gz,/well/papiez/users/hri611/python/nnUnet_raw/Dataset219_PETCT/labelsTr/PETCT_fb014a1ea0_12012005.nii.gz,0.42627173213135866,0.0,0.0
544,,0,0,,95520000,0,0,0,/well/papiez/users/hri611/python/nnUNet_results/Dataset219_PETCT/nnUNetTrainer__nnUNetPlans__3d_fullres_maxnum_512_patch_192/crossval_results_folds_0_1_2/PETCT_fc0389a486_05302005.nii.gz,/well/papiez/users/hri611/python/nnUnet_raw/Dataset219_PETCT/labelsTr/PETCT_fc0389a486_05302005.nii.gz,,0.0,0.0
545,0.8605196836708091,1297,308,0.7551860890787065,99033444,4951,5259,6248,/well/papiez/users/hri611/python/nnUNet_results/Dataset219_PETCT/nnUNetTrainer__nnUNetPlans__3d_fullres_maxnum_512_patch_192/crossval_results_folds_0_1_2/PETCT_fcdbe15200_12142003.nii.gz,/well/papiez/users/hri611/python/nnUnet_raw/Dataset219_PETCT/labelsTr/PETCT_fcdbe15200_12142003.nii.gz,0.8605196836708091,0.0,0.06220510482788086
546,0.5674300254452926,268,72,0.3960923623445826,47839437,223,295,491,/well/papiez/users/hri611/python/nnUNet_results/Dataset219_PETCT/nnUNetTrainer__nnUNetPlans__3d_fullres_maxnum_512_patch_192/crossval_results_folds_0_1_2/PETCT_fde66dd53a_12222005.nii.gz,/well/papiez/users/hri611/python/nnUnet_raw/Dataset219_PETCT/labelsTr/PETCT_fde66dd53a_12222005.nii.gz,0.5674300254452926,0.0,3.0107270736694334
547,,0,0,,92320000,0,0,0,/well/papiez/users/hri611/python/nnUNet_results/Dataset219_PETCT/nnUNetTrainer__nnUNetPlans__3d_fullres_maxnum_512_patch_192/crossval_results_folds_0_1_2/PETCT_fde79b6aa9_02232003.nii.gz,/well/papiez/users/hri611/python/nnUnet_raw/Dataset219_PETCT/labelsTr/PETCT_fde79b6aa9_02232003.nii.gz,,0.0,0.0
548,,0,0,,92320000,0,0,0,/well/papiez/users/hri611/python/nnUNet_results/Dataset219_PETCT/nnUNetTrainer__nnUNetPlans__3d_fullres_maxnum_512_patch_192/crossval_results_folds_0_1_2/PETCT_fde79b6aa9_08162003.nii.gz,/well/papiez/users/hri611/python/nnUnet_raw/Dataset219_PETCT/labelsTr/PETCT_fde79b6aa9_08162003.nii.gz,,0.0,0.0
549,0.0,0,174,0.0,45439826,0,174,0,/well/papiez/users/hri611/python/nnUNet_results/Dataset219_PETCT/nnUNetTrainer__nnUNetPlans__3d_fullres_maxnum_512_patch_192/crossval_results_folds_0_1_2/PETCT_fe705ea1cc_04272003.nii.gz,/well/papiez/users/hri611/python/nnUnet_raw/Dataset219_PETCT/labelsTr/PETCT_fe705ea1cc_04272003.nii.gz,0.0,2.164737648010254,0.0
550,0.7423699099529844,7092,2607,0.5902927385629197,45416327,13974,16581,21066,/well/papiez/users/hri611/python/nnUNet_results/Dataset219_PETCT/nnUNetTrainer__nnUNetPlans__3d_fullres_maxnum_512_patch_192/crossval_results_folds_0_1_2/PETCT_fe705ea1cc_12292002.nii.gz,/well/papiez/users/hri611/python/nnUnet_raw/Dataset219_PETCT/labelsTr/PETCT_fe705ea1cc_12292002.nii.gz,0.7423699099529844,3.5208089332580568,37.13644758224487
551,,0,0,,52160000,0,0,0,/well/papiez/users/hri611/python/nnUNet_results/Dataset219_PETCT/nnUNetTrainer__nnUNetPlans__3d_fullres_maxnum_512_patch_192/crossval_results_folds_0_1_2/PETCT_ff1451316e_03312003.nii.gz,/well/papiez/users/hri611/python/nnUnet_raw/Dataset219_PETCT/labelsTr/PETCT_ff1451316e_03312003.nii.gz,,0.0,0.0
