,DICE,FN,FP,IoU,TN,TP,n_pred,n_ref,prediction_file,reference_file,challenge_DICE,challenge_FP,challenge_FN
0,0.8987293030419715,132,131,0.8160839160839161,52158570,1167,1298,1299,/well/papiez/users/hri611/python/nnUNet_results/Dataset219_PETCT/nnUNetTrainer_probabilisticOversampling_033__nnUNetPlans__3d_fullres/crossval_results_folds_0_1_2/PETCT_0011f3deaf_03232003.nii.gz,/well/papiez/users/hri611/python/nnUnet_raw/Dataset219_PETCT/labelsTr/PETCT_0011f3deaf_03232003.nii.gz,0.8987293030419715,0.9828406562805175,0.0
1,0.7472371658534551,5494,567,0.5964713715046605,45424980,8959,9526,14453,/well/papiez/users/hri611/python/nnUNet_results/Dataset219_PETCT/nnUNetTrainer_probabilisticOversampling_033__nnUNetPlans__3d_fullres/crossval_results_folds_0_1_2/PETCT_0117d7f11f_09132001.nii.gz,/well/papiez/users/hri611/python/nnUnet_raw/Dataset219_PETCT/labelsTr/PETCT_0117d7f11f_09132001.nii.gz,0.7472371658534551,0.06220510482788086,0.09952816772460937
2,0.0,0,445,0.0,46079555,0,445,0,/well/papiez/users/hri611/python/nnUNet_results/Dataset219_PETCT/nnUNetTrainer_probabilisticOversampling_033__nnUNetPlans__3d_fullres/crossval_results_folds_0_1_2/PETCT_0143bab87a_07172005.nii.gz,/well/papiez/users/hri611/python/nnUnet_raw/Dataset219_PETCT/labelsTr/PETCT_0143bab87a_07172005.nii.gz,0.0,5.536254329681396,0.0
3,0.5177816463566277,7629,127,0.3493288590604027,52148080,4164,4291,11793,/well/papiez/users/hri611/python/nnUNet_results/Dataset219_PETCT/nnUNetTrainer_probabilisticOversampling_033__nnUNetPlans__3d_fullres/crossval_results_folds_0_1_2/PETCT_01682f60c3_03112002.nii.gz,/well/papiez/users/hri611/python/nnUnet_raw/Dataset219_PETCT/labelsTr/PETCT_01682f60c3_03112002.nii.gz,0.5177816463566277,0.42299471282958984,30.86617301559448
4,0.2413793103448276,1,43,0.13725490196078433,99039949,7,50,8,/well/papiez/users/hri611/python/nnUNet_results/Dataset219_PETCT/nnUNetTrainer_probabilisticOversampling_033__nnUNetPlans__3d_fullres/crossval_results_folds_0_1_2/PETCT_0223010e46_09042003.nii.gz,/well/papiez/users/hri611/python/nnUnet_raw/Dataset219_PETCT/labelsTr/PETCT_0223010e46_09042003.nii.gz,0.2413793103448276,0.4727587966918945,0.012441020965576172
5,,0,0,,37120000,0,0,0,/well/papiez/users/hri611/python/nnUNet_results/Dataset219_PETCT/nnUNetTrainer_probabilisticOversampling_033__nnUNetPlans__3d_fullres/crossval_results_folds_0_1_2/PETCT_0225325b91_08222005.nii.gz,/well/papiez/users/hri611/python/nnUnet_raw/Dataset219_PETCT/labelsTr/PETCT_0225325b91_08222005.nii.gz,,0.0,0.0
6,0.0,0,4556,0.0,45435444,0,4556,0,/well/papiez/users/hri611/python/nnUNet_results/Dataset219_PETCT/nnUNetTrainer_probabilisticOversampling_033__nnUNetPlans__3d_fullres/crossval_results_folds_0_1_2/PETCT_0410759456_08222003.nii.gz,/well/papiez/users/hri611/python/nnUnet_raw/Dataset219_PETCT/labelsTr/PETCT_0410759456_08222003.nii.gz,0.0,56.681291519165036,0.0
7,0.0,0,9,0.0,45439991,0,9,0,/well/papiez/users/hri611/python/nnUNet_results/Dataset219_PETCT/nnUNetTrainer_probabilisticOversampling_033__nnUNetPlans__3d_fullres/crossval_results_folds_0_1_2/PETCT_0410759456_11072002.nii.gz,/well/papiez/users/hri611/python/nnUnet_raw/Dataset219_PETCT/labelsTr/PETCT_0410759456_11072002.nii.gz,0.0,0.11196918869018554,0.0
8,0.8270538858603889,946,2639,0.7051081681335856,45427843,8572,11211,9518,/well/papiez/users/hri611/python/nnUNet_results/Dataset219_PETCT/nnUNetTrainer_probabilisticOversampling_033__nnUNetPlans__3d_fullres/crossval_results_folds_0_1_2/PETCT_04606080a0_02202003.nii.gz,/well/papiez/users/hri611/python/nnUnet_raw/Dataset219_PETCT/labelsTr/PETCT_04606080a0_02202003.nii.gz,0.8270538858603889,2.699701549530029,0.0
9,0.8694376065139178,785,1973,0.7690310694246713,45428059,9183,11156,9968,/well/papiez/users/hri611/python/nnUNet_results/Dataset219_PETCT/nnUNetTrainer_probabilisticOversampling_033__nnUNetPlans__3d_fullres/crossval_results_folds_0_1_2/PETCT_04a4e1c874_11182001.nii.gz,/well/papiez/users/hri611/python/nnUnet_raw/Dataset219_PETCT/labelsTr/PETCT_04a4e1c874_11182001.nii.gz,0.8694376065139178,20.204218048095704,0.0
10,0.0,0,402,0.0,51839598,0,402,0,/well/papiez/users/hri611/python/nnUNet_results/Dataset219_PETCT/nnUNetTrainer_probabilisticOversampling_033__nnUNetPlans__3d_fullres/crossval_results_folds_0_1_2/PETCT_05808cf24e_03182006.nii.gz,/well/papiez/users/hri611/python/nnUnet_raw/Dataset219_PETCT/labelsTr/PETCT_05808cf24e_03182006.nii.gz,0.0,5.001290428161621,0.0
11,0.8630009319664492,0,147,0.759016393442623,40639390,463,610,463,/well/papiez/users/hri611/python/nnUNet_results/Dataset219_PETCT/nnUNetTrainer_probabilisticOversampling_033__nnUNetPlans__3d_fullres/crossval_results_folds_0_1_2/PETCT_06a46414eb_03122006.nii.gz,/well/papiez/users/hri611/python/nnUnet_raw/Dataset219_PETCT/labelsTr/PETCT_06a46414eb_03122006.nii.gz,0.8630009319664492,0.5225228805541993,0.0
12,0.0,0,20,0.0,38719980,0,20,0,/well/papiez/users/hri611/python/nnUNet_results/Dataset219_PETCT/nnUNetTrainer_probabilisticOversampling_033__nnUNetPlans__3d_fullres/crossval_results_folds_0_1_2/PETCT_06d55e8295_04172003.nii.gz,/well/papiez/users/hri611/python/nnUnet_raw/Dataset219_PETCT/labelsTr/PETCT_06d55e8295_04172003.nii.gz,0.0,0.24882041931152343,0.0
13,0.6025600718616663,7182,1667,0.4311885324934113,45424443,6708,8375,13890,/well/papiez/users/hri611/python/nnUNet_results/Dataset219_PETCT/nnUNetTrainer_probabilisticOversampling_033__nnUNetPlans__3d_fullres/crossval_results_folds_0_1_2/PETCT_06e7c24059_04222005.nii.gz,/well/papiez/users/hri611/python/nnUnet_raw/Dataset219_PETCT/labelsTr/PETCT_06e7c24059_04222005.nii.gz,0.6025600718616663,9.2934426612854,27.930092067718505
14,0.0,0,3554,0.0,38876446,0,3554,0,/well/papiez/users/hri611/python/nnUNet_results/Dataset219_PETCT/nnUNetTrainer_probabilisticOversampling_033__nnUNetPlans__3d_fullres/crossval_results_folds_0_1_2/PETCT_072833774e_07232006.nii.gz,/well/papiez/users/hri611/python/nnUnet_raw/Dataset219_PETCT/labelsTr/PETCT_072833774e_07232006.nii.gz,0.0,44.215388511657714,0.0
15,0.8616190014541929,6191,8083,0.7568810464640959,45381288,44438,52521,50629,/well/papiez/users/hri611/python/nnUNet_results/Dataset219_PETCT/nnUNetTrainer_probabilisticOversampling_033__nnUNetPlans__3d_fullres/crossval_results_folds_0_1_2/PETCT_07574bfa00_04202003.nii.gz,/well/papiez/users/hri611/python/nnUnet_raw/Dataset219_PETCT/labelsTr/PETCT_07574bfa00_04202003.nii.gz,0.8616190014541929,64.02149388885498,0.3359075660705566
16,0.0,0,140,0.0,45439860,0,140,0,/well/papiez/users/hri611/python/nnUNet_results/Dataset219_PETCT/nnUNetTrainer_probabilisticOversampling_033__nnUNetPlans__3d_fullres/crossval_results_folds_0_1_2/PETCT_07b7e9abfc_02102003.nii.gz,/well/papiez/users/hri611/python/nnUnet_raw/Dataset219_PETCT/labelsTr/PETCT_07b7e9abfc_02102003.nii.gz,0.0,1.741742935180664,0.0
17,0.0,0,166,0.0,41439834,0,166,0,/well/papiez/users/hri611/python/nnUNet_results/Dataset219_PETCT/nnUNetTrainer_probabilisticOversampling_033__nnUNetPlans__3d_fullres/crossval_results_folds_0_1_2/PETCT_080922db5a_01282006.nii.gz,/well/papiez/users/hri611/python/nnUnet_raw/Dataset219_PETCT/labelsTr/PETCT_080922db5a_01282006.nii.gz,0.0,2.0652094802856444,0.0
18,,0,0,,49440000,0,0,0,/well/papiez/users/hri611/python/nnUNet_results/Dataset219_PETCT/nnUNetTrainer_probabilisticOversampling_033__nnUNetPlans__3d_fullres/crossval_results_folds_0_1_2/PETCT_08198c4f0c_11102005.nii.gz,/well/papiez/users/hri611/python/nnUnet_raw/Dataset219_PETCT/labelsTr/PETCT_08198c4f0c_11102005.nii.gz,,0.0,0.0
19,0.0,0,2048,0.0,52157952,0,2048,0,/well/papiez/users/hri611/python/nnUNet_results/Dataset219_PETCT/nnUNetTrainer_probabilisticOversampling_033__nnUNetPlans__3d_fullres/crossval_results_folds_0_1_2/PETCT_098c4b7b87_08312003.nii.gz,/well/papiez/users/hri611/python/nnUnet_raw/Dataset219_PETCT/labelsTr/PETCT_098c4b7b87_08312003.nii.gz,0.0,25.4792109375,0.0
20,0.632760298410639,1313,4348,0.4628012905674701,94869462,4877,9225,6190,/well/papiez/users/hri611/python/nnUNet_results/Dataset219_PETCT/nnUNetTrainer_probabilisticOversampling_033__nnUNetPlans__3d_fullres/crossval_results_folds_0_1_2/PETCT_09ee00bdc6_09302005.nii.gz,/well/papiez/users/hri611/python/nnUnet_raw/Dataset219_PETCT/labelsTr/PETCT_09ee00bdc6_09302005.nii.gz,0.632760298410639,29.323486415863037,0.0
21,0.8271658909147016,1558,5163,0.7052710050868268,52137196,16083,21246,17641,/well/papiez/users/hri611/python/nnUNet_results/Dataset219_PETCT/nnUNetTrainer_probabilisticOversampling_033__nnUNetPlans__3d_fullres/crossval_results_folds_0_1_2/PETCT_0b57b247b6_05022002.nii.gz,/well/papiez/users/hri611/python/nnUnet_raw/Dataset219_PETCT/labelsTr/PETCT_0b57b247b6_05022002.nii.gz,0.8271658909147016,8.571863445281982,0.0
22,0.8570718810440584,7288,767,0.749891324597901,52127794,24151,24918,31439,/well/papiez/users/hri611/python/nnUNet_results/Dataset219_PETCT/nnUNetTrainer_probabilisticOversampling_033__nnUNetPlans__3d_fullres/crossval_results_folds_0_1_2/PETCT_0b98dbe00d_08112002.nii.gz,/well/papiez/users/hri611/python/nnUnet_raw/Dataset219_PETCT/labelsTr/PETCT_0b98dbe00d_08112002.nii.gz,0.8570718810440584,0.0,8.783360801696777
23,0.0,0,33,0.0,52159967,0,33,0,/well/papiez/users/hri611/python/nnUNet_results/Dataset219_PETCT/nnUNetTrainer_probabilisticOversampling_033__nnUNetPlans__3d_fullres/crossval_results_folds_0_1_2/PETCT_0c13e4df10_10112003.nii.gz,/well/papiez/users/hri611/python/nnUnet_raw/Dataset219_PETCT/labelsTr/PETCT_0c13e4df10_10112003.nii.gz,0.0,0.4105536918640137,0.0
24,0.7951783023606228,3904,174,0.6599966649991662,45428006,7916,8090,11820,/well/papiez/users/hri611/python/nnUNet_results/Dataset219_PETCT/nnUNetTrainer_probabilisticOversampling_033__nnUNetPlans__3d_fullres/crossval_results_folds_0_1_2/PETCT_0e2034240b_01312003.nii.gz,/well/papiez/users/hri611/python/nnUnet_raw/Dataset219_PETCT/labelsTr/PETCT_0e2034240b_01312003.nii.gz,0.7951783023606228,0.37323062896728515,1.1072508659362792
25,,0,0,,46080000,0,0,0,/well/papiez/users/hri611/python/nnUNet_results/Dataset219_PETCT/nnUNetTrainer_probabilisticOversampling_033__nnUNetPlans__3d_fullres/crossval_results_folds_0_1_2/PETCT_0fa313309d_10032005.nii.gz,/well/papiez/users/hri611/python/nnUnet_raw/Dataset219_PETCT/labelsTr/PETCT_0fa313309d_10032005.nii.gz,,0.0,0.0
26,0.6246153846153846,19,225,0.4541387024608501,54079553,203,428,222,/well/papiez/users/hri611/python/nnUNet_results/Dataset219_PETCT/nnUNetTrainer_probabilisticOversampling_033__nnUNetPlans__3d_fullres/crossval_results_folds_0_1_2/PETCT_1019ae8551_04062007.nii.gz,/well/papiez/users/hri611/python/nnUnet_raw/Dataset219_PETCT/labelsTr/PETCT_1019ae8551_04062007.nii.gz,0.6246153846153846,2.1149735641479492,0.0
27,0.5692188708430008,219,338,0.3978378378378378,52159075,368,706,587,/well/papiez/users/hri611/python/nnUNet_results/Dataset219_PETCT/nnUNetTrainer_probabilisticOversampling_033__nnUNetPlans__3d_fullres/crossval_results_folds_0_1_2/PETCT_12025abab5_11012004.nii.gz,/well/papiez/users/hri611/python/nnUnet_raw/Dataset219_PETCT/labelsTr/PETCT_12025abab5_11012004.nii.gz,0.5692188708430008,4.205065086364746,0.0
28,0.8767986843908455,268,631,0.7806246949731577,104475902,3199,3830,3467,/well/papiez/users/hri611/python/nnUNet_results/Dataset219_PETCT/nnUNetTrainer_probabilisticOversampling_033__nnUNetPlans__3d_fullres/crossval_results_folds_0_1_2/PETCT_1253499c80_10072005.nii.gz,/well/papiez/users/hri611/python/nnUnet_raw/Dataset219_PETCT/labelsTr/PETCT_1253499c80_10072005.nii.gz,0.8767986843908455,6.456889881134033,0.0
29,0.7488605929615186,59614,9871,0.5985428871864203,47826918,103597,113468,163211,/well/papiez/users/hri611/python/nnUNet_results/Dataset219_PETCT/nnUNetTrainer_probabilisticOversampling_033__nnUNetPlans__3d_fullres/crossval_results_folds_0_1_2/PETCT_1285b86bea_02242006.nii.gz,/well/papiez/users/hri611/python/nnUnet_raw/Dataset219_PETCT/labelsTr/PETCT_1285b86bea_02242006.nii.gz,0.7488605929615186,0.1368512306213379,150.27509224319456
30,,0,0,,105760000,0,0,0,/well/papiez/users/hri611/python/nnUNet_results/Dataset219_PETCT/nnUNetTrainer_probabilisticOversampling_033__nnUNetPlans__3d_fullres/crossval_results_folds_0_1_2/PETCT_141fffa2a9_03012003.nii.gz,/well/papiez/users/hri611/python/nnUnet_raw/Dataset219_PETCT/labelsTr/PETCT_141fffa2a9_03012003.nii.gz,,0.0,0.0
31,0.7890363798867887,11536,1210,0.6515772784429501,52123418,23836,25046,35372,/well/papiez/users/hri611/python/nnUNet_results/Dataset219_PETCT/nnUNetTrainer_probabilisticOversampling_033__nnUNetPlans__3d_fullres/crossval_results_folds_0_1_2/PETCT_1472967bef_12212002.nii.gz,/well/papiez/users/hri611/python/nnUnet_raw/Dataset219_PETCT/labelsTr/PETCT_1472967bef_12212002.nii.gz,0.7890363798867887,0.16173327255249023,0.0
32,0.885704315458881,4382,531,0.7948557351037622,52136051,19036,19567,23418,/well/papiez/users/hri611/python/nnUNet_results/Dataset219_PETCT/nnUNetTrainer_probabilisticOversampling_033__nnUNetPlans__3d_fullres/crossval_results_folds_0_1_2/PETCT_147a9fcff3_08162001.nii.gz,/well/papiez/users/hri611/python/nnUnet_raw/Dataset219_PETCT/labelsTr/PETCT_147a9fcff3_08162001.nii.gz,0.885704315458881,0.06220510482788086,3.9935677299499512
33,0.0,0,8353,0.0,45431647,0,8353,0,/well/papiez/users/hri611/python/nnUNet_results/Dataset219_PETCT/nnUNetTrainer_probabilisticOversampling_033__nnUNetPlans__3d_fullres/crossval_results_folds_0_1_2/PETCT_14929994cf_04302005.nii.gz,/well/papiez/users/hri611/python/nnUnet_raw/Dataset219_PETCT/labelsTr/PETCT_14929994cf_04302005.nii.gz,0.0,103.91984812545776,0.0
34,0.7732453509298141,753,3,0.630317848410758,52157955,1289,1292,2042,/well/papiez/users/hri611/python/nnUNet_results/Dataset219_PETCT/nnUNetTrainer_probabilisticOversampling_033__nnUNetPlans__3d_fullres/crossval_results_folds_0_1_2/PETCT_14c4d2c208_09222002.nii.gz,/well/papiez/users/hri611/python/nnUnet_raw/Dataset219_PETCT/labelsTr/PETCT_14c4d2c208_09222002.nii.gz,0.7732453509298141,0.0,1.157014949798584
35,0.8260518615679548,3122,326,0.7036527718091964,52148365,8187,8513,11309,/well/papiez/users/hri611/python/nnUNet_results/Dataset219_PETCT/nnUNetTrainer_probabilisticOversampling_033__nnUNetPlans__3d_fullres/crossval_results_folds_0_1_2/PETCT_154e94256c_11252000.nii.gz,/well/papiez/users/hri611/python/nnUnet_raw/Dataset219_PETCT/labelsTr/PETCT_154e94256c_11252000.nii.gz,0.8260518615679548,2.898757884979248,0.0
36,0.8936284167639014,7995,3127,0.8077109266943292,45382160,46718,49845,54713,/well/papiez/users/hri611/python/nnUNet_results/Dataset219_PETCT/nnUNetTrainer_probabilisticOversampling_033__nnUNetPlans__3d_fullres/crossval_results_folds_0_1_2/PETCT_15cfa01130_02242001.nii.gz,/well/papiez/users/hri611/python/nnUnet_raw/Dataset219_PETCT/labelsTr/PETCT_15cfa01130_02242001.nii.gz,0.8936284167639014,0.0,0.0
37,0.9209824449663628,1710,275,0.8535379620748174,45426447,11568,11843,13278,/well/papiez/users/hri611/python/nnUNet_results/Dataset219_PETCT/nnUNetTrainer_probabilisticOversampling_033__nnUNetPlans__3d_fullres/crossval_results_folds_0_1_2/PETCT_15f4b7254f_07182003.nii.gz,/well/papiez/users/hri611/python/nnUnet_raw/Dataset219_PETCT/labelsTr/PETCT_15f4b7254f_07182003.nii.gz,0.9209824449663628,2.4011170463562013,2.4882041931152346
38,0.8067226890756303,1,22,0.676056338028169,45439929,48,70,49,/well/papiez/users/hri611/python/nnUNet_results/Dataset219_PETCT/nnUNetTrainer_probabilisticOversampling_033__nnUNetPlans__3d_fullres/crossval_results_folds_0_1_2/PETCT_15f4b7254f_10112003.nii.gz,/well/papiez/users/hri611/python/nnUnet_raw/Dataset219_PETCT/labelsTr/PETCT_15f4b7254f_10112003.nii.gz,0.8067226890756303,0.2239383773803711,0.0
39,0.0,0,464,0.0,92319536,0,464,0,/well/papiez/users/hri611/python/nnUNet_results/Dataset219_PETCT/nnUNetTrainer_probabilisticOversampling_033__nnUNetPlans__3d_fullres/crossval_results_folds_0_1_2/PETCT_173b804eda_10112004.nii.gz,/well/papiez/users/hri611/python/nnUnet_raw/Dataset219_PETCT/labelsTr/PETCT_173b804eda_10112004.nii.gz,0.0,5.772633728027344,0.0
40,0.0,0,11,0.0,43839989,0,11,0,/well/papiez/users/hri611/python/nnUNet_results/Dataset219_PETCT/nnUNetTrainer_probabilisticOversampling_033__nnUNetPlans__3d_fullres/crossval_results_folds_0_1_2/PETCT_176bdc5388_06222006.nii.gz,/well/papiez/users/hri611/python/nnUnet_raw/Dataset219_PETCT/labelsTr/PETCT_176bdc5388_06222006.nii.gz,0.0,0.1368512306213379,0.0
41,0.0,0,584,0.0,49119416,0,584,0,/well/papiez/users/hri611/python/nnUNet_results/Dataset219_PETCT/nnUNetTrainer_probabilisticOversampling_033__nnUNetPlans__3d_fullres/crossval_results_folds_0_1_2/PETCT_1774857f8e_11232006.nii.gz,/well/papiez/users/hri611/python/nnUnet_raw/Dataset219_PETCT/labelsTr/PETCT_1774857f8e_11232006.nii.gz,0.0,7.2655562438964845,0.0
42,0.0,0,671,0.0,45439329,0,671,0,/well/papiez/users/hri611/python/nnUNet_results/Dataset219_PETCT/nnUNetTrainer_probabilisticOversampling_033__nnUNetPlans__3d_fullres/crossval_results_folds_0_1_2/PETCT_1781ba966c_08082002.nii.gz,/well/papiez/users/hri611/python/nnUnet_raw/Dataset219_PETCT/labelsTr/PETCT_1781ba966c_08082002.nii.gz,0.0,8.347925067901611,0.0
43,0.0,0,27,0.0,38719973,0,27,0,/well/papiez/users/hri611/python/nnUNet_results/Dataset219_PETCT/nnUNetTrainer_probabilisticOversampling_033__nnUNetPlans__3d_fullres/crossval_results_folds_0_1_2/PETCT_17b46d7275_11132003.nii.gz,/well/papiez/users/hri611/python/nnUnet_raw/Dataset219_PETCT/labelsTr/PETCT_17b46d7275_11132003.nii.gz,0.0,0.3359075660705566,0.0
44,0.0,0,1128,0.0,49438872,0,1128,0,/well/papiez/users/hri611/python/nnUNet_results/Dataset219_PETCT/nnUNetTrainer_probabilisticOversampling_033__nnUNetPlans__3d_fullres/crossval_results_folds_0_1_2/PETCT_182bdeba22_05102007.nii.gz,/well/papiez/users/hri611/python/nnUnet_raw/Dataset219_PETCT/labelsTr/PETCT_182bdeba22_05102007.nii.gz,0.0,14.033471649169922,0.0
45,0.5171232876712328,0,846,0.34872979214780603,52318701,453,1299,453,/well/papiez/users/hri611/python/nnUNet_results/Dataset219_PETCT/nnUNetTrainer_probabilisticOversampling_033__nnUNetPlans__3d_fullres/crossval_results_folds_0_1_2/PETCT_18e8b02af3_08142005.nii.gz,/well/papiez/users/hri611/python/nnUnet_raw/Dataset219_PETCT/labelsTr/PETCT_18e8b02af3_08142005.nii.gz,0.5171232876712328,10.077226982116699,0.0
46,0.0,0,278,0.0,99039722,0,278,0,/well/papiez/users/hri611/python/nnUNet_results/Dataset219_PETCT/nnUNetTrainer_probabilisticOversampling_033__nnUNetPlans__3d_fullres/crossval_results_folds_0_1_2/PETCT_1928952a0f_06202003.nii.gz,/well/papiez/users/hri611/python/nnUnet_raw/Dataset219_PETCT/labelsTr/PETCT_1928952a0f_06202003.nii.gz,0.0,3.4586038284301757,0.0
47,0.0,0,247,0.0,38719753,0,247,0,/well/papiez/users/hri611/python/nnUNet_results/Dataset219_PETCT/nnUNetTrainer_probabilisticOversampling_033__nnUNetPlans__3d_fullres/crossval_results_folds_0_1_2/PETCT_193dea6ac7_04102003.nii.gz,/well/papiez/users/hri611/python/nnUnet_raw/Dataset219_PETCT/labelsTr/PETCT_193dea6ac7_04102003.nii.gz,0.0,3.0729321784973145,0.0
48,0.6601511169513797,1402,2736,0.4927056515875935,52151843,4019,6755,5421,/well/papiez/users/hri611/python/nnUNet_results/Dataset219_PETCT/nnUNetTrainer_probabilisticOversampling_033__nnUNetPlans__3d_fullres/crossval_results_folds_0_1_2/PETCT_1a1712f7d0_07052001.nii.gz,/well/papiez/users/hri611/python/nnUnet_raw/Dataset219_PETCT/labelsTr/PETCT_1a1712f7d0_07052001.nii.gz,0.6601511169513797,31.139875476837158,4.628059799194336
49,0.0,0,302,0.0,45119698,0,302,0,/well/papiez/users/hri611/python/nnUNet_results/Dataset219_PETCT/nnUNetTrainer_probabilisticOversampling_033__nnUNetPlans__3d_fullres/crossval_results_folds_0_1_2/PETCT_1a8bd52f71_05052006.nii.gz,/well/papiez/users/hri611/python/nnUnet_raw/Dataset219_PETCT/labelsTr/PETCT_1a8bd52f71_05052006.nii.gz,0.0,3.757188331604004,0.0
50,0.47926634768740034,159,1147,0.31515469323544837,58878093,601,1748,760,/well/papiez/users/hri611/python/nnUNet_results/Dataset219_PETCT/nnUNetTrainer_probabilisticOversampling_033__nnUNetPlans__3d_fullres/crossval_results_folds_0_1_2/PETCT_1a90052cb2_06222001.nii.gz,/well/papiez/users/hri611/python/nnUnet_raw/Dataset219_PETCT/labelsTr/PETCT_1a90052cb2_06222001.nii.gz,0.47926634768740034,13.90906143951416,0.0
51,0.0,0,1600,0.0,45438400,0,1600,0,/well/papiez/users/hri611/python/nnUNet_results/Dataset219_PETCT/nnUNetTrainer_probabilisticOversampling_033__nnUNetPlans__3d_fullres/crossval_results_folds_0_1_2/PETCT_1ac497ed9d_10282004.nii.gz,/well/papiez/users/hri611/python/nnUnet_raw/Dataset219_PETCT/labelsTr/PETCT_1ac497ed9d_10282004.nii.gz,0.0,19.905633544921876,0.0
52,0.841019072018218,1008,3460,0.7256539358958615,52143714,11818,15278,12826,/well/papiez/users/hri611/python/nnUNet_results/Dataset219_PETCT/nnUNetTrainer_probabilisticOversampling_033__nnUNetPlans__3d_fullres/crossval_results_folds_0_1_2/PETCT_1b1bdfc35b_10292000.nii.gz,/well/papiez/users/hri611/python/nnUnet_raw/Dataset219_PETCT/labelsTr/PETCT_1b1bdfc35b_10292000.nii.gz,0.841019072018218,10.226519233703613,2.8738758430480957
53,0.7538022988505747,13103,284,0.6048817921548951,52126119,20494,20778,33597,/well/papiez/users/hri611/python/nnUNet_results/Dataset219_PETCT/nnUNetTrainer_probabilisticOversampling_033__nnUNetPlans__3d_fullres/crossval_results_folds_0_1_2/PETCT_1bb48bfb40_12022000.nii.gz,/well/papiez/users/hri611/python/nnUnet_raw/Dataset219_PETCT/labelsTr/PETCT_1bb48bfb40_12022000.nii.gz,0.7538022988505747,0.0,15.041194347381591
54,,0,0,,47520000,0,0,0,/well/papiez/users/hri611/python/nnUNet_results/Dataset219_PETCT/nnUNetTrainer_probabilisticOversampling_033__nnUNetPlans__3d_fullres/crossval_results_folds_0_1_2/PETCT_1f2a4f4280_06122005.nii.gz,/well/papiez/users/hri611/python/nnUnet_raw/Dataset219_PETCT/labelsTr/PETCT_1f2a4f4280_06122005.nii.gz,,0.0,0.0
55,0.29508196721311475,3,169,0.17307692307692307,105759792,36,205,39,/well/papiez/users/hri611/python/nnUNet_results/Dataset219_PETCT/nnUNetTrainer_probabilisticOversampling_033__nnUNetPlans__3d_fullres/crossval_results_folds_0_1_2/PETCT_1f65acff65_05062007.nii.gz,/well/papiez/users/hri611/python/nnUnet_raw/Dataset219_PETCT/labelsTr/PETCT_1f65acff65_05062007.nii.gz,0.29508196721311475,2.090091522216797,0.0
56,0.8142732431252728,0,1702,0.6867292471930794,52154567,3731,5433,3731,/well/papiez/users/hri611/python/nnUNet_results/Dataset219_PETCT/nnUNetTrainer_probabilisticOversampling_033__nnUNetPlans__3d_fullres/crossval_results_folds_0_1_2/PETCT_1fc35d02da_08092003.nii.gz,/well/papiez/users/hri611/python/nnUnet_raw/Dataset219_PETCT/labelsTr/PETCT_1fc35d02da_08092003.nii.gz,0.8142732431252728,0.4478767547607422,0.0
57,0.8030913012221423,565,10391,0.6709712295032735,52126702,22342,32733,22907,/well/papiez/users/hri611/python/nnUNet_results/Dataset219_PETCT/nnUNetTrainer_probabilisticOversampling_033__nnUNetPlans__3d_fullres/crossval_results_folds_0_1_2/PETCT_1fe6e48293_06262003.nii.gz,/well/papiez/users/hri611/python/nnUnet_raw/Dataset219_PETCT/labelsTr/PETCT_1fe6e48293_06262003.nii.gz,0.8030913012221423,8.18619179534912,0.1368512306213379
58,0.7312676056338028,1,476,0.5763765541740675,55198874,649,1125,650,/well/papiez/users/hri611/python/nnUNet_results/Dataset219_PETCT/nnUNetTrainer_probabilisticOversampling_033__nnUNetPlans__3d_fullres/crossval_results_folds_0_1_2/PETCT_20995a0fe1_12022005.nii.gz,/well/papiez/users/hri611/python/nnUnet_raw/Dataset219_PETCT/labelsTr/PETCT_20995a0fe1_12022005.nii.gz,0.7312676056338028,4.851998176574707,0.0
59,0.0,0,2598,0.0,45437402,0,2598,0,/well/papiez/users/hri611/python/nnUNet_results/Dataset219_PETCT/nnUNetTrainer_probabilisticOversampling_033__nnUNetPlans__3d_fullres/crossval_results_folds_0_1_2/PETCT_20f4a3aa02_03172005.nii.gz,/well/papiez/users/hri611/python/nnUnet_raw/Dataset219_PETCT/labelsTr/PETCT_20f4a3aa02_03172005.nii.gz,0.0,32.32177246856689,0.0
60,0.0,0,1224,0.0,43518776,0,1224,0,/well/papiez/users/hri611/python/nnUNet_results/Dataset219_PETCT/nnUNetTrainer_probabilisticOversampling_033__nnUNetPlans__3d_fullres/crossval_results_folds_0_1_2/PETCT_2122b88719_09092006.nii.gz,/well/papiez/users/hri611/python/nnUnet_raw/Dataset219_PETCT/labelsTr/PETCT_2122b88719_09092006.nii.gz,0.0,15.227809661865233,0.0
61,0.4148079215982784,59648,721,0.26167675655842965,54638235,21396,22117,81044,/well/papiez/users/hri611/python/nnUNet_results/Dataset219_PETCT/nnUNetTrainer_probabilisticOversampling_033__nnUNetPlans__3d_fullres/crossval_results_folds_0_1_2/PETCT_2140db0ca5_04132007.nii.gz,/well/papiez/users/hri611/python/nnUnet_raw/Dataset219_PETCT/labelsTr/PETCT_2140db0ca5_04132007.nii.gz,0.4148079215982784,0.37323062896728515,35.855022422790526
62,0.8689108910891089,591,71,0.7682072829131653,52157144,2194,2265,2785,/well/papiez/users/hri611/python/nnUNet_results/Dataset219_PETCT/nnUNetTrainer_probabilisticOversampling_033__nnUNetPlans__3d_fullres/crossval_results_folds_0_1_2/PETCT_21853fc15b_10122002.nii.gz,/well/papiez/users/hri611/python/nnUnet_raw/Dataset219_PETCT/labelsTr/PETCT_21853fc15b_10122002.nii.gz,0.8689108910891089,0.0,0.012441020965576172
63,0.7906631586048708,1131,1972,0.6537989512440031,45431037,5860,7832,6991,/well/papiez/users/hri611/python/nnUNet_results/Dataset219_PETCT/nnUNetTrainer_probabilisticOversampling_033__nnUNetPlans__3d_fullres/crossval_results_folds_0_1_2/PETCT_2202a936e0_05312002.nii.gz,/well/papiez/users/hri611/python/nnUnet_raw/Dataset219_PETCT/labelsTr/PETCT_2202a936e0_05312002.nii.gz,0.7906631586048708,1.9159172286987305,9.156591430664061
64,0.0,0,320,0.0,51839680,0,320,0,/well/papiez/users/hri611/python/nnUNet_results/Dataset219_PETCT/nnUNetTrainer_probabilisticOversampling_033__nnUNetPlans__3d_fullres/crossval_results_folds_0_1_2/PETCT_234f8427c0_12032005.nii.gz,/well/papiez/users/hri611/python/nnUnet_raw/Dataset219_PETCT/labelsTr/PETCT_234f8427c0_12032005.nii.gz,0.0,3.981126708984375,0.0
65,0.0,0,379,0.0,45439621,0,379,0,/well/papiez/users/hri611/python/nnUNet_results/Dataset219_PETCT/nnUNetTrainer_probabilisticOversampling_033__nnUNetPlans__3d_fullres/crossval_results_folds_0_1_2/PETCT_234f8427c0_12092004.nii.gz,/well/papiez/users/hri611/python/nnUnet_raw/Dataset219_PETCT/labelsTr/PETCT_234f8427c0_12092004.nii.gz,0.0,4.715146945953369,0.0
66,0.03977485928705441,33,2526,0.020290964777947933,92317388,53,2579,86,/well/papiez/users/hri611/python/nnUNet_results/Dataset219_PETCT/nnUNetTrainer_probabilisticOversampling_033__nnUNetPlans__3d_fullres/crossval_results_folds_0_1_2/PETCT_23ed525e82_08012003.nii.gz,/well/papiez/users/hri611/python/nnUnet_raw/Dataset219_PETCT/labelsTr/PETCT_23ed525e82_08012003.nii.gz,0.03977485928705441,31.276726707458497,0.0
67,,0,0,,99520000,0,0,0,/well/papiez/users/hri611/python/nnUNet_results/Dataset219_PETCT/nnUNetTrainer_probabilisticOversampling_033__nnUNetPlans__3d_fullres/crossval_results_folds_0_1_2/PETCT_2428b44e92_03222007.nii.gz,/well/papiez/users/hri611/python/nnUnet_raw/Dataset219_PETCT/labelsTr/PETCT_2428b44e92_03222007.nii.gz,,0.0,0.0
68,0.6078285851089299,22466,10296,0.4366047015528538,52101849,25389,35685,47855,/well/papiez/users/hri611/python/nnUNet_results/Dataset219_PETCT/nnUNetTrainer_probabilisticOversampling_033__nnUNetPlans__3d_fullres/crossval_results_folds_0_1_2/PETCT_249c02c01c_03062003.nii.gz,/well/papiez/users/hri611/python/nnUnet_raw/Dataset219_PETCT/labelsTr/PETCT_249c02c01c_03062003.nii.gz,0.6078285851089299,2.4882041931152346,2.6374964447021485
69,0.0,0,18,0.0,45439982,0,18,0,/well/papiez/users/hri611/python/nnUNet_results/Dataset219_PETCT/nnUNetTrainer_probabilisticOversampling_033__nnUNetPlans__3d_fullres/crossval_results_folds_0_1_2/PETCT_249c02c01c_07262003.nii.gz,/well/papiez/users/hri611/python/nnUnet_raw/Dataset219_PETCT/labelsTr/PETCT_249c02c01c_07262003.nii.gz,0.0,0.2239383773803711,0.0
70,0.0,0,88,0.0,72159912,0,88,0,/well/papiez/users/hri611/python/nnUNet_results/Dataset219_PETCT/nnUNetTrainer_probabilisticOversampling_033__nnUNetPlans__3d_fullres/crossval_results_folds_0_1_2/PETCT_24cb79a92b_04132003.nii.gz,/well/papiez/users/hri611/python/nnUnet_raw/Dataset219_PETCT/labelsTr/PETCT_24cb79a92b_04132003.nii.gz,0.0,1.094809844970703,0.0
71,0.0,0,182,0.0,47839818,0,182,0,/well/papiez/users/hri611/python/nnUNet_results/Dataset219_PETCT/nnUNetTrainer_probabilisticOversampling_033__nnUNetPlans__3d_fullres/crossval_results_folds_0_1_2/PETCT_265c26907a_11102005.nii.gz,/well/papiez/users/hri611/python/nnUnet_raw/Dataset219_PETCT/labelsTr/PETCT_265c26907a_11102005.nii.gz,0.0,2.264265815734863,0.0
72,0.0,0,295,0.0,58879705,0,295,0,/well/papiez/users/hri611/python/nnUNet_results/Dataset219_PETCT/nnUNetTrainer_probabilisticOversampling_033__nnUNetPlans__3d_fullres/crossval_results_folds_0_1_2/PETCT_2716c9bfff_10042003.nii.gz,/well/papiez/users/hri611/python/nnUnet_raw/Dataset219_PETCT/labelsTr/PETCT_2716c9bfff_10042003.nii.gz,0.0,3.6701011848449707,0.0
73,0.0,0,198,0.0,54559802,0,198,0,/well/papiez/users/hri611/python/nnUNet_results/Dataset219_PETCT/nnUNetTrainer_probabilisticOversampling_033__nnUNetPlans__3d_fullres/crossval_results_folds_0_1_2/PETCT_274688d0a8_03242007.nii.gz,/well/papiez/users/hri611/python/nnUnet_raw/Dataset219_PETCT/labelsTr/PETCT_274688d0a8_03242007.nii.gz,0.0,2.463322151184082,0.0
74,0.44882178448821786,15784,753,0.28934250107434467,52136730,6733,7486,22517,/well/papiez/users/hri611/python/nnUNet_results/Dataset219_PETCT/nnUNetTrainer_probabilisticOversampling_033__nnUNetPlans__3d_fullres/crossval_results_folds_0_1_2/PETCT_27d69a8466_12162001.nii.gz,/well/papiez/users/hri611/python/nnUnet_raw/Dataset219_PETCT/labelsTr/PETCT_27d69a8466_12162001.nii.gz,0.44882178448821786,0.16173327255249023,60.363833724975585
75,0.0,0,67,0.0,52159933,0,67,0,/well/papiez/users/hri611/python/nnUNet_results/Dataset219_PETCT/nnUNetTrainer_probabilisticOversampling_033__nnUNetPlans__3d_fullres/crossval_results_folds_0_1_2/PETCT_28a0a0a163_10222004.nii.gz,/well/papiez/users/hri611/python/nnUnet_raw/Dataset219_PETCT/labelsTr/PETCT_28a0a0a163_10222004.nii.gz,0.0,0.8335484046936035,0.0
76,0.7385549599127094,24,5487,0.5854832643851072,52146705,7784,13271,7808,/well/papiez/users/hri611/python/nnUNet_results/Dataset219_PETCT/nnUNetTrainer_probabilisticOversampling_033__nnUNetPlans__3d_fullres/crossval_results_folds_0_1_2/PETCT_29ab45ef17_06272002.nii.gz,/well/papiez/users/hri611/python/nnUnet_raw/Dataset219_PETCT/labelsTr/PETCT_29ab45ef17_06272002.nii.gz,0.7385549599127094,4.317034275054931,0.09952816772460937
77,0.8441814595660749,871,77,0.7303754266211604,45436484,2568,2645,3439,/well/papiez/users/hri611/python/nnUNet_results/Dataset219_PETCT/nnUNetTrainer_probabilisticOversampling_033__nnUNetPlans__3d_fullres/crossval_results_folds_0_1_2/PETCT_2a78eed085_12222001.nii.gz,/well/papiez/users/hri611/python/nnUnet_raw/Dataset219_PETCT/labelsTr/PETCT_2a78eed085_12222001.nii.gz,0.8441814595660749,0.24882041931152343,0.0
78,0.0,0,546,0.0,31999454,0,546,0,/well/papiez/users/hri611/python/nnUNet_results/Dataset219_PETCT/nnUNetTrainer_probabilisticOversampling_033__nnUNetPlans__3d_fullres/crossval_results_folds_0_1_2/PETCT_2ad62beb52_03082003.nii.gz,/well/papiez/users/hri611/python/nnUnet_raw/Dataset219_PETCT/labelsTr/PETCT_2ad62beb52_03082003.nii.gz,0.0,6.79279744720459,0.0
79,0.8390554041780199,9,1763,0.7227350962290722,51033609,4619,6382,4628,/well/papiez/users/hri611/python/nnUNet_results/Dataset219_PETCT/nnUNetTrainer_probabilisticOversampling_033__nnUNetPlans__3d_fullres/crossval_results_folds_0_1_2/PETCT_2b29531d8c_10162005.nii.gz,/well/papiez/users/hri611/python/nnUnet_raw/Dataset219_PETCT/labelsTr/PETCT_2b29531d8c_10162005.nii.gz,0.8390554041780199,5.9592490425109865,0.0
80,0.0,0,417,0.0,47839583,0,417,0,/well/papiez/users/hri611/python/nnUNet_results/Dataset219_PETCT/nnUNetTrainer_probabilisticOversampling_033__nnUNetPlans__3d_fullres/crossval_results_folds_0_1_2/PETCT_2b8064fbe2_06112006.nii.gz,/well/papiez/users/hri611/python/nnUnet_raw/Dataset219_PETCT/labelsTr/PETCT_2b8064fbe2_06112006.nii.gz,0.0,5.187905742645263,0.0
81,0.7517241379310344,0,72,0.6022099447513812,43839819,109,181,109,/well/papiez/users/hri611/python/nnUNet_results/Dataset219_PETCT/nnUNetTrainer_probabilisticOversampling_033__nnUNetPlans__3d_fullres/crossval_results_folds_0_1_2/PETCT_2ce074c2ea_02042006.nii.gz,/well/papiez/users/hri611/python/nnUnet_raw/Dataset219_PETCT/labelsTr/PETCT_2ce074c2ea_02042006.nii.gz,0.7517241379310344,0.58472798538208,0.0
82,0.6991404011461319,104,1,0.5374449339207048,94079773,122,123,226,/well/papiez/users/hri611/python/nnUNet_results/Dataset219_PETCT/nnUNetTrainer_probabilisticOversampling_033__nnUNetPlans__3d_fullres/crossval_results_folds_0_1_2/PETCT_2d70838805_04302007.nii.gz,/well/papiez/users/hri611/python/nnUnet_raw/Dataset219_PETCT/labelsTr/PETCT_2d70838805_04302007.nii.gz,0.6991404011461319,0.0,0.0
83,0.2765089722675367,988,6108,0.16043539990534786,45431548,1356,7464,2344,/well/papiez/users/hri611/python/nnUNet_results/Dataset219_PETCT/nnUNetTrainer_probabilisticOversampling_033__nnUNetPlans__3d_fullres/crossval_results_folds_0_1_2/PETCT_2dac5ef654_11042000.nii.gz,/well/papiez/users/hri611/python/nnUnet_raw/Dataset219_PETCT/labelsTr/PETCT_2dac5ef654_11042000.nii.gz,0.2765089722675367,75.81558176422119,0.0
84,0.823494705462224,1392,21344,0.6999498508723309,46644226,53038,74382,54430,/well/papiez/users/hri611/python/nnUNet_results/Dataset219_PETCT/nnUNetTrainer_probabilisticOversampling_033__nnUNetPlans__3d_fullres/crossval_results_folds_0_1_2/PETCT_2f7200f771_11052005.nii.gz,/well/papiez/users/hri611/python/nnUnet_raw/Dataset219_PETCT/labelsTr/PETCT_2f7200f771_11052005.nii.gz,0.823494705462224,0.5225228805541993,0.8086663627624512
85,0.7270996403638671,2423,157,0.571214891141765,52153983,3437,3594,5860,/well/papiez/users/hri611/python/nnUNet_results/Dataset219_PETCT/nnUNetTrainer_probabilisticOversampling_033__nnUNetPlans__3d_fullres/crossval_results_folds_0_1_2/PETCT_3049d4f1a4_02242002.nii.gz,/well/papiez/users/hri611/python/nnUnet_raw/Dataset219_PETCT/labelsTr/PETCT_3049d4f1a4_02242002.nii.gz,0.7270996403638671,0.19905633544921875,3.2844295349121095
86,0.8756494995751465,14774,1763,0.7788047403761269,45365238,58225,59988,72999,/well/papiez/users/hri611/python/nnUNet_results/Dataset219_PETCT/nnUNetTrainer_probabilisticOversampling_033__nnUNetPlans__3d_fullres/crossval_results_folds_0_1_2/PETCT_30c4b7062b_01182001.nii.gz,/well/papiez/users/hri611/python/nnUnet_raw/Dataset219_PETCT/labelsTr/PETCT_30c4b7062b_01182001.nii.gz,0.8756494995751465,8.198632816314698,9.467616954803466
87,0.0,0,244,0.0,99039756,0,244,0,/well/papiez/users/hri611/python/nnUNet_results/Dataset219_PETCT/nnUNetTrainer_probabilisticOversampling_033__nnUNetPlans__3d_fullres/crossval_results_folds_0_1_2/PETCT_30e2b83b74_04262003.nii.gz,/well/papiez/users/hri611/python/nnUnet_raw/Dataset219_PETCT/labelsTr/PETCT_30e2b83b74_04262003.nii.gz,0.0,3.035609115600586,0.0
88,0.0,0,179,0.0,92319821,0,179,0,/well/papiez/users/hri611/python/nnUNet_results/Dataset219_PETCT/nnUNetTrainer_probabilisticOversampling_033__nnUNetPlans__3d_fullres/crossval_results_folds_0_1_2/PETCT_30e2b83b74_07212003.nii.gz,/well/papiez/users/hri611/python/nnUnet_raw/Dataset219_PETCT/labelsTr/PETCT_30e2b83b74_07212003.nii.gz,0.0,2.2269427528381347,0.0
89,0.9331986726302121,718,208,0.8747633216121179,52152606,6468,6676,7186,/well/papiez/users/hri611/python/nnUNet_results/Dataset219_PETCT/nnUNetTrainer_probabilisticOversampling_033__nnUNetPlans__3d_fullres/crossval_results_folds_0_1_2/PETCT_31ddf5013a_02222001.nii.gz,/well/papiez/users/hri611/python/nnUnet_raw/Dataset219_PETCT/labelsTr/PETCT_31ddf5013a_02222001.nii.gz,0.9331986726302121,0.6593741111755371,0.0
90,0.6600623893432257,4015,4049,0.4926068080286919,45424107,7829,11878,11844,/well/papiez/users/hri611/python/nnUNet_results/Dataset219_PETCT/nnUNetTrainer_probabilisticOversampling_033__nnUNetPlans__3d_fullres/crossval_results_folds_0_1_2/PETCT_321bba14bc_03072002.nii.gz,/well/papiez/users/hri611/python/nnUnet_raw/Dataset219_PETCT/labelsTr/PETCT_321bba14bc_03072002.nii.gz,0.6600623893432257,4.553413673400879,4.764911029815674
91,0.0,0,41,0.0,45439959,0,41,0,/well/papiez/users/hri611/python/nnUNet_results/Dataset219_PETCT/nnUNetTrainer_probabilisticOversampling_033__nnUNetPlans__3d_fullres/crossval_results_folds_0_1_2/PETCT_32219760da_03132003.nii.gz,/well/papiez/users/hri611/python/nnUnet_raw/Dataset219_PETCT/labelsTr/PETCT_32219760da_03132003.nii.gz,0.0,0.5100818595886231,0.0
92,0.5516304347826086,26,304,0.3808630393996248,99839467,203,507,229,/well/papiez/users/hri611/python/nnUNet_results/Dataset219_PETCT/nnUNetTrainer_probabilisticOversampling_033__nnUNetPlans__3d_fullres/crossval_results_folds_0_1_2/PETCT_32aa845af1_01262007.nii.gz,/well/papiez/users/hri611/python/nnUnet_raw/Dataset219_PETCT/labelsTr/PETCT_32aa845af1_01262007.nii.gz,0.5516304347826086,3.321752597808838,0.0
93,0.8721276736639958,543,1388,0.7732503522780648,50871484,6585,7973,7128,/well/papiez/users/hri611/python/nnUNet_results/Dataset219_PETCT/nnUNetTrainer_probabilisticOversampling_033__nnUNetPlans__3d_fullres/crossval_results_folds_0_1_2/PETCT_32aa845af1_06152007.nii.gz,/well/papiez/users/hri611/python/nnUnet_raw/Dataset219_PETCT/labelsTr/PETCT_32aa845af1_06152007.nii.gz,0.8721276736639958,7.5516997261047365,1.7915070190429687
94,0.8359284715041664,9387,1403,0.7181074796875409,45401723,27487,28890,36874,/well/papiez/users/hri611/python/nnUNet_results/Dataset219_PETCT/nnUNetTrainer_probabilisticOversampling_033__nnUNetPlans__3d_fullres/crossval_results_folds_0_1_2/PETCT_335a00191d_02162001.nii.gz,/well/papiez/users/hri611/python/nnUnet_raw/Dataset219_PETCT/labelsTr/PETCT_335a00191d_02162001.nii.gz,0.8359284715041664,1.082368824005127,0.6096100273132324
95,0.0,0,540,0.0,49919460,0,540,0,/well/papiez/users/hri611/python/nnUNet_results/Dataset219_PETCT/nnUNetTrainer_probabilisticOversampling_033__nnUNetPlans__3d_fullres/crossval_results_folds_0_1_2/PETCT_345b11778a_10142005.nii.gz,/well/papiez/users/hri611/python/nnUnet_raw/Dataset219_PETCT/labelsTr/PETCT_345b11778a_10142005.nii.gz,0.0,6.718151321411133,0.0
96,,0,0,,54240000,0,0,0,/well/papiez/users/hri611/python/nnUNet_results/Dataset219_PETCT/nnUNetTrainer_probabilisticOversampling_033__nnUNetPlans__3d_fullres/crossval_results_folds_0_1_2/PETCT_3481507253_06172007.nii.gz,/well/papiez/users/hri611/python/nnUnet_raw/Dataset219_PETCT/labelsTr/PETCT_3481507253_06172007.nii.gz,,0.0,0.0
97,0.0,0,26,0.0,52159974,0,26,0,/well/papiez/users/hri611/python/nnUNet_results/Dataset219_PETCT/nnUNetTrainer_probabilisticOversampling_033__nnUNetPlans__3d_fullres/crossval_results_folds_0_1_2/PETCT_34d3efa936_10222004.nii.gz,/well/papiez/users/hri611/python/nnUnet_raw/Dataset219_PETCT/labelsTr/PETCT_34d3efa936_10222004.nii.gz,0.0,0.32346654510498046,0.0
98,0.6841875681570339,2305,591,0.5199734791977457,45593967,3137,3728,5442,/well/papiez/users/hri611/python/nnUNet_results/Dataset219_PETCT/nnUNetTrainer_probabilisticOversampling_033__nnUNetPlans__3d_fullres/crossval_results_folds_0_1_2/PETCT_350e91119a_10232005.nii.gz,/well/papiez/users/hri611/python/nnUnet_raw/Dataset219_PETCT/labelsTr/PETCT_350e91119a_10232005.nii.gz,0.6841875681570339,5.063495532989502,5.78507474899292
99,0.8421823507872574,616,677,0.7273877292852625,92315257,3450,4127,4066,/well/papiez/users/hri611/python/nnUNet_results/Dataset219_PETCT/nnUNetTrainer_probabilisticOversampling_033__nnUNetPlans__3d_fullres/crossval_results_folds_0_1_2/PETCT_35c9c85a96_04082005.nii.gz,/well/papiez/users/hri611/python/nnUnet_raw/Dataset219_PETCT/labelsTr/PETCT_35c9c85a96_04082005.nii.gz,0.8421823507872574,2.4882041931152346,0.48519981765747067
100,0.08940493468795356,12368,180,0.04679428745062291,52146836,616,796,12984,/well/papiez/users/hri611/python/nnUNet_results/Dataset219_PETCT/nnUNetTrainer_probabilisticOversampling_033__nnUNetPlans__3d_fullres/crossval_results_folds_0_1_2/PETCT_36bb0257fc_08032003.nii.gz,/well/papiez/users/hri611/python/nnUnet_raw/Dataset219_PETCT/labelsTr/PETCT_36bb0257fc_08032003.nii.gz,0.08940493468795356,1.4182763900756836,149.27981056594848
101,0.7627862488043662,1639,6793,0.6165355404975215,100938011,13557,20350,15196,/well/papiez/users/hri611/python/nnUNet_results/Dataset219_PETCT/nnUNetTrainer_probabilisticOversampling_033__nnUNetPlans__3d_fullres/crossval_results_folds_0_1_2/PETCT_36d8219e3f_02092006.nii.gz,/well/papiez/users/hri611/python/nnUnet_raw/Dataset219_PETCT/labelsTr/PETCT_36d8219e3f_02092006.nii.gz,0.7627862488043662,46.9399721031189,1.8288300819396972
102,0.0,0,159,0.0,48799841,0,159,0,/well/papiez/users/hri611/python/nnUNet_results/Dataset219_PETCT/nnUNetTrainer_probabilisticOversampling_033__nnUNetPlans__3d_fullres/crossval_results_folds_0_1_2/PETCT_372746cc99_07152006.nii.gz,/well/papiez/users/hri611/python/nnUnet_raw/Dataset219_PETCT/labelsTr/PETCT_372746cc99_07152006.nii.gz,0.0,1.9781223335266114,0.0
103,0.8594209592337798,4979,804,0.7534953111679454,52136540,17677,18481,22656,/well/papiez/users/hri611/python/nnUNet_results/Dataset219_PETCT/nnUNetTrainer_probabilisticOversampling_033__nnUNetPlans__3d_fullres/crossval_results_folds_0_1_2/PETCT_37952b7ffb_08242002.nii.gz,/well/papiez/users/hri611/python/nnUnet_raw/Dataset219_PETCT/labelsTr/PETCT_37952b7ffb_08242002.nii.gz,0.8594209592337798,0.24882041931152343,5.859720874786377
104,0.0,0,2454,0.0,52157546,0,2454,0,/well/papiez/users/hri611/python/nnUNet_results/Dataset219_PETCT/nnUNetTrainer_probabilisticOversampling_033__nnUNetPlans__3d_fullres/crossval_results_folds_0_1_2/PETCT_389462c0ac_03032005.nii.gz,/well/papiez/users/hri611/python/nnUnet_raw/Dataset219_PETCT/labelsTr/PETCT_389462c0ac_03032005.nii.gz,0.0,30.530265449523924,0.0
105,0.0,0,140,0.0,56159860,0,140,0,/well/papiez/users/hri611/python/nnUNet_results/Dataset219_PETCT/nnUNetTrainer_probabilisticOversampling_033__nnUNetPlans__3d_fullres/crossval_results_folds_0_1_2/PETCT_389462c0ac_08292005.nii.gz,/well/papiez/users/hri611/python/nnUnet_raw/Dataset219_PETCT/labelsTr/PETCT_389462c0ac_08292005.nii.gz,0.0,1.741742935180664,0.0
106,0.0,0,200,0.0,97279800,0,200,0,/well/papiez/users/hri611/python/nnUNet_results/Dataset219_PETCT/nnUNetTrainer_probabilisticOversampling_033__nnUNetPlans__3d_fullres/crossval_results_folds_0_1_2/PETCT_389c968170_02172006.nii.gz,/well/papiez/users/hri611/python/nnUnet_raw/Dataset219_PETCT/labelsTr/PETCT_389c968170_02172006.nii.gz,0.0,2.4882041931152346,0.0
107,0.0,0,1096,0.0,100958904,0,1096,0,/well/papiez/users/hri611/python/nnUNet_results/Dataset219_PETCT/nnUNetTrainer_probabilisticOversampling_033__nnUNetPlans__3d_fullres/crossval_results_folds_0_1_2/PETCT_389c968170_08192005.nii.gz,/well/papiez/users/hri611/python/nnUnet_raw/Dataset219_PETCT/labelsTr/PETCT_389c968170_08192005.nii.gz,0.0,13.635358978271483,0.0
108,0.0,0,953,0.0,52799047,0,953,0,/well/papiez/users/hri611/python/nnUNet_results/Dataset219_PETCT/nnUNetTrainer_probabilisticOversampling_033__nnUNetPlans__3d_fullres/crossval_results_folds_0_1_2/PETCT_38a374d01a_05242007.nii.gz,/well/papiez/users/hri611/python/nnUnet_raw/Dataset219_PETCT/labelsTr/PETCT_38a374d01a_05242007.nii.gz,0.0,11.856292980194091,0.0
109,0.0,0,1566,0.0,71518434,0,1566,0,/well/papiez/users/hri611/python/nnUNet_results/Dataset219_PETCT/nnUNetTrainer_probabilisticOversampling_033__nnUNetPlans__3d_fullres/crossval_results_folds_0_1_2/PETCT_390129c0d2_04272007.nii.gz,/well/papiez/users/hri611/python/nnUnet_raw/Dataset219_PETCT/labelsTr/PETCT_390129c0d2_04272007.nii.gz,0.0,19.482638832092285,0.0
110,0.0,0,343,0.0,65439657,0,343,0,/well/papiez/users/hri611/python/nnUNet_results/Dataset219_PETCT/nnUNetTrainer_probabilisticOversampling_033__nnUNetPlans__3d_fullres/crossval_results_folds_0_1_2/PETCT_39eca178a1_06082003.nii.gz,/well/papiez/users/hri611/python/nnUnet_raw/Dataset219_PETCT/labelsTr/PETCT_39eca178a1_06082003.nii.gz,0.0,4.267270191192627,0.0
111,,0,0,,49440000,0,0,0,/well/papiez/users/hri611/python/nnUNet_results/Dataset219_PETCT/nnUNetTrainer_probabilisticOversampling_033__nnUNetPlans__3d_fullres/crossval_results_folds_0_1_2/PETCT_3a40a26443_10022005.nii.gz,/well/papiez/users/hri611/python/nnUnet_raw/Dataset219_PETCT/labelsTr/PETCT_3a40a26443_10022005.nii.gz,,0.0,0.0
112,0.6460460492054224,17871,4558,0.47715511212643946,58837102,20469,25027,38340,/well/papiez/users/hri611/python/nnUNet_results/Dataset219_PETCT/nnUNetTrainer_probabilisticOversampling_033__nnUNetPlans__3d_fullres/crossval_results_folds_0_1_2/PETCT_3b1c9155f5_01312003.nii.gz,/well/papiez/users/hri611/python/nnUnet_raw/Dataset219_PETCT/labelsTr/PETCT_3b1c9155f5_01312003.nii.gz,0.6460460492054224,8.795801822662353,33.01846964263916
113,0.8640693871747476,5209,527,0.7606709225184629,52136033,18231,18758,23440,/well/papiez/users/hri611/python/nnUNet_results/Dataset219_PETCT/nnUNetTrainer_probabilisticOversampling_033__nnUNetPlans__3d_fullres/crossval_results_folds_0_1_2/PETCT_3b26172779_11102001.nii.gz,/well/papiez/users/hri611/python/nnUnet_raw/Dataset219_PETCT/labelsTr/PETCT_3b26172779_11102001.nii.gz,0.8640693871747476,1.5426865997314452,11.707000728607177
114,0.0,0,4,0.0,45439996,0,4,0,/well/papiez/users/hri611/python/nnUNet_results/Dataset219_PETCT/nnUNetTrainer_probabilisticOversampling_033__nnUNetPlans__3d_fullres/crossval_results_folds_0_1_2/PETCT_3b2a4af482_01262003.nii.gz,/well/papiez/users/hri611/python/nnUnet_raw/Dataset219_PETCT/labelsTr/PETCT_3b2a4af482_01262003.nii.gz,0.0,0.04976408386230469,0.0
115,0.0,0,32,0.0,48479968,0,32,0,/well/papiez/users/hri611/python/nnUNet_results/Dataset219_PETCT/nnUNetTrainer_probabilisticOversampling_033__nnUNetPlans__3d_fullres/crossval_results_folds_0_1_2/PETCT_3bce0eb7aa_06032007.nii.gz,/well/papiez/users/hri611/python/nnUnet_raw/Dataset219_PETCT/labelsTr/PETCT_3bce0eb7aa_06032007.nii.gz,0.0,0.3981126708984375,0.0
116,0.8835164835164835,4,49,0.7913385826771654,45439746,201,250,205,/well/papiez/users/hri611/python/nnUNet_results/Dataset219_PETCT/nnUNetTrainer_probabilisticOversampling_033__nnUNetPlans__3d_fullres/crossval_results_folds_0_1_2/PETCT_3c3050f75e_09052002.nii.gz,/well/papiez/users/hri611/python/nnUnet_raw/Dataset219_PETCT/labelsTr/PETCT_3c3050f75e_09052002.nii.gz,0.8835164835164835,0.024882041931152343,0.0
117,0.027186761229314422,200,4738,0.01378070701018574,78874993,69,4807,269,/well/papiez/users/hri611/python/nnUNet_results/Dataset219_PETCT/nnUNetTrainer_probabilisticOversampling_033__nnUNetPlans__3d_fullres/crossval_results_folds_0_1_2/PETCT_3c3ee87fc6_06132003.nii.gz,/well/papiez/users/hri611/python/nnUnet_raw/Dataset219_PETCT/labelsTr/PETCT_3c3ee87fc6_06132003.nii.gz,0.027186761229314422,58.9455573348999,2.027886417388916
118,0.8298751745206729,10571,1736,0.7092193554484453,52117676,30017,31753,40588,/well/papiez/users/hri611/python/nnUNet_results/Dataset219_PETCT/nnUNetTrainer_probabilisticOversampling_033__nnUNetPlans__3d_fullres/crossval_results_folds_0_1_2/PETCT_3c71e8f518_12112000.nii.gz,/well/papiez/users/hri611/python/nnUnet_raw/Dataset219_PETCT/labelsTr/PETCT_3c71e8f518_12112000.nii.gz,0.8298751745206729,6.344920692443847,11.719441749572754
119,0.0,0,245,0.0,94719755,0,245,0,/well/papiez/users/hri611/python/nnUNet_results/Dataset219_PETCT/nnUNetTrainer_probabilisticOversampling_033__nnUNetPlans__3d_fullres/crossval_results_folds_0_1_2/PETCT_3c94a00f90_05112007.nii.gz,/well/papiez/users/hri611/python/nnUnet_raw/Dataset219_PETCT/labelsTr/PETCT_3c94a00f90_05112007.nii.gz,0.0,3.048050136566162,0.0
120,0.0,0,18,0.0,45439982,0,18,0,/well/papiez/users/hri611/python/nnUNet_results/Dataset219_PETCT/nnUNetTrainer_probabilisticOversampling_033__nnUNetPlans__3d_fullres/crossval_results_folds_0_1_2/PETCT_3cd49210eb_12292002.nii.gz,/well/papiez/users/hri611/python/nnUnet_raw/Dataset219_PETCT/labelsTr/PETCT_3cd49210eb_12292002.nii.gz,0.0,0.2239383773803711,0.0
121,0.0,0,760,0.0,52159240,0,760,0,/well/papiez/users/hri611/python/nnUNet_results/Dataset219_PETCT/nnUNetTrainer_probabilisticOversampling_033__nnUNetPlans__3d_fullres/crossval_results_folds_0_1_2/PETCT_3cf68da275_03202003.nii.gz,/well/papiez/users/hri611/python/nnUnet_raw/Dataset219_PETCT/labelsTr/PETCT_3cf68da275_03202003.nii.gz,0.0,9.455175933837891,0.0
122,0.8144108111383813,682,5443,0.6869249642199959,52140436,13439,18882,14121,/well/papiez/users/hri611/python/nnUNet_results/Dataset219_PETCT/nnUNetTrainer_probabilisticOversampling_033__nnUNetPlans__3d_fullres/crossval_results_folds_0_1_2/PETCT_3d6f425a76_01282002.nii.gz,/well/papiez/users/hri611/python/nnUnet_raw/Dataset219_PETCT/labelsTr/PETCT_3d6f425a76_01282002.nii.gz,0.8144108111383813,22.953683681488037,0.024882041931152343
123,0.0,0,110,0.0,52159890,0,110,0,/well/papiez/users/hri611/python/nnUNet_results/Dataset219_PETCT/nnUNetTrainer_probabilisticOversampling_033__nnUNetPlans__3d_fullres/crossval_results_folds_0_1_2/PETCT_3d6f425a76_07222002.nii.gz,/well/papiez/users/hri611/python/nnUnet_raw/Dataset219_PETCT/labelsTr/PETCT_3d6f425a76_07222002.nii.gz,0.0,1.3685123062133788,0.0
124,,0,0,,45440000,0,0,0,/well/papiez/users/hri611/python/nnUNet_results/Dataset219_PETCT/nnUNetTrainer_probabilisticOversampling_033__nnUNetPlans__3d_fullres/crossval_results_folds_0_1_2/PETCT_3d8b79d739_11282004.nii.gz,/well/papiez/users/hri611/python/nnUnet_raw/Dataset219_PETCT/labelsTr/PETCT_3d8b79d739_11282004.nii.gz,,0.0,0.0
125,0.8874056515501216,1593,212,0.7976003588248486,45431082,7113,7325,8706,/well/papiez/users/hri611/python/nnUNet_results/Dataset219_PETCT/nnUNetTrainer_probabilisticOversampling_033__nnUNetPlans__3d_fullres/crossval_results_folds_0_1_2/PETCT_3eac8f16d4_09302001.nii.gz,/well/papiez/users/hri611/python/nnUnet_raw/Dataset219_PETCT/labelsTr/PETCT_3eac8f16d4_09302001.nii.gz,0.8874056515501216,0.1368512306213379,9.741319416046142
126,0.0,0,258,0.0,52159742,0,258,0,/well/papiez/users/hri611/python/nnUNet_results/Dataset219_PETCT/nnUNetTrainer_probabilisticOversampling_033__nnUNetPlans__3d_fullres/crossval_results_folds_0_1_2/PETCT_3f2ee0274d_09162002.nii.gz,/well/papiez/users/hri611/python/nnUnet_raw/Dataset219_PETCT/labelsTr/PETCT_3f2ee0274d_09162002.nii.gz,0.0,3.209783409118652,0.0
127,0.0,0,2,0.0,52159998,0,2,0,/well/papiez/users/hri611/python/nnUNet_results/Dataset219_PETCT/nnUNetTrainer_probabilisticOversampling_033__nnUNetPlans__3d_fullres/crossval_results_folds_0_1_2/PETCT_3f3df20439_05092005.nii.gz,/well/papiez/users/hri611/python/nnUnet_raw/Dataset219_PETCT/labelsTr/PETCT_3f3df20439_05092005.nii.gz,0.0,0.024882041931152343,0.0
128,0.6721931222956047,1024,6173,0.5062431394072447,45585424,7379,13552,8403,/well/papiez/users/hri611/python/nnUNet_results/Dataset219_PETCT/nnUNetTrainer_probabilisticOversampling_033__nnUNetPlans__3d_fullres/crossval_results_folds_0_1_2/PETCT_3f5a9f616f_06032007.nii.gz,/well/papiez/users/hri611/python/nnUnet_raw/Dataset219_PETCT/labelsTr/PETCT_3f5a9f616f_06032007.nii.gz,0.6721931222956047,1.2814251594543458,4.453885505676269
129,0.4269081500646831,6129,73,0.2713815789473684,45431488,2310,2383,8439,/well/papiez/users/hri611/python/nnUNet_results/Dataset219_PETCT/nnUNetTrainer_probabilisticOversampling_033__nnUNetPlans__3d_fullres/crossval_results_folds_0_1_2/PETCT_3fd361ec14_10242004.nii.gz,/well/papiez/users/hri611/python/nnUnet_raw/Dataset219_PETCT/labelsTr/PETCT_3fd361ec14_10242004.nii.gz,0.4269081500646831,0.2239383773803711,0.0
130,0.0,0,202,0.0,58879798,0,202,0,/well/papiez/users/hri611/python/nnUNet_results/Dataset219_PETCT/nnUNetTrainer_probabilisticOversampling_033__nnUNetPlans__3d_fullres/crossval_results_folds_0_1_2/PETCT_402c061122_02222003.nii.gz,/well/papiez/users/hri611/python/nnUnet_raw/Dataset219_PETCT/labelsTr/PETCT_402c061122_02222003.nii.gz,0.0,2.5130862350463867,0.0
131,0.0,0,42,0.0,45439958,0,42,0,/well/papiez/users/hri611/python/nnUNet_results/Dataset219_PETCT/nnUNetTrainer_probabilisticOversampling_033__nnUNetPlans__3d_fullres/crossval_results_folds_0_1_2/PETCT_402c061122_08252003.nii.gz,/well/papiez/users/hri611/python/nnUnet_raw/Dataset219_PETCT/labelsTr/PETCT_402c061122_08252003.nii.gz,0.0,0.5225228805541993,0.0
132,,0,0,,45120000,0,0,0,/well/papiez/users/hri611/python/nnUNet_results/Dataset219_PETCT/nnUNetTrainer_probabilisticOversampling_033__nnUNetPlans__3d_fullres/crossval_results_folds_0_1_2/PETCT_404f8c732f_06142007.nii.gz,/well/papiez/users/hri611/python/nnUnet_raw/Dataset219_PETCT/labelsTr/PETCT_404f8c732f_06142007.nii.gz,,0.0,0.0
133,,0,0,,53600000,0,0,0,/well/papiez/users/hri611/python/nnUNet_results/Dataset219_PETCT/nnUNetTrainer_probabilisticOversampling_033__nnUNetPlans__3d_fullres/crossval_results_folds_0_1_2/PETCT_416d3b9b78_08142006.nii.gz,/well/papiez/users/hri611/python/nnUnet_raw/Dataset219_PETCT/labelsTr/PETCT_416d3b9b78_08142006.nii.gz,,0.0,0.0
134,0.0,0,1972,0.0,52158028,0,1972,0,/well/papiez/users/hri611/python/nnUNet_results/Dataset219_PETCT/nnUNetTrainer_probabilisticOversampling_033__nnUNetPlans__3d_fullres/crossval_results_folds_0_1_2/PETCT_41f4d41517_11132004.nii.gz,/well/papiez/users/hri611/python/nnUnet_raw/Dataset219_PETCT/labelsTr/PETCT_41f4d41517_11132004.nii.gz,0.0,24.53369334411621,0.0
135,0.07989690721649484,0,714,0.04161073825503356,45439255,31,745,31,/well/papiez/users/hri611/python/nnUNet_results/Dataset219_PETCT/nnUNetTrainer_probabilisticOversampling_033__nnUNetPlans__3d_fullres/crossval_results_folds_0_1_2/PETCT_41fadf6520_02272003.nii.gz,/well/papiez/users/hri611/python/nnUnet_raw/Dataset219_PETCT/labelsTr/PETCT_41fadf6520_02272003.nii.gz,0.07989690721649484,8.609186508178711,0.0
136,0.8844727583911762,489,726,0.7928741902488919,92314134,4651,5377,5140,/well/papiez/users/hri611/python/nnUNet_results/Dataset219_PETCT/nnUNetTrainer_probabilisticOversampling_033__nnUNetPlans__3d_fullres/crossval_results_folds_0_1_2/PETCT_424e9b79c5_05112003.nii.gz,/well/papiez/users/hri611/python/nnUnet_raw/Dataset219_PETCT/labelsTr/PETCT_424e9b79c5_05112003.nii.gz,0.8844727583911762,5.623341476440429,0.012441020965576172
137,0.8040519963455096,10928,1297,0.6723135068485807,45402693,25082,26379,36010,/well/papiez/users/hri611/python/nnUNet_results/Dataset219_PETCT/nnUNetTrainer_probabilisticOversampling_033__nnUNetPlans__3d_fullres/crossval_results_folds_0_1_2/PETCT_43323b7d42_05272001.nii.gz,/well/papiez/users/hri611/python/nnUnet_raw/Dataset219_PETCT/labelsTr/PETCT_43323b7d42_05272001.nii.gz,0.8040519963455096,0.12441020965576172,13.672682041168212
138,0.8858589793533307,145,148,0.7951048951048951,50878570,1137,1285,1282,/well/papiez/users/hri611/python/nnUNet_results/Dataset219_PETCT/nnUNetTrainer_probabilisticOversampling_033__nnUNetPlans__3d_fullres/crossval_results_folds_0_1_2/PETCT_43647ff727_03022006.nii.gz,/well/papiez/users/hri611/python/nnUnet_raw/Dataset219_PETCT/labelsTr/PETCT_43647ff727_03022006.nii.gz,0.8858589793533307,0.1368512306213379,0.0
139,0.0,0,1,0.0,45439999,0,1,0,/well/papiez/users/hri611/python/nnUNet_results/Dataset219_PETCT/nnUNetTrainer_probabilisticOversampling_033__nnUNetPlans__3d_fullres/crossval_results_folds_0_1_2/PETCT_437d2c96fe_11162003.nii.gz,/well/papiez/users/hri611/python/nnUnet_raw/Dataset219_PETCT/labelsTr/PETCT_437d2c96fe_11162003.nii.gz,0.0,0.012441020965576172,0.0
140,0.0,0,140,0.0,46399860,0,140,0,/well/papiez/users/hri611/python/nnUNet_results/Dataset219_PETCT/nnUNetTrainer_probabilisticOversampling_033__nnUNetPlans__3d_fullres/crossval_results_folds_0_1_2/PETCT_43c9c71b31_05142007.nii.gz,/well/papiez/users/hri611/python/nnUnet_raw/Dataset219_PETCT/labelsTr/PETCT_43c9c71b31_05142007.nii.gz,0.0,1.741742935180664,0.0
141,0.0,0,383,0.0,52159617,0,383,0,/well/papiez/users/hri611/python/nnUNet_results/Dataset219_PETCT/nnUNetTrainer_probabilisticOversampling_033__nnUNetPlans__3d_fullres/crossval_results_folds_0_1_2/PETCT_44bf7dc508_07252002.nii.gz,/well/papiez/users/hri611/python/nnUnet_raw/Dataset219_PETCT/labelsTr/PETCT_44bf7dc508_07252002.nii.gz,0.0,4.764911029815674,0.0
142,0.9333888426311407,7,313,0.8750975800156128,52157438,2242,2555,2249,/well/papiez/users/hri611/python/nnUNet_results/Dataset219_PETCT/nnUNetTrainer_probabilisticOversampling_033__nnUNetPlans__3d_fullres/crossval_results_folds_0_1_2/PETCT_456d14846b_09012003.nii.gz,/well/papiez/users/hri611/python/nnUnet_raw/Dataset219_PETCT/labelsTr/PETCT_456d14846b_09012003.nii.gz,0.9333888426311407,1.2689841384887695,0.0
143,0.029401824940858398,73,5671,0.014920253815812039,52474169,87,5758,160,/well/papiez/users/hri611/python/nnUNet_results/Dataset219_PETCT/nnUNetTrainer_probabilisticOversampling_033__nnUNetPlans__3d_fullres/crossval_results_folds_0_1_2/PETCT_456e6f9dc2_07282005.nii.gz,/well/papiez/users/hri611/python/nnUnet_raw/Dataset219_PETCT/labelsTr/PETCT_456e6f9dc2_07282005.nii.gz,0.029401824940858398,70.55302989578247,0.0
144,0.6998027421279497,11555,772,0.5382281326091028,103813305,14368,15140,25923,/well/papiez/users/hri611/python/nnUNet_results/Dataset219_PETCT/nnUNetTrainer_probabilisticOversampling_033__nnUNetPlans__3d_fullres/crossval_results_folds_0_1_2/PETCT_4776e75543_04012007.nii.gz,/well/papiez/users/hri611/python/nnUnet_raw/Dataset219_PETCT/labelsTr/PETCT_4776e75543_04012007.nii.gz,0.6998027421279497,1.530245578765869,0.0
145,0.0,0,2532,0.0,51837468,0,2532,0,/well/papiez/users/hri611/python/nnUNet_results/Dataset219_PETCT/nnUNetTrainer_probabilisticOversampling_033__nnUNetPlans__3d_fullres/crossval_results_folds_0_1_2/PETCT_4785066413_08242006.nii.gz,/well/papiez/users/hri611/python/nnUnet_raw/Dataset219_PETCT/labelsTr/PETCT_4785066413_08242006.nii.gz,0.0,31.500665084838868,0.0
146,0.5329434894389272,8348,917,0.3632740017868188,52145449,5286,6203,13634,/well/papiez/users/hri611/python/nnUNet_results/Dataset219_PETCT/nnUNetTrainer_probabilisticOversampling_033__nnUNetPlans__3d_fullres/crossval_results_folds_0_1_2/PETCT_47cd731006_01252002.nii.gz,/well/papiez/users/hri611/python/nnUnet_raw/Dataset219_PETCT/labelsTr/PETCT_47cd731006_01252002.nii.gz,0.5329434894389272,1.965681312561035,0.0
147,,0,0,,50400000,0,0,0,/well/papiez/users/hri611/python/nnUNet_results/Dataset219_PETCT/nnUNetTrainer_probabilisticOversampling_033__nnUNetPlans__3d_fullres/crossval_results_folds_0_1_2/PETCT_47f4460050_08062006.nii.gz,/well/papiez/users/hri611/python/nnUnet_raw/Dataset219_PETCT/labelsTr/PETCT_47f4460050_08062006.nii.gz,,0.0,0.0
148,0.0,0,8,0.0,58399992,0,8,0,/well/papiez/users/hri611/python/nnUNet_results/Dataset219_PETCT/nnUNetTrainer_probabilisticOversampling_033__nnUNetPlans__3d_fullres/crossval_results_folds_0_1_2/PETCT_48c70dc4a3_04132007.nii.gz,/well/papiez/users/hri611/python/nnUnet_raw/Dataset219_PETCT/labelsTr/PETCT_48c70dc4a3_04132007.nii.gz,0.0,0.09952816772460937,0.0
149,0.770893371757925,402,234,0.6271981242672919,52158294,1070,1304,1472,/well/papiez/users/hri611/python/nnUNet_results/Dataset219_PETCT/nnUNetTrainer_probabilisticOversampling_033__nnUNetPlans__3d_fullres/crossval_results_folds_0_1_2/PETCT_49f3d297b0_07242003.nii.gz,/well/papiez/users/hri611/python/nnUnet_raw/Dataset219_PETCT/labelsTr/PETCT_49f3d297b0_07242003.nii.gz,0.770893371757925,0.24882041931152343,0.21149735641479492
150,0.38805879641982194,1584,99330,0.240740044089654,52027089,31997,131327,33581,/well/papiez/users/hri611/python/nnUNet_results/Dataset219_PETCT/nnUNetTrainer_probabilisticOversampling_033__nnUNetPlans__3d_fullres/crossval_results_folds_0_1_2/PETCT_4b688f46b0_02182005.nii.gz,/well/papiez/users/hri611/python/nnUnet_raw/Dataset219_PETCT/labelsTr/PETCT_4b688f46b0_02182005.nii.gz,0.38805879641982194,7.0416178665161135,0.21149735641479492
151,,0,0,,44960000,0,0,0,/well/papiez/users/hri611/python/nnUNet_results/Dataset219_PETCT/nnUNetTrainer_probabilisticOversampling_033__nnUNetPlans__3d_fullres/crossval_results_folds_0_1_2/PETCT_4bab91dccd_01052006.nii.gz,/well/papiez/users/hri611/python/nnUnet_raw/Dataset219_PETCT/labelsTr/PETCT_4bab91dccd_01052006.nii.gz,,0.0,0.0
152,0.8073112401776563,842,286,0.6768834144944142,45436509,2363,2649,3205,/well/papiez/users/hri611/python/nnUNet_results/Dataset219_PETCT/nnUNetTrainer_probabilisticOversampling_033__nnUNetPlans__3d_fullres/crossval_results_folds_0_1_2/PETCT_4be28f9cd7_02032002.nii.gz,/well/papiez/users/hri611/python/nnUnet_raw/Dataset219_PETCT/labelsTr/PETCT_4be28f9cd7_02032002.nii.gz,0.8073112401776563,2.264265815734863,0.1741742935180664
153,0.5478402826697081,70742,10134,0.37725897236488515,52030129,48995,59129,119737,/well/papiez/users/hri611/python/nnUNet_results/Dataset219_PETCT/nnUNetTrainer_probabilisticOversampling_033__nnUNetPlans__3d_fullres/crossval_results_folds_0_1_2/PETCT_4c75fa4a5d_04192001.nii.gz,/well/papiez/users/hri611/python/nnUnet_raw/Dataset219_PETCT/labelsTr/PETCT_4c75fa4a5d_04192001.nii.gz,0.5478402826697081,0.14929225158691406,134.7486980781555
154,0.8531192753918176,9509,2037,0.7438605053574994,52114923,33531,35568,43040,/well/papiez/users/hri611/python/nnUNet_results/Dataset219_PETCT/nnUNetTrainer_probabilisticOversampling_033__nnUNetPlans__3d_fullres/crossval_results_folds_0_1_2/PETCT_4c9e7be363_09172000.nii.gz,/well/papiez/users/hri611/python/nnUnet_raw/Dataset219_PETCT/labelsTr/PETCT_4c9e7be363_09172000.nii.gz,0.8531192753918176,2.102532543182373,0.4478767547607422
155,0.0,0,47,0.0,52159953,0,47,0,/well/papiez/users/hri611/python/nnUNet_results/Dataset219_PETCT/nnUNetTrainer_probabilisticOversampling_033__nnUNetPlans__3d_fullres/crossval_results_folds_0_1_2/PETCT_4ea806706c_10302003.nii.gz,/well/papiez/users/hri611/python/nnUnet_raw/Dataset219_PETCT/labelsTr/PETCT_4ea806706c_10302003.nii.gz,0.0,0.58472798538208,0.0
156,0.0,0,230,0.0,42399770,0,230,0,/well/papiez/users/hri611/python/nnUNet_results/Dataset219_PETCT/nnUNetTrainer_probabilisticOversampling_033__nnUNetPlans__3d_fullres/crossval_results_folds_0_1_2/PETCT_4fb1817df3_06062005.nii.gz,/well/papiez/users/hri611/python/nnUnet_raw/Dataset219_PETCT/labelsTr/PETCT_4fb1817df3_06062005.nii.gz,0.0,2.8614348220825194,0.0
157,0.6564299424184261,119,60,0.48857142857142855,52159650,171,231,290,/well/papiez/users/hri611/python/nnUNet_results/Dataset219_PETCT/nnUNetTrainer_probabilisticOversampling_033__nnUNetPlans__3d_fullres/crossval_results_folds_0_1_2/PETCT_5060603ba4_09192003.nii.gz,/well/papiez/users/hri611/python/nnUnet_raw/Dataset219_PETCT/labelsTr/PETCT_5060603ba4_09192003.nii.gz,0.6564299424184261,0.7091381950378418,0.7464612579345703
158,0.9059659269503992,6734,745,0.8280966281288069,45396493,36028,36773,42762,/well/papiez/users/hri611/python/nnUNet_results/Dataset219_PETCT/nnUNetTrainer_probabilisticOversampling_033__nnUNetPlans__3d_fullres/crossval_results_folds_0_1_2/PETCT_510fb36781_02062003.nii.gz,/well/papiez/users/hri611/python/nnUnet_raw/Dataset219_PETCT/labelsTr/PETCT_510fb36781_02062003.nii.gz,0.9059659269503992,0.0,0.0
159,,0,0,,48480000,0,0,0,/well/papiez/users/hri611/python/nnUNet_results/Dataset219_PETCT/nnUNetTrainer_probabilisticOversampling_033__nnUNetPlans__3d_fullres/crossval_results_folds_0_1_2/PETCT_53ccb9efbb_12152005.nii.gz,/well/papiez/users/hri611/python/nnUnet_raw/Dataset219_PETCT/labelsTr/PETCT_53ccb9efbb_12152005.nii.gz,,0.0,0.0
160,0.680327868852459,542,11080,0.515527950310559,50056011,12367,23447,12909,/well/papiez/users/hri611/python/nnUNet_results/Dataset219_PETCT/nnUNetTrainer_probabilisticOversampling_033__nnUNetPlans__3d_fullres/crossval_results_folds_0_1_2/PETCT_53dad1785b_12112005.nii.gz,/well/papiez/users/hri611/python/nnUnet_raw/Dataset219_PETCT/labelsTr/PETCT_53dad1785b_12112005.nii.gz,0.680327868852459,57.36554767227173,4.329475296020508
161,0.0,0,367,0.0,46079633,0,367,0,/well/papiez/users/hri611/python/nnUNet_results/Dataset219_PETCT/nnUNetTrainer_probabilisticOversampling_033__nnUNetPlans__3d_fullres/crossval_results_folds_0_1_2/PETCT_5420205a5f_12072006.nii.gz,/well/papiez/users/hri611/python/nnUnet_raw/Dataset219_PETCT/labelsTr/PETCT_5420205a5f_12072006.nii.gz,0.0,4.565854694366455,0.0
162,,0,0,,50560000,0,0,0,/well/papiez/users/hri611/python/nnUNet_results/Dataset219_PETCT/nnUNetTrainer_probabilisticOversampling_033__nnUNetPlans__3d_fullres/crossval_results_folds_0_1_2/PETCT_544676de40_12152005.nii.gz,/well/papiez/users/hri611/python/nnUnet_raw/Dataset219_PETCT/labelsTr/PETCT_544676de40_12152005.nii.gz,,0.0,0.0
163,0.8999306999307,1372,72,0.8180672798286506,48792063,6493,6565,7865,/well/papiez/users/hri611/python/nnUNet_results/Dataset219_PETCT/nnUNetTrainer_probabilisticOversampling_033__nnUNetPlans__3d_fullres/crossval_results_folds_0_1_2/PETCT_548213edf7_09192005.nii.gz,/well/papiez/users/hri611/python/nnUnet_raw/Dataset219_PETCT/labelsTr/PETCT_548213edf7_09192005.nii.gz,0.8999306999307,0.024882041931152343,0.8211073837280274
164,,0,0,,45440000,0,0,0,/well/papiez/users/hri611/python/nnUNet_results/Dataset219_PETCT/nnUNetTrainer_probabilisticOversampling_033__nnUNetPlans__3d_fullres/crossval_results_folds_0_1_2/PETCT_54977a7e76_02212003.nii.gz,/well/papiez/users/hri611/python/nnUnet_raw/Dataset219_PETCT/labelsTr/PETCT_54977a7e76_02212003.nii.gz,,0.0,0.0
165,0.9734382685686178,32,724,0.9482510781025395,58865391,13853,14577,13885,/well/papiez/users/hri611/python/nnUNet_results/Dataset219_PETCT/nnUNetTrainer_probabilisticOversampling_033__nnUNetPlans__3d_fullres/crossval_results_folds_0_1_2/PETCT_556b56485a_08292003.nii.gz,/well/papiez/users/hri611/python/nnUnet_raw/Dataset219_PETCT/labelsTr/PETCT_556b56485a_08292003.nii.gz,0.9734382685686178,0.32346654510498046,0.024882041931152343
166,0.05217391304347826,55,54,0.026785714285714284,52159888,3,57,58,/well/papiez/users/hri611/python/nnUNet_results/Dataset219_PETCT/nnUNetTrainer_probabilisticOversampling_033__nnUNetPlans__3d_fullres/crossval_results_folds_0_1_2/PETCT_55ae7986e1_05102003.nii.gz,/well/papiez/users/hri611/python/nnUnet_raw/Dataset219_PETCT/labelsTr/PETCT_55ae7986e1_05102003.nii.gz,0.05217391304347826,0.6718151321411132,0.0
167,0.0,0,3,0.0,51519997,0,3,0,/well/papiez/users/hri611/python/nnUNet_results/Dataset219_PETCT/nnUNetTrainer_probabilisticOversampling_033__nnUNetPlans__3d_fullres/crossval_results_folds_0_1_2/PETCT_55e3e62722_03032007.nii.gz,/well/papiez/users/hri611/python/nnUnet_raw/Dataset219_PETCT/labelsTr/PETCT_55e3e62722_03032007.nii.gz,0.0,0.037323062896728515,0.0
168,0.31102204408817635,3227,211,0.1841480778357855,52155786,776,987,4003,/well/papiez/users/hri611/python/nnUNet_results/Dataset219_PETCT/nnUNetTrainer_probabilisticOversampling_033__nnUNetPlans__3d_fullres/crossval_results_folds_0_1_2/PETCT_581fa95eb0_03242003.nii.gz,/well/papiez/users/hri611/python/nnUnet_raw/Dataset219_PETCT/labelsTr/PETCT_581fa95eb0_03242003.nii.gz,0.31102204408817635,2.4882041931152346,0.0
169,0.0,0,40,0.0,52159960,0,40,0,/well/papiez/users/hri611/python/nnUNet_results/Dataset219_PETCT/nnUNetTrainer_probabilisticOversampling_033__nnUNetPlans__3d_fullres/crossval_results_folds_0_1_2/PETCT_591b3025ff_11132004.nii.gz,/well/papiez/users/hri611/python/nnUnet_raw/Dataset219_PETCT/labelsTr/PETCT_591b3025ff_11132004.nii.gz,0.0,0.49764083862304687,0.0
170,0.0,0,196,0.0,48159804,0,196,0,/well/papiez/users/hri611/python/nnUNet_results/Dataset219_PETCT/nnUNetTrainer_probabilisticOversampling_033__nnUNetPlans__3d_fullres/crossval_results_folds_0_1_2/PETCT_595975bc57_03102006.nii.gz,/well/papiez/users/hri611/python/nnUnet_raw/Dataset219_PETCT/labelsTr/PETCT_595975bc57_03102006.nii.gz,0.0,2.4384401092529298,0.0
171,0.8224646089579949,1245,285,0.6984627512810406,51194926,3544,3829,4789,/well/papiez/users/hri611/python/nnUNet_results/Dataset219_PETCT/nnUNetTrainer_probabilisticOversampling_033__nnUNetPlans__3d_fullres/crossval_results_folds_0_1_2/PETCT_59e6d1de22_08062005.nii.gz,/well/papiez/users/hri611/python/nnUnet_raw/Dataset219_PETCT/labelsTr/PETCT_59e6d1de22_08062005.nii.gz,0.8224646089579949,0.19905633544921875,0.3110255241394043
172,0.8803659527815058,5081,1248,0.7862979470556456,52130384,23287,24535,28368,/well/papiez/users/hri611/python/nnUNet_results/Dataset219_PETCT/nnUNetTrainer_probabilisticOversampling_033__nnUNetPlans__3d_fullres/crossval_results_folds_0_1_2/PETCT_5ac322455f_05262003.nii.gz,/well/papiez/users/hri611/python/nnUnet_raw/Dataset219_PETCT/labelsTr/PETCT_5ac322455f_05262003.nii.gz,0.8803659527815058,0.5598459434509278,1.306307201385498
173,0.0,0,333,0.0,52159667,0,333,0,/well/papiez/users/hri611/python/nnUNet_results/Dataset219_PETCT/nnUNetTrainer_probabilisticOversampling_033__nnUNetPlans__3d_fullres/crossval_results_folds_0_1_2/PETCT_5ac4fd9091_11142004.nii.gz,/well/papiez/users/hri611/python/nnUnet_raw/Dataset219_PETCT/labelsTr/PETCT_5ac4fd9091_11142004.nii.gz,0.0,4.142859981536865,0.0
174,,0,0,,47520000,0,0,0,/well/papiez/users/hri611/python/nnUNet_results/Dataset219_PETCT/nnUNetTrainer_probabilisticOversampling_033__nnUNetPlans__3d_fullres/crossval_results_folds_0_1_2/PETCT_5b0aa4e971_09102006.nii.gz,/well/papiez/users/hri611/python/nnUnet_raw/Dataset219_PETCT/labelsTr/PETCT_5b0aa4e971_09102006.nii.gz,,0.0,0.0
175,0.32061068702290074,485,49,0.19090909090909092,52159340,126,175,611,/well/papiez/users/hri611/python/nnUNet_results/Dataset219_PETCT/nnUNetTrainer_probabilisticOversampling_033__nnUNetPlans__3d_fullres/crossval_results_folds_0_1_2/PETCT_5c1baad5d8_03062003.nii.gz,/well/papiez/users/hri611/python/nnUnet_raw/Dataset219_PETCT/labelsTr/PETCT_5c1baad5d8_03062003.nii.gz,0.32061068702290074,0.6096100273132324,0.0
176,0.5869297163995068,154,516,0.41535776614310643,45438854,476,992,630,/well/papiez/users/hri611/python/nnUNet_results/Dataset219_PETCT/nnUNetTrainer_probabilisticOversampling_033__nnUNetPlans__3d_fullres/crossval_results_folds_0_1_2/PETCT_5c35fcbe89_08102002.nii.gz,/well/papiez/users/hri611/python/nnUnet_raw/Dataset219_PETCT/labelsTr/PETCT_5c35fcbe89_08102002.nii.gz,0.5869297163995068,6.0338951683044435,0.0
177,0.8711015787067965,3516,3816,0.7716385834864671,45407893,24775,28591,28291,/well/papiez/users/hri611/python/nnUNet_results/Dataset219_PETCT/nnUNetTrainer_probabilisticOversampling_033__nnUNetPlans__3d_fullres/crossval_results_folds_0_1_2/PETCT_5c55b3087d_12112000.nii.gz,/well/papiez/users/hri611/python/nnUnet_raw/Dataset219_PETCT/labelsTr/PETCT_5c55b3087d_12112000.nii.gz,0.8711015787067965,22.754627346038816,12.217082588195801
178,,0,0,,45440000,0,0,0,/well/papiez/users/hri611/python/nnUNet_results/Dataset219_PETCT/nnUNetTrainer_probabilisticOversampling_033__nnUNetPlans__3d_fullres/crossval_results_folds_0_1_2/PETCT_5c57a98a43_02242005.nii.gz,/well/papiez/users/hri611/python/nnUnet_raw/Dataset219_PETCT/labelsTr/PETCT_5c57a98a43_02242005.nii.gz,,0.0,0.0
179,0.8615791896869245,726,11300,0.7568196064950559,47310547,37427,48727,38153,/well/papiez/users/hri611/python/nnUNet_results/Dataset219_PETCT/nnUNetTrainer_probabilisticOversampling_033__nnUNetPlans__3d_fullres/crossval_results_folds_0_1_2/PETCT_5d10be5b89_05302005.nii.gz,/well/papiez/users/hri611/python/nnUnet_raw/Dataset219_PETCT/labelsTr/PETCT_5d10be5b89_05302005.nii.gz,0.8615791896869245,3.5954550590515137,1.0077226982116698
180,0.013872832369942197,0,1706,0.006984866123399301,46718282,12,1718,12,/well/papiez/users/hri611/python/nnUNet_results/Dataset219_PETCT/nnUNetTrainer_probabilisticOversampling_033__nnUNetPlans__3d_fullres/crossval_results_folds_0_1_2/PETCT_5d994c3f44_03052006.nii.gz,/well/papiez/users/hri611/python/nnUnet_raw/Dataset219_PETCT/labelsTr/PETCT_5d994c3f44_03052006.nii.gz,0.013872832369942197,21.124853599548338,0.0
181,0.8761398176291794,272,54,0.7795807978363759,47518521,1153,1207,1425,/well/papiez/users/hri611/python/nnUNet_results/Dataset219_PETCT/nnUNetTrainer_probabilisticOversampling_033__nnUNetPlans__3d_fullres/crossval_results_folds_0_1_2/PETCT_5de3ac617a_11132005.nii.gz,/well/papiez/users/hri611/python/nnUnet_raw/Dataset219_PETCT/labelsTr/PETCT_5de3ac617a_11132005.nii.gz,0.8761398176291794,0.49764083862304687,0.0
182,0.0,0,79,0.0,46399921,0,79,0,/well/papiez/users/hri611/python/nnUNet_results/Dataset219_PETCT/nnUNetTrainer_probabilisticOversampling_033__nnUNetPlans__3d_fullres/crossval_results_folds_0_1_2/PETCT_5e339b2ecf_05272006.nii.gz,/well/papiez/users/hri611/python/nnUnet_raw/Dataset219_PETCT/labelsTr/PETCT_5e339b2ecf_05272006.nii.gz,0.0,0.9828406562805175,0.0
183,0.5646812957157785,2040,43,0.3934187536400699,45436566,1351,1394,3391,/well/papiez/users/hri611/python/nnUNet_results/Dataset219_PETCT/nnUNetTrainer_probabilisticOversampling_033__nnUNetPlans__3d_fullres/crossval_results_folds_0_1_2/PETCT_5e8b013935_12162001.nii.gz,/well/papiez/users/hri611/python/nnUnet_raw/Dataset219_PETCT/labelsTr/PETCT_5e8b013935_12162001.nii.gz,0.5646812957157785,0.0,9.753760437011719
184,0.0,0,447,0.0,45439553,0,447,0,/well/papiez/users/hri611/python/nnUNet_results/Dataset219_PETCT/nnUNetTrainer_probabilisticOversampling_033__nnUNetPlans__3d_fullres/crossval_results_folds_0_1_2/PETCT_5fa9d9a820_03242003.nii.gz,/well/papiez/users/hri611/python/nnUnet_raw/Dataset219_PETCT/labelsTr/PETCT_5fa9d9a820_03242003.nii.gz,0.0,5.561136371612549,0.0
185,0.0,0,245,0.0,45439755,0,245,0,/well/papiez/users/hri611/python/nnUNet_results/Dataset219_PETCT/nnUNetTrainer_probabilisticOversampling_033__nnUNetPlans__3d_fullres/crossval_results_folds_0_1_2/PETCT_5fa9d9a820_09152002.nii.gz,/well/papiez/users/hri611/python/nnUnet_raw/Dataset219_PETCT/labelsTr/PETCT_5fa9d9a820_09152002.nii.gz,0.0,3.048050136566162,0.0
186,0.0,0,250,0.0,52159750,0,250,0,/well/papiez/users/hri611/python/nnUNet_results/Dataset219_PETCT/nnUNetTrainer_probabilisticOversampling_033__nnUNetPlans__3d_fullres/crossval_results_folds_0_1_2/PETCT_5fa9d9a820_09272004.nii.gz,/well/papiez/users/hri611/python/nnUnet_raw/Dataset219_PETCT/labelsTr/PETCT_5fa9d9a820_09272004.nii.gz,0.0,3.110255241394043,0.0
187,0.0,0,307,0.0,52159693,0,307,0,/well/papiez/users/hri611/python/nnUNet_results/Dataset219_PETCT/nnUNetTrainer_probabilisticOversampling_033__nnUNetPlans__3d_fullres/crossval_results_folds_0_1_2/PETCT_6016a6c3af_07012002.nii.gz,/well/papiez/users/hri611/python/nnUnet_raw/Dataset219_PETCT/labelsTr/PETCT_6016a6c3af_07012002.nii.gz,0.0,3.8193934364318847,0.0
188,0.0,0,242,0.0,50879758,0,242,0,/well/papiez/users/hri611/python/nnUNet_results/Dataset219_PETCT/nnUNetTrainer_probabilisticOversampling_033__nnUNetPlans__3d_fullres/crossval_results_folds_0_1_2/PETCT_607c1b38e3_04142007.nii.gz,/well/papiez/users/hri611/python/nnUnet_raw/Dataset219_PETCT/labelsTr/PETCT_607c1b38e3_04142007.nii.gz,0.0,3.0107270736694334,0.0
189,0.0,0,39,0.0,48639961,0,39,0,/well/papiez/users/hri611/python/nnUNet_results/Dataset219_PETCT/nnUNetTrainer_probabilisticOversampling_033__nnUNetPlans__3d_fullres/crossval_results_folds_0_1_2/PETCT_607c1b38e3_10162006.nii.gz,/well/papiez/users/hri611/python/nnUnet_raw/Dataset219_PETCT/labelsTr/PETCT_607c1b38e3_10162006.nii.gz,0.0,0.48519981765747067,0.0
190,0.7614129796972187,1701,332,0.6147432253174152,45434723,3244,3576,4945,/well/papiez/users/hri611/python/nnUNet_results/Dataset219_PETCT/nnUNetTrainer_probabilisticOversampling_033__nnUNetPlans__3d_fullres/crossval_results_folds_0_1_2/PETCT_60baa6979c_08162003.nii.gz,/well/papiez/users/hri611/python/nnUnet_raw/Dataset219_PETCT/labelsTr/PETCT_60baa6979c_08162003.nii.gz,0.7614129796972187,0.8086663627624512,2.8365527801513672
191,0.8869334218827827,909,453,0.7968377088305489,45433296,5342,5795,6251,/well/papiez/users/hri611/python/nnUNet_results/Dataset219_PETCT/nnUNetTrainer_probabilisticOversampling_033__nnUNetPlans__3d_fullres/crossval_results_folds_0_1_2/PETCT_61663450f8_08162003.nii.gz,/well/papiez/users/hri611/python/nnUnet_raw/Dataset219_PETCT/labelsTr/PETCT_61663450f8_08162003.nii.gz,0.8869334218827827,1.741742935180664,0.0
192,0.9078712824842856,6422,1434,0.831285971995533,45393436,38708,40142,45130,/well/papiez/users/hri611/python/nnUNet_results/Dataset219_PETCT/nnUNetTrainer_probabilisticOversampling_033__nnUNetPlans__3d_fullres/crossval_results_folds_0_1_2/PETCT_6170317f2e_02182000.nii.gz,/well/papiez/users/hri611/python/nnUnet_raw/Dataset219_PETCT/labelsTr/PETCT_6170317f2e_02182000.nii.gz,0.9078712824842856,0.0870871467590332,6.120982315063476
193,0.0,0,242,0.0,58079758,0,242,0,/well/papiez/users/hri611/python/nnUNet_results/Dataset219_PETCT/nnUNetTrainer_probabilisticOversampling_033__nnUNetPlans__3d_fullres/crossval_results_folds_0_1_2/PETCT_61d5bc58fc_06152007.nii.gz,/well/papiez/users/hri611/python/nnUnet_raw/Dataset219_PETCT/labelsTr/PETCT_61d5bc58fc_06152007.nii.gz,0.0,3.0107270736694334,0.0
194,0.0,0,124,0.0,59839876,0,124,0,/well/papiez/users/hri611/python/nnUNet_results/Dataset219_PETCT/nnUNetTrainer_probabilisticOversampling_033__nnUNetPlans__3d_fullres/crossval_results_folds_0_1_2/PETCT_61d5bc58fc_06182005.nii.gz,/well/papiez/users/hri611/python/nnUnet_raw/Dataset219_PETCT/labelsTr/PETCT_61d5bc58fc_06182005.nii.gz,0.0,1.5426865997314452,0.0
195,0.0,0,608,0.0,55999392,0,608,0,/well/papiez/users/hri611/python/nnUNet_results/Dataset219_PETCT/nnUNetTrainer_probabilisticOversampling_033__nnUNetPlans__3d_fullres/crossval_results_folds_0_1_2/PETCT_61d5bc58fc_12152005.nii.gz,/well/papiez/users/hri611/python/nnUnet_raw/Dataset219_PETCT/labelsTr/PETCT_61d5bc58fc_12152005.nii.gz,0.0,7.564140747070312,0.0
196,0.9145436330536135,6827,1106,0.8425429716962407,52109618,42449,43555,49276,/well/papiez/users/hri611/python/nnUNet_results/Dataset219_PETCT/nnUNetTrainer_probabilisticOversampling_033__nnUNetPlans__3d_fullres/crossval_results_folds_0_1_2/PETCT_62011ff15b_05052005.nii.gz,/well/papiez/users/hri611/python/nnUnet_raw/Dataset219_PETCT/labelsTr/PETCT_62011ff15b_05052005.nii.gz,0.9145436330536135,0.26126144027709963,16.87002442932129
197,0.0,0,65,0.0,52159935,0,65,0,/well/papiez/users/hri611/python/nnUNet_results/Dataset219_PETCT/nnUNetTrainer_probabilisticOversampling_033__nnUNetPlans__3d_fullres/crossval_results_folds_0_1_2/PETCT_62b114e09b_06092003.nii.gz,/well/papiez/users/hri611/python/nnUnet_raw/Dataset219_PETCT/labelsTr/PETCT_62b114e09b_06092003.nii.gz,0.0,0.8086663627624512,0.0
198,0.9102080545078477,362,2590,0.8352126828179078,52142086,14962,17552,15324,/well/papiez/users/hri611/python/nnUNet_results/Dataset219_PETCT/nnUNetTrainer_probabilisticOversampling_033__nnUNetPlans__3d_fullres/crossval_results_folds_0_1_2/PETCT_62ced197ca_04142003.nii.gz,/well/papiez/users/hri611/python/nnUnet_raw/Dataset219_PETCT/labelsTr/PETCT_62ced197ca_04142003.nii.gz,0.9102080545078477,0.0,0.0
199,,0,0,,52160000,0,0,0,/well/papiez/users/hri611/python/nnUNet_results/Dataset219_PETCT/nnUNetTrainer_probabilisticOversampling_033__nnUNetPlans__3d_fullres/crossval_results_folds_0_1_2/PETCT_63464433c8_01042003.nii.gz,/well/papiez/users/hri611/python/nnUnet_raw/Dataset219_PETCT/labelsTr/PETCT_63464433c8_01042003.nii.gz,,0.0,0.0
200,0.9083796776321991,458,1486,0.832138848113289,45428419,9637,11123,10095,/well/papiez/users/hri611/python/nnUNet_results/Dataset219_PETCT/nnUNetTrainer_probabilisticOversampling_033__nnUNetPlans__3d_fullres/crossval_results_folds_0_1_2/PETCT_63508c679d_02172005.nii.gz,/well/papiez/users/hri611/python/nnUnet_raw/Dataset219_PETCT/labelsTr/PETCT_63508c679d_02172005.nii.gz,0.9083796776321991,8.70871467590332,0.0
201,0.0,0,358,0.0,45759642,0,358,0,/well/papiez/users/hri611/python/nnUNet_results/Dataset219_PETCT/nnUNetTrainer_probabilisticOversampling_033__nnUNetPlans__3d_fullres/crossval_results_folds_0_1_2/PETCT_63508c679d_08212005.nii.gz,/well/papiez/users/hri611/python/nnUnet_raw/Dataset219_PETCT/labelsTr/PETCT_63508c679d_08212005.nii.gz,0.0,4.453885505676269,0.0
202,0.8851373717312149,813,228,0.7939429928741093,52154948,4011,4239,4824,/well/papiez/users/hri611/python/nnUNet_results/Dataset219_PETCT/nnUNetTrainer_probabilisticOversampling_033__nnUNetPlans__3d_fullres/crossval_results_folds_0_1_2/PETCT_64909533c5_04142003.nii.gz,/well/papiez/users/hri611/python/nnUnet_raw/Dataset219_PETCT/labelsTr/PETCT_64909533c5_04142003.nii.gz,0.8851373717312149,0.1741742935180664,0.0
203,,0,0,,49920000,0,0,0,/well/papiez/users/hri611/python/nnUNet_results/Dataset219_PETCT/nnUNetTrainer_probabilisticOversampling_033__nnUNetPlans__3d_fullres/crossval_results_folds_0_1_2/PETCT_64aff75516_01202006.nii.gz,/well/papiez/users/hri611/python/nnUnet_raw/Dataset219_PETCT/labelsTr/PETCT_64aff75516_01202006.nii.gz,,0.0,0.0
204,0.0,0,208,0.0,47839792,0,208,0,/well/papiez/users/hri611/python/nnUNet_results/Dataset219_PETCT/nnUNetTrainer_probabilisticOversampling_033__nnUNetPlans__3d_fullres/crossval_results_folds_0_1_2/PETCT_64aff75516_10162005.nii.gz,/well/papiez/users/hri611/python/nnUnet_raw/Dataset219_PETCT/labelsTr/PETCT_64aff75516_10162005.nii.gz,0.0,2.5877323608398437,0.0
205,0.0,0,1394,0.0,41918606,0,1394,0,/well/papiez/users/hri611/python/nnUNet_results/Dataset219_PETCT/nnUNetTrainer_probabilisticOversampling_033__nnUNetPlans__3d_fullres/crossval_results_folds_0_1_2/PETCT_64c0cba177_08072006.nii.gz,/well/papiez/users/hri611/python/nnUnet_raw/Dataset219_PETCT/labelsTr/PETCT_64c0cba177_08072006.nii.gz,0.0,17.342783226013182,0.0
206,0.683377308707124,182,58,0.5190380761523046,92319501,259,317,441,/well/papiez/users/hri611/python/nnUNet_results/Dataset219_PETCT/nnUNetTrainer_probabilisticOversampling_033__nnUNetPlans__3d_fullres/crossval_results_folds_0_1_2/PETCT_65346b03b8_03142004.nii.gz,/well/papiez/users/hri611/python/nnUnet_raw/Dataset219_PETCT/labelsTr/PETCT_65346b03b8_03142004.nii.gz,0.683377308707124,0.4603177757263184,0.0
207,0.6858120675544974,3921,302,0.5218523550724637,45431168,4609,4911,8530,/well/papiez/users/hri611/python/nnUNet_results/Dataset219_PETCT/nnUNetTrainer_probabilisticOversampling_033__nnUNetPlans__3d_fullres/crossval_results_folds_0_1_2/PETCT_65a1330e90_06162001.nii.gz,/well/papiez/users/hri611/python/nnUnet_raw/Dataset219_PETCT/labelsTr/PETCT_65a1330e90_06162001.nii.gz,0.6858120675544974,0.1741742935180664,30.231680946350096
208,0.0,0,6576,0.0,52153424,0,6576,0,/well/papiez/users/hri611/python/nnUNet_results/Dataset219_PETCT/nnUNetTrainer_probabilisticOversampling_033__nnUNetPlans__3d_fullres/crossval_results_folds_0_1_2/PETCT_674c49778c_12222002.nii.gz,/well/papiez/users/hri611/python/nnUnet_raw/Dataset219_PETCT/labelsTr/PETCT_674c49778c_12222002.nii.gz,0.0,81.8121538696289,0.0
209,0.6971262990976191,7955,18594,0.5350682100765284,52102897,30554,49148,38509,/well/papiez/users/hri611/python/nnUNet_results/Dataset219_PETCT/nnUNetTrainer_probabilisticOversampling_033__nnUNetPlans__3d_fullres/crossval_results_folds_0_1_2/PETCT_685d7c09b5_12232000.nii.gz,/well/papiez/users/hri611/python/nnUnet_raw/Dataset219_PETCT/labelsTr/PETCT_685d7c09b5_12232000.nii.gz,0.6971262990976191,5.187905742645263,3.76962935256958
210,0.9274232245681382,2404,16,0.864668381612795,45422118,15462,15478,17866,/well/papiez/users/hri611/python/nnUNet_results/Dataset219_PETCT/nnUNetTrainer_probabilisticOversampling_033__nnUNetPlans__3d_fullres/crossval_results_folds_0_1_2/PETCT_68f73c4518_11132004.nii.gz,/well/papiez/users/hri611/python/nnUnet_raw/Dataset219_PETCT/labelsTr/PETCT_68f73c4518_11132004.nii.gz,0.9274232245681382,0.0,0.0
211,,0,0,,50560000,0,0,0,/well/papiez/users/hri611/python/nnUNet_results/Dataset219_PETCT/nnUNetTrainer_probabilisticOversampling_033__nnUNetPlans__3d_fullres/crossval_results_folds_0_1_2/PETCT_69606f6a25_08132006.nii.gz,/well/papiez/users/hri611/python/nnUnet_raw/Dataset219_PETCT/labelsTr/PETCT_69606f6a25_08132006.nii.gz,,0.0,0.0
212,,0,0,,44320000,0,0,0,/well/papiez/users/hri611/python/nnUNet_results/Dataset219_PETCT/nnUNetTrainer_probabilisticOversampling_033__nnUNetPlans__3d_fullres/crossval_results_folds_0_1_2/PETCT_69c90b6820_11212005.nii.gz,/well/papiez/users/hri611/python/nnUnet_raw/Dataset219_PETCT/labelsTr/PETCT_69c90b6820_11212005.nii.gz,,0.0,0.0
213,0.8775782075428361,19847,9468,0.781861340754686,45305613,105072,114540,124919,/well/papiez/users/hri611/python/nnUNet_results/Dataset219_PETCT/nnUNetTrainer_probabilisticOversampling_033__nnUNetPlans__3d_fullres/crossval_results_folds_0_1_2/PETCT_6a3477cd9a_01152005.nii.gz,/well/papiez/users/hri611/python/nnUnet_raw/Dataset219_PETCT/labelsTr/PETCT_6a3477cd9a_01152005.nii.gz,0.8775782075428361,7.825402187347412,26.58646180343628
214,0.47279250548136337,2575,70,0.3095797441921169,45436169,1186,1256,3761,/well/papiez/users/hri611/python/nnUNet_results/Dataset219_PETCT/nnUNetTrainer_probabilisticOversampling_033__nnUNetPlans__3d_fullres/crossval_results_folds_0_1_2/PETCT_6aea5c3a03_12272001.nii.gz,/well/papiez/users/hri611/python/nnUnet_raw/Dataset219_PETCT/labelsTr/PETCT_6aea5c3a03_12272001.nii.gz,0.47279250548136337,0.2239383773803711,8.746037738800048
215,,0,0,,51840000,0,0,0,/well/papiez/users/hri611/python/nnUNet_results/Dataset219_PETCT/nnUNetTrainer_probabilisticOversampling_033__nnUNetPlans__3d_fullres/crossval_results_folds_0_1_2/PETCT_6b177a3c28_06302005.nii.gz,/well/papiez/users/hri611/python/nnUnet_raw/Dataset219_PETCT/labelsTr/PETCT_6b177a3c28_06302005.nii.gz,,0.0,0.0
216,0.0,0,4,0.0,38719996,0,4,0,/well/papiez/users/hri611/python/nnUNet_results/Dataset219_PETCT/nnUNetTrainer_probabilisticOversampling_033__nnUNetPlans__3d_fullres/crossval_results_folds_0_1_2/PETCT_6b20c7eabb_07312003.nii.gz,/well/papiez/users/hri611/python/nnUnet_raw/Dataset219_PETCT/labelsTr/PETCT_6b20c7eabb_07312003.nii.gz,0.0,0.04976408386230469,0.0
217,0.8916082430422775,1511,1040,0.8044161619259372,51666957,10492,11532,12003,/well/papiez/users/hri611/python/nnUNet_results/Dataset219_PETCT/nnUNetTrainer_probabilisticOversampling_033__nnUNetPlans__3d_fullres/crossval_results_folds_0_1_2/PETCT_6c23f2686d_04212007.nii.gz,/well/papiez/users/hri611/python/nnUnet_raw/Dataset219_PETCT/labelsTr/PETCT_6c23f2686d_04212007.nii.gz,0.8916082430422775,1.8537121238708496,0.0
218,0.8565217391304348,8,124,0.7490494296577946,54079474,394,518,402,/well/papiez/users/hri611/python/nnUNet_results/Dataset219_PETCT/nnUNetTrainer_probabilisticOversampling_033__nnUNetPlans__3d_fullres/crossval_results_folds_0_1_2/PETCT_6d62e15c29_02232007.nii.gz,/well/papiez/users/hri611/python/nnUnet_raw/Dataset219_PETCT/labelsTr/PETCT_6d62e15c29_02232007.nii.gz,0.8565217391304348,1.0699278030395507,0.0
219,0.8779662927681642,1402,763,0.7824776449311766,52150047,7788,8551,9190,/well/papiez/users/hri611/python/nnUNet_results/Dataset219_PETCT/nnUNetTrainer_probabilisticOversampling_033__nnUNetPlans__3d_fullres/crossval_results_folds_0_1_2/PETCT_6d6a193655_11172002.nii.gz,/well/papiez/users/hri611/python/nnUnet_raw/Dataset219_PETCT/labelsTr/PETCT_6d6a193655_11172002.nii.gz,0.8779662927681642,0.11196918869018554,0.0
220,0.0,0,1,0.0,45439999,0,1,0,/well/papiez/users/hri611/python/nnUNet_results/Dataset219_PETCT/nnUNetTrainer_probabilisticOversampling_033__nnUNetPlans__3d_fullres/crossval_results_folds_0_1_2/PETCT_6dd36a2c19_11282003.nii.gz,/well/papiez/users/hri611/python/nnUnet_raw/Dataset219_PETCT/labelsTr/PETCT_6dd36a2c19_11282003.nii.gz,0.0,0.012441020965576172,0.0
221,0.8895785065997832,4333,862,0.8011178745071016,52133879,20926,21788,25259,/well/papiez/users/hri611/python/nnUNet_results/Dataset219_PETCT/nnUNetTrainer_probabilisticOversampling_033__nnUNetPlans__3d_fullres/crossval_results_folds_0_1_2/PETCT_6e7c7f8087_03232003.nii.gz,/well/papiez/users/hri611/python/nnUnet_raw/Dataset219_PETCT/labelsTr/PETCT_6e7c7f8087_03232003.nii.gz,0.8895785065997832,0.12441020965576172,0.0
222,0.4815426997245179,75,866,0.31712626995645865,52158622,437,1303,512,/well/papiez/users/hri611/python/nnUNet_results/Dataset219_PETCT/nnUNetTrainer_probabilisticOversampling_033__nnUNetPlans__3d_fullres/crossval_results_folds_0_1_2/PETCT_6efefcb92a_03262005.nii.gz,/well/papiez/users/hri611/python/nnUnet_raw/Dataset219_PETCT/labelsTr/PETCT_6efefcb92a_03262005.nii.gz,0.4815426997245179,10.151873107910156,0.24882041931152343
223,0.0,0,3231,0.0,94236769,0,3231,0,/well/papiez/users/hri611/python/nnUNet_results/Dataset219_PETCT/nnUNetTrainer_probabilisticOversampling_033__nnUNetPlans__3d_fullres/crossval_results_folds_0_1_2/PETCT_6f46454a8d_09032005.nii.gz,/well/papiez/users/hri611/python/nnUnet_raw/Dataset219_PETCT/labelsTr/PETCT_6f46454a8d_09032005.nii.gz,0.0,40.19693873977661,0.0
224,0.0,0,414,0.0,99039586,0,414,0,/well/papiez/users/hri611/python/nnUNet_results/Dataset219_PETCT/nnUNetTrainer_probabilisticOversampling_033__nnUNetPlans__3d_fullres/crossval_results_folds_0_1_2/PETCT_6f46454a8d_09122002.nii.gz,/well/papiez/users/hri611/python/nnUnet_raw/Dataset219_PETCT/labelsTr/PETCT_6f46454a8d_09122002.nii.gz,0.0,5.150582679748535,0.0
225,0.8086177720912956,4279,358,0.6787223723411626,52145567,9796,10154,14075,/well/papiez/users/hri611/python/nnUNet_results/Dataset219_PETCT/nnUNetTrainer_probabilisticOversampling_033__nnUNetPlans__3d_fullres/crossval_results_folds_0_1_2/PETCT_6fe855c937_12292001.nii.gz,/well/papiez/users/hri611/python/nnUnet_raw/Dataset219_PETCT/labelsTr/PETCT_6fe855c937_12292001.nii.gz,0.8086177720912956,0.8584304466247559,0.0
226,0.5467266366816592,865,42,0.37620357634112794,52158546,547,589,1412,/well/papiez/users/hri611/python/nnUNet_results/Dataset219_PETCT/nnUNetTrainer_probabilisticOversampling_033__nnUNetPlans__3d_fullres/crossval_results_folds_0_1_2/PETCT_7094acd4c0_08232001.nii.gz,/well/papiez/users/hri611/python/nnUnet_raw/Dataset219_PETCT/labelsTr/PETCT_7094acd4c0_08232001.nii.gz,0.5467266366816592,0.1741742935180664,9.281001640319824
227,0.0,0,1,0.0,45439999,0,1,0,/well/papiez/users/hri611/python/nnUNet_results/Dataset219_PETCT/nnUNetTrainer_probabilisticOversampling_033__nnUNetPlans__3d_fullres/crossval_results_folds_0_1_2/PETCT_71ae114917_04132003.nii.gz,/well/papiez/users/hri611/python/nnUnet_raw/Dataset219_PETCT/labelsTr/PETCT_71ae114917_04132003.nii.gz,0.0,0.012441020965576172,0.0
228,,0,0,,50880000,0,0,0,/well/papiez/users/hri611/python/nnUNet_results/Dataset219_PETCT/nnUNetTrainer_probabilisticOversampling_033__nnUNetPlans__3d_fullres/crossval_results_folds_0_1_2/PETCT_72725f2bda_07062007.nii.gz,/well/papiez/users/hri611/python/nnUnet_raw/Dataset219_PETCT/labelsTr/PETCT_72725f2bda_07062007.nii.gz,,0.0,0.0
229,0.0,0,4260,0.0,38235740,0,4260,0,/well/papiez/users/hri611/python/nnUNet_results/Dataset219_PETCT/nnUNetTrainer_probabilisticOversampling_033__nnUNetPlans__3d_fullres/crossval_results_folds_0_1_2/PETCT_72d2d6de52_08052005.nii.gz,/well/papiez/users/hri611/python/nnUnet_raw/Dataset219_PETCT/labelsTr/PETCT_72d2d6de52_08052005.nii.gz,0.0,52.998749313354494,0.0
230,0.74005954848679,7643,13048,0.5873766078372719,45069855,29454,42502,37097,/well/papiez/users/hri611/python/nnUNet_results/Dataset219_PETCT/nnUNetTrainer_probabilisticOversampling_033__nnUNetPlans__3d_fullres/crossval_results_folds_0_1_2/PETCT_7323c415d0_02262006.nii.gz,/well/papiez/users/hri611/python/nnUnet_raw/Dataset219_PETCT/labelsTr/PETCT_7323c415d0_02262006.nii.gz,0.74005954848679,4.67782388305664,56.85546581268311
231,0.8294636795655126,5572,1964,0.7086184897343696,84454137,18327,20291,23899,/well/papiez/users/hri611/python/nnUNet_results/Dataset219_PETCT/nnUNetTrainer_probabilisticOversampling_033__nnUNetPlans__3d_fullres/crossval_results_folds_0_1_2/PETCT_73597f33fe_05172007.nii.gz,/well/papiez/users/hri611/python/nnUnet_raw/Dataset219_PETCT/labelsTr/PETCT_73597f33fe_05172007.nii.gz,0.8294636795655126,1.8537121238708496,3.495926891326904
232,0.0,0,325,0.0,51839675,0,325,0,/well/papiez/users/hri611/python/nnUNet_results/Dataset219_PETCT/nnUNetTrainer_probabilisticOversampling_033__nnUNetPlans__3d_fullres/crossval_results_folds_0_1_2/PETCT_7365362464_03222007.nii.gz,/well/papiez/users/hri611/python/nnUnet_raw/Dataset219_PETCT/labelsTr/PETCT_7365362464_03222007.nii.gz,0.0,4.043331813812256,0.0
233,0.19834710743801653,4,772,0.11009174311926606,45119128,96,868,100,/well/papiez/users/hri611/python/nnUNet_results/Dataset219_PETCT/nnUNetTrainer_probabilisticOversampling_033__nnUNetPlans__3d_fullres/crossval_results_folds_0_1_2/PETCT_74bbceaeeb_06032005.nii.gz,/well/papiez/users/hri611/python/nnUnet_raw/Dataset219_PETCT/labelsTr/PETCT_74bbceaeeb_06032005.nii.gz,0.19834710743801653,8.907771011352539,0.0
234,0.0,0,4,0.0,38719996,0,4,0,/well/papiez/users/hri611/python/nnUNet_results/Dataset219_PETCT/nnUNetTrainer_probabilisticOversampling_033__nnUNetPlans__3d_fullres/crossval_results_folds_0_1_2/PETCT_75d5e740f0_07112002.nii.gz,/well/papiez/users/hri611/python/nnUnet_raw/Dataset219_PETCT/labelsTr/PETCT_75d5e740f0_07112002.nii.gz,0.0,0.04976408386230469,0.0
235,0.0,0,118,0.0,52159882,0,118,0,/well/papiez/users/hri611/python/nnUNet_results/Dataset219_PETCT/nnUNetTrainer_probabilisticOversampling_033__nnUNetPlans__3d_fullres/crossval_results_folds_0_1_2/PETCT_75e42ff05f_09212002.nii.gz,/well/papiez/users/hri611/python/nnUnet_raw/Dataset219_PETCT/labelsTr/PETCT_75e42ff05f_09212002.nii.gz,0.0,1.4680404739379882,0.0
236,0.0,0,28,0.0,45439972,0,28,0,/well/papiez/users/hri611/python/nnUNet_results/Dataset219_PETCT/nnUNetTrainer_probabilisticOversampling_033__nnUNetPlans__3d_fullres/crossval_results_folds_0_1_2/PETCT_777fa0ba88_11042002.nii.gz,/well/papiez/users/hri611/python/nnUnet_raw/Dataset219_PETCT/labelsTr/PETCT_777fa0ba88_11042002.nii.gz,0.0,0.3483485870361328,0.0
237,0.3363265306122449,132,681,0.20215897939156036,97278981,206,887,338,/well/papiez/users/hri611/python/nnUNet_results/Dataset219_PETCT/nnUNetTrainer_probabilisticOversampling_033__nnUNetPlans__3d_fullres/crossval_results_folds_0_1_2/PETCT_7785c10e91_12152006.nii.gz,/well/papiez/users/hri611/python/nnUnet_raw/Dataset219_PETCT/labelsTr/PETCT_7785c10e91_12152006.nii.gz,0.3363265306122449,8.136427711486816,0.0
238,0.6840464013970313,9,5057,0.5198104265402843,45429450,5484,10541,5493,/well/papiez/users/hri611/python/nnUNet_results/Dataset219_PETCT/nnUNetTrainer_probabilisticOversampling_033__nnUNetPlans__3d_fullres/crossval_results_folds_0_1_2/PETCT_790246c76c_02072004.nii.gz,/well/papiez/users/hri611/python/nnUnet_raw/Dataset219_PETCT/labelsTr/PETCT_790246c76c_02072004.nii.gz,0.6840464013970313,14.406702278137207,0.0
239,0.6431134654818865,7923,431,0.47396259681380265,45424119,7527,7958,15450,/well/papiez/users/hri611/python/nnUNet_results/Dataset219_PETCT/nnUNetTrainer_probabilisticOversampling_033__nnUNetPlans__3d_fullres/crossval_results_folds_0_1_2/PETCT_7948aa0e26_08102001.nii.gz,/well/papiez/users/hri611/python/nnUnet_raw/Dataset219_PETCT/labelsTr/PETCT_7948aa0e26_08102001.nii.gz,0.6431134654818865,0.0,14.829696990966797
240,,0,0,,45440000,0,0,0,/well/papiez/users/hri611/python/nnUNet_results/Dataset219_PETCT/nnUNetTrainer_probabilisticOversampling_033__nnUNetPlans__3d_fullres/crossval_results_folds_0_1_2/PETCT_7978e9fe62_03232003.nii.gz,/well/papiez/users/hri611/python/nnUnet_raw/Dataset219_PETCT/labelsTr/PETCT_7978e9fe62_03232003.nii.gz,,0.0,0.0
241,0.0,0,64,0.0,49119936,0,64,0,/well/papiez/users/hri611/python/nnUNet_results/Dataset219_PETCT/nnUNetTrainer_probabilisticOversampling_033__nnUNetPlans__3d_fullres/crossval_results_folds_0_1_2/PETCT_7a262070a9_11252005.nii.gz,/well/papiez/users/hri611/python/nnUnet_raw/Dataset219_PETCT/labelsTr/PETCT_7a262070a9_11252005.nii.gz,0.0,0.796225341796875,0.0
242,0.7013304882640894,8675,843,0.5400376939061519,45419307,11175,12018,19850,/well/papiez/users/hri611/python/nnUNet_results/Dataset219_PETCT/nnUNetTrainer_probabilisticOversampling_033__nnUNetPlans__3d_fullres/crossval_results_folds_0_1_2/PETCT_7a77b26403_10202000.nii.gz,/well/papiez/users/hri611/python/nnUnet_raw/Dataset219_PETCT/labelsTr/PETCT_7a77b26403_10202000.nii.gz,0.7013304882640894,0.49764083862304687,12.05534931564331
243,0.890700685818426,3098,1460,0.8029399048854302,99016870,18572,20032,21670,/well/papiez/users/hri611/python/nnUNet_results/Dataset219_PETCT/nnUNetTrainer_probabilisticOversampling_033__nnUNetPlans__3d_fullres/crossval_results_folds_0_1_2/PETCT_7b477e7e0d_07262002.nii.gz,/well/papiez/users/hri611/python/nnUnet_raw/Dataset219_PETCT/labelsTr/PETCT_7b477e7e0d_07262002.nii.gz,0.890700685818426,2.4384401092529298,4.988849407196045
244,0.0,0,77,0.0,52159923,0,77,0,/well/papiez/users/hri611/python/nnUNet_results/Dataset219_PETCT/nnUNetTrainer_probabilisticOversampling_033__nnUNetPlans__3d_fullres/crossval_results_folds_0_1_2/PETCT_7b9d625330_11172002.nii.gz,/well/papiez/users/hri611/python/nnUnet_raw/Dataset219_PETCT/labelsTr/PETCT_7b9d625330_11172002.nii.gz,0.0,0.9579586143493652,0.0
245,0.0,0,53,0.0,99039947,0,53,0,/well/papiez/users/hri611/python/nnUNet_results/Dataset219_PETCT/nnUNetTrainer_probabilisticOversampling_033__nnUNetPlans__3d_fullres/crossval_results_folds_0_1_2/PETCT_7c1e6175e0_01302005.nii.gz,/well/papiez/users/hri611/python/nnUnet_raw/Dataset219_PETCT/labelsTr/PETCT_7c1e6175e0_01302005.nii.gz,0.0,0.6593741111755371,0.0
246,0.0,0,8323,0.0,52151677,0,8323,0,/well/papiez/users/hri611/python/nnUNet_results/Dataset219_PETCT/nnUNetTrainer_probabilisticOversampling_033__nnUNetPlans__3d_fullres/crossval_results_folds_0_1_2/PETCT_7c96c4626d_06302003.nii.gz,/well/papiez/users/hri611/python/nnUnet_raw/Dataset219_PETCT/labelsTr/PETCT_7c96c4626d_06302003.nii.gz,0.0,103.54661749649048,0.0
247,0.516867469879518,1014,7006,0.34849715678310317,92147690,4290,11296,5304,/well/papiez/users/hri611/python/nnUNet_results/Dataset219_PETCT/nnUNetTrainer_probabilisticOversampling_033__nnUNetPlans__3d_fullres/crossval_results_folds_0_1_2/PETCT_7cfd708a53_06172005.nii.gz,/well/papiez/users/hri611/python/nnUnet_raw/Dataset219_PETCT/labelsTr/PETCT_7cfd708a53_06172005.nii.gz,0.516867469879518,82.27247164535522,2.052768459320068
248,0.11418832552194291,1706,373,0.0605512878445549,52157787,134,507,1840,/well/papiez/users/hri611/python/nnUNet_results/Dataset219_PETCT/nnUNetTrainer_probabilisticOversampling_033__nnUNetPlans__3d_fullres/crossval_results_folds_0_1_2/PETCT_7d01eb835d_03312002.nii.gz,/well/papiez/users/hri611/python/nnUnet_raw/Dataset219_PETCT/labelsTr/PETCT_7d01eb835d_03312002.nii.gz,0.11418832552194291,4.2299471282958985,21.211940746307373
249,0.0,0,28,0.0,52159972,0,28,0,/well/papiez/users/hri611/python/nnUNet_results/Dataset219_PETCT/nnUNetTrainer_probabilisticOversampling_033__nnUNetPlans__3d_fullres/crossval_results_folds_0_1_2/PETCT_7d8aa1e94d_10042002.nii.gz,/well/papiez/users/hri611/python/nnUnet_raw/Dataset219_PETCT/labelsTr/PETCT_7d8aa1e94d_10042002.nii.gz,0.0,0.3483485870361328,0.0
250,0.8594350660203911,2250,273,0.7535169988276671,52149764,7713,7986,9963,/well/papiez/users/hri611/python/nnUNet_results/Dataset219_PETCT/nnUNetTrainer_probabilisticOversampling_033__nnUNetPlans__3d_fullres/crossval_results_folds_0_1_2/PETCT_7d97f7a102_04212002.nii.gz,/well/papiez/users/hri611/python/nnUnet_raw/Dataset219_PETCT/labelsTr/PETCT_7d97f7a102_04212002.nii.gz,0.8594350660203911,0.024882041931152343,0.0
251,0.0,0,5,0.0,46239995,0,5,0,/well/papiez/users/hri611/python/nnUNet_results/Dataset219_PETCT/nnUNetTrainer_probabilisticOversampling_033__nnUNetPlans__3d_fullres/crossval_results_folds_0_1_2/PETCT_7e56b0b62c_05272006.nii.gz,/well/papiez/users/hri611/python/nnUnet_raw/Dataset219_PETCT/labelsTr/PETCT_7e56b0b62c_05272006.nii.gz,0.0,0.06220510482788086,0.0
252,0.8177091071163275,674,553,0.6916310630811762,52156021,2752,3305,3426,/well/papiez/users/hri611/python/nnUNet_results/Dataset219_PETCT/nnUNetTrainer_probabilisticOversampling_033__nnUNetPlans__3d_fullres/crossval_results_folds_0_1_2/PETCT_7e5729ea40_02212003.nii.gz,/well/papiez/users/hri611/python/nnUnet_raw/Dataset219_PETCT/labelsTr/PETCT_7e5729ea40_02212003.nii.gz,0.8177091071163275,1.0077226982116698,0.0
253,0.8594799883143441,51,430,0.7535860655737705,52158048,1471,1901,1522,/well/papiez/users/hri611/python/nnUNet_results/Dataset219_PETCT/nnUNetTrainer_probabilisticOversampling_033__nnUNetPlans__3d_fullres/crossval_results_folds_0_1_2/PETCT_7ed037687a_01272003.nii.gz,/well/papiez/users/hri611/python/nnUnet_raw/Dataset219_PETCT/labelsTr/PETCT_7ed037687a_01272003.nii.gz,0.8594799883143441,0.5225228805541993,0.0
254,0.0,0,9210,0.0,52150790,0,9210,0,/well/papiez/users/hri611/python/nnUNet_results/Dataset219_PETCT/nnUNetTrainer_probabilisticOversampling_033__nnUNetPlans__3d_fullres/crossval_results_folds_0_1_2/PETCT_7ef5343426_05122005.nii.gz,/well/papiez/users/hri611/python/nnUnet_raw/Dataset219_PETCT/labelsTr/PETCT_7ef5343426_05122005.nii.gz,0.0,114.58180309295653,0.0
255,0.2558959067497967,608,2137,0.14672054709356544,99036783,472,2609,1080,/well/papiez/users/hri611/python/nnUNet_results/Dataset219_PETCT/nnUNetTrainer_probabilisticOversampling_033__nnUNetPlans__3d_fullres/crossval_results_folds_0_1_2/PETCT_7f2a604e03_05052002.nii.gz,/well/papiez/users/hri611/python/nnUnet_raw/Dataset219_PETCT/labelsTr/PETCT_7f2a604e03_05052002.nii.gz,0.2558959067497967,25.329918685913086,4.329475296020508
256,0.9098272138228942,233,101,0.8345715700842001,45437981,1685,1786,1918,/well/papiez/users/hri611/python/nnUNet_results/Dataset219_PETCT/nnUNetTrainer_probabilisticOversampling_033__nnUNetPlans__3d_fullres/crossval_results_folds_0_1_2/PETCT_7faf36a152_06142002.nii.gz,/well/papiez/users/hri611/python/nnUnet_raw/Dataset219_PETCT/labelsTr/PETCT_7faf36a152_06142002.nii.gz,0.9098272138228942,0.012441020965576172,0.0
257,0.0,0,117,0.0,45439883,0,117,0,/well/papiez/users/hri611/python/nnUNet_results/Dataset219_PETCT/nnUNetTrainer_probabilisticOversampling_033__nnUNetPlans__3d_fullres/crossval_results_folds_0_1_2/PETCT_7faf36a152_11272005.nii.gz,/well/papiez/users/hri611/python/nnUnet_raw/Dataset219_PETCT/labelsTr/PETCT_7faf36a152_11272005.nii.gz,0.0,1.4555994529724121,0.0
258,0.0,0,4,0.0,38719996,0,4,0,/well/papiez/users/hri611/python/nnUNet_results/Dataset219_PETCT/nnUNetTrainer_probabilisticOversampling_033__nnUNetPlans__3d_fullres/crossval_results_folds_0_1_2/PETCT_80b8393c44_07222002.nii.gz,/well/papiez/users/hri611/python/nnUnet_raw/Dataset219_PETCT/labelsTr/PETCT_80b8393c44_07222002.nii.gz,0.0,0.04976408386230469,0.0
259,0.8378498692337655,4078,1750,0.7209480488388795,52139115,15057,16807,19135,/well/papiez/users/hri611/python/nnUNet_results/Dataset219_PETCT/nnUNetTrainer_probabilisticOversampling_033__nnUNetPlans__3d_fullres/crossval_results_folds_0_1_2/PETCT_80d7e682f7_02112005.nii.gz,/well/papiez/users/hri611/python/nnUnet_raw/Dataset219_PETCT/labelsTr/PETCT_80d7e682f7_02112005.nii.gz,0.8378498692337655,1.1445739288330077,0.19905633544921875
260,,0,0,,50560000,0,0,0,/well/papiez/users/hri611/python/nnUNet_results/Dataset219_PETCT/nnUNetTrainer_probabilisticOversampling_033__nnUNetPlans__3d_fullres/crossval_results_folds_0_1_2/PETCT_80f21e1ed0_11122006.nii.gz,/well/papiez/users/hri611/python/nnUnet_raw/Dataset219_PETCT/labelsTr/PETCT_80f21e1ed0_11122006.nii.gz,,0.0,0.0
261,0.0,0,1485,0.0,92318515,0,1485,0,/well/papiez/users/hri611/python/nnUNet_results/Dataset219_PETCT/nnUNetTrainer_probabilisticOversampling_033__nnUNetPlans__3d_fullres/crossval_results_folds_0_1_2/PETCT_80f7760f65_11142005.nii.gz,/well/papiez/users/hri611/python/nnUnet_raw/Dataset219_PETCT/labelsTr/PETCT_80f7760f65_11142005.nii.gz,0.0,18.474916133880615,0.0
262,0.0,0,27,0.0,49919973,0,27,0,/well/papiez/users/hri611/python/nnUNet_results/Dataset219_PETCT/nnUNetTrainer_probabilisticOversampling_033__nnUNetPlans__3d_fullres/crossval_results_folds_0_1_2/PETCT_81debf13a1_03092006.nii.gz,/well/papiez/users/hri611/python/nnUnet_raw/Dataset219_PETCT/labelsTr/PETCT_81debf13a1_03092006.nii.gz,0.0,0.3359075660705566,0.0
263,0.7942503992778279,68,2895,0.6587191891269293,52151318,5719,8614,5787,/well/papiez/users/hri611/python/nnUNet_results/Dataset219_PETCT/nnUNetTrainer_probabilisticOversampling_033__nnUNetPlans__3d_fullres/crossval_results_folds_0_1_2/PETCT_82137245b0_01262002.nii.gz,/well/papiez/users/hri611/python/nnUnet_raw/Dataset219_PETCT/labelsTr/PETCT_82137245b0_01262002.nii.gz,0.7942503992778279,1.7790659980773926,0.012441020965576172
264,0.0,0,1180,0.0,47518820,0,1180,0,/well/papiez/users/hri611/python/nnUNet_results/Dataset219_PETCT/nnUNetTrainer_probabilisticOversampling_033__nnUNetPlans__3d_fullres/crossval_results_folds_0_1_2/PETCT_8311aeddb9_12162005.nii.gz,/well/papiez/users/hri611/python/nnUnet_raw/Dataset219_PETCT/labelsTr/PETCT_8311aeddb9_12162005.nii.gz,0.0,14.680404739379883,0.0
265,0.7749344214514718,1512,2349,0.6325656642558051,51989492,6647,8996,8159,/well/papiez/users/hri611/python/nnUNet_results/Dataset219_PETCT/nnUNetTrainer_probabilisticOversampling_033__nnUNetPlans__3d_fullres/crossval_results_folds_0_1_2/PETCT_84e7715ed9_01042002.nii.gz,/well/papiez/users/hri611/python/nnUnet_raw/Dataset219_PETCT/labelsTr/PETCT_84e7715ed9_01042002.nii.gz,0.7749344214514718,25.653385231018067,0.0
266,,0,0,,47360000,0,0,0,/well/papiez/users/hri611/python/nnUNet_results/Dataset219_PETCT/nnUNetTrainer_probabilisticOversampling_033__nnUNetPlans__3d_fullres/crossval_results_folds_0_1_2/PETCT_855c7fca12_07272006.nii.gz,/well/papiez/users/hri611/python/nnUnet_raw/Dataset219_PETCT/labelsTr/PETCT_855c7fca12_07272006.nii.gz,,0.0,0.0
267,0.0,0,210,0.0,46879790,0,210,0,/well/papiez/users/hri611/python/nnUNet_results/Dataset219_PETCT/nnUNetTrainer_probabilisticOversampling_033__nnUNetPlans__3d_fullres/crossval_results_folds_0_1_2/PETCT_85b69fed1c_01212006.nii.gz,/well/papiez/users/hri611/python/nnUnet_raw/Dataset219_PETCT/labelsTr/PETCT_85b69fed1c_01212006.nii.gz,0.0,2.612614402770996,0.0
268,0.0,0,11,0.0,53599989,0,11,0,/well/papiez/users/hri611/python/nnUNet_results/Dataset219_PETCT/nnUNetTrainer_probabilisticOversampling_033__nnUNetPlans__3d_fullres/crossval_results_folds_0_1_2/PETCT_86153b2974_03192006.nii.gz,/well/papiez/users/hri611/python/nnUnet_raw/Dataset219_PETCT/labelsTr/PETCT_86153b2974_03192006.nii.gz,0.0,0.1368512306213379,0.0
269,0.0,0,340,0.0,53119660,0,340,0,/well/papiez/users/hri611/python/nnUNet_results/Dataset219_PETCT/nnUNetTrainer_probabilisticOversampling_033__nnUNetPlans__3d_fullres/crossval_results_folds_0_1_2/PETCT_86153b2974_10022005.nii.gz,/well/papiez/users/hri611/python/nnUnet_raw/Dataset219_PETCT/labelsTr/PETCT_86153b2974_10022005.nii.gz,0.0,4.2299471282958985,0.0
270,0.8876607132468439,126,1805,0.7980125523012552,45430440,7629,9434,7755,/well/papiez/users/hri611/python/nnUNet_results/Dataset219_PETCT/nnUNetTrainer_probabilisticOversampling_033__nnUNetPlans__3d_fullres/crossval_results_folds_0_1_2/PETCT_86e54ea60a_03182002.nii.gz,/well/papiez/users/hri611/python/nnUnet_raw/Dataset219_PETCT/labelsTr/PETCT_86e54ea60a_03182002.nii.gz,0.8876607132468439,2.886316864013672,0.24882041931152343
271,0.3102712587625724,0,2263,0.18362193362193363,45437228,509,2772,509,/well/papiez/users/hri611/python/nnUNet_results/Dataset219_PETCT/nnUNetTrainer_probabilisticOversampling_033__nnUNetPlans__3d_fullres/crossval_results_folds_0_1_2/PETCT_870181d7fd_10312004.nii.gz,/well/papiez/users/hri611/python/nnUnet_raw/Dataset219_PETCT/labelsTr/PETCT_870181d7fd_10312004.nii.gz,0.3102712587625724,24.459047218322752,0.0
272,,0,0,,87200000,0,0,0,/well/papiez/users/hri611/python/nnUNet_results/Dataset219_PETCT/nnUNetTrainer_probabilisticOversampling_033__nnUNetPlans__3d_fullres/crossval_results_folds_0_1_2/PETCT_87afc291ec_01262006.nii.gz,/well/papiez/users/hri611/python/nnUnet_raw/Dataset219_PETCT/labelsTr/PETCT_87afc291ec_01262006.nii.gz,,0.0,0.0
273,0.0,0,568,0.0,85599432,0,568,0,/well/papiez/users/hri611/python/nnUNet_results/Dataset219_PETCT/nnUNetTrainer_probabilisticOversampling_033__nnUNetPlans__3d_fullres/crossval_results_folds_0_1_2/PETCT_87afc291ec_07202003.nii.gz,/well/papiez/users/hri611/python/nnUnet_raw/Dataset219_PETCT/labelsTr/PETCT_87afc291ec_07202003.nii.gz,0.0,7.066499908447265,0.0
274,0.7688868307171487,14196,277,0.624546020545813,52121452,24075,24352,38271,/well/papiez/users/hri611/python/nnUNet_results/Dataset219_PETCT/nnUNetTrainer_probabilisticOversampling_033__nnUNetPlans__3d_fullres/crossval_results_folds_0_1_2/PETCT_88bcc970b3_02282002.nii.gz,/well/papiez/users/hri611/python/nnUnet_raw/Dataset219_PETCT/labelsTr/PETCT_88bcc970b3_02282002.nii.gz,0.7688868307171487,1.5675686416625976,18.773500637054443
275,0.3780160857908847,59,405,0.23305785123966943,92319395,141,546,200,/well/papiez/users/hri611/python/nnUNet_results/Dataset219_PETCT/nnUNetTrainer_probabilisticOversampling_033__nnUNetPlans__3d_fullres/crossval_results_folds_0_1_2/PETCT_89065bc4ab_02202004.nii.gz,/well/papiez/users/hri611/python/nnUnet_raw/Dataset219_PETCT/labelsTr/PETCT_89065bc4ab_02202004.nii.gz,0.3780160857908847,3.9935677299499512,0.3981126708984375
276,0.8142884508378411,15836,24882,0.6867508808640931,58750014,89268,114150,105104,/well/papiez/users/hri611/python/nnUNet_results/Dataset219_PETCT/nnUNetTrainer_probabilisticOversampling_033__nnUNetPlans__3d_fullres/crossval_results_folds_0_1_2/PETCT_8a52353a72_02172003.nii.gz,/well/papiez/users/hri611/python/nnUnet_raw/Dataset219_PETCT/labelsTr/PETCT_8a52353a72_02172003.nii.gz,0.8142884508378411,10.761483135223388,51.51826781845093
277,0.8320323014804846,2991,753,0.7123761235307675,45426983,9273,10026,12264,/well/papiez/users/hri611/python/nnUNet_results/Dataset219_PETCT/nnUNetTrainer_probabilisticOversampling_033__nnUNetPlans__3d_fullres/crossval_results_folds_0_1_2/PETCT_8aa48809ea_04162001.nii.gz,/well/papiez/users/hri611/python/nnUnet_raw/Dataset219_PETCT/labelsTr/PETCT_8aa48809ea_04162001.nii.gz,0.8320323014804846,7.564140747070312,0.04976408386230469
278,0.0,0,66,0.0,40639934,0,66,0,/well/papiez/users/hri611/python/nnUNet_results/Dataset219_PETCT/nnUNetTrainer_probabilisticOversampling_033__nnUNetPlans__3d_fullres/crossval_results_folds_0_1_2/PETCT_8af3757198_12032006.nii.gz,/well/papiez/users/hri611/python/nnUnet_raw/Dataset219_PETCT/labelsTr/PETCT_8af3757198_12032006.nii.gz,0.0,0.8211073837280274,0.0
279,0.0,0,37,0.0,92799963,0,37,0,/well/papiez/users/hri611/python/nnUNet_results/Dataset219_PETCT/nnUNetTrainer_probabilisticOversampling_033__nnUNetPlans__3d_fullres/crossval_results_folds_0_1_2/PETCT_8b14e6a819_01292006.nii.gz,/well/papiez/users/hri611/python/nnUnet_raw/Dataset219_PETCT/labelsTr/PETCT_8b14e6a819_01292006.nii.gz,0.0,0.4603177757263184,0.0
280,0.0,0,3054,0.0,99036946,0,3054,0,/well/papiez/users/hri611/python/nnUNet_results/Dataset219_PETCT/nnUNetTrainer_probabilisticOversampling_033__nnUNetPlans__3d_fullres/crossval_results_folds_0_1_2/PETCT_8b40e356dc_06182007.nii.gz,/well/papiez/users/hri611/python/nnUnet_raw/Dataset219_PETCT/labelsTr/PETCT_8b40e356dc_06182007.nii.gz,0.0,37.99487802886963,0.0
281,0.0,0,43,0.0,38719957,0,43,0,/well/papiez/users/hri611/python/nnUNet_results/Dataset219_PETCT/nnUNetTrainer_probabilisticOversampling_033__nnUNetPlans__3d_fullres/crossval_results_folds_0_1_2/PETCT_8b73608326_04042003.nii.gz,/well/papiez/users/hri611/python/nnUnet_raw/Dataset219_PETCT/labelsTr/PETCT_8b73608326_04042003.nii.gz,0.0,0.5349639015197754,0.0
282,0.8552334246838791,626,8407,0.7470810583788324,52124285,26682,35089,27308,/well/papiez/users/hri611/python/nnUNet_results/Dataset219_PETCT/nnUNetTrainer_probabilisticOversampling_033__nnUNetPlans__3d_fullres/crossval_results_folds_0_1_2/PETCT_8b74860ce6_03102005.nii.gz,/well/papiez/users/hri611/python/nnUnet_raw/Dataset219_PETCT/labelsTr/PETCT_8b74860ce6_03102005.nii.gz,0.8552334246838791,2.189619689941406,0.07464612579345703
283,0.0,0,17981,0.0,49262019,0,17981,0,/well/papiez/users/hri611/python/nnUNet_results/Dataset219_PETCT/nnUNetTrainer_probabilisticOversampling_033__nnUNetPlans__3d_fullres/crossval_results_folds_0_1_2/PETCT_8bf08c9a42_06092006.nii.gz,/well/papiez/users/hri611/python/nnUnet_raw/Dataset219_PETCT/labelsTr/PETCT_8bf08c9a42_06092006.nii.gz,0.0,223.70199798202515,0.0
284,0.0,0,970,0.0,49919030,0,970,0,/well/papiez/users/hri611/python/nnUNet_results/Dataset219_PETCT/nnUNetTrainer_probabilisticOversampling_033__nnUNetPlans__3d_fullres/crossval_results_folds_0_1_2/PETCT_8c5d99b459_05042007.nii.gz,/well/papiez/users/hri611/python/nnUnet_raw/Dataset219_PETCT/labelsTr/PETCT_8c5d99b459_05042007.nii.gz,0.0,12.067790336608887,0.0
285,0.875725900116144,149,172,0.7789256198347108,52158548,1131,1303,1280,/well/papiez/users/hri611/python/nnUNet_results/Dataset219_PETCT/nnUNetTrainer_probabilisticOversampling_033__nnUNetPlans__3d_fullres/crossval_results_folds_0_1_2/PETCT_8c8cd2699c_01182004.nii.gz,/well/papiez/users/hri611/python/nnUnet_raw/Dataset219_PETCT/labelsTr/PETCT_8c8cd2699c_01182004.nii.gz,0.875725900116144,0.58472798538208,0.0
286,0.8071467539552646,1975,9337,0.6766521838554768,52125016,23672,33009,25647,/well/papiez/users/hri611/python/nnUNet_results/Dataset219_PETCT/nnUNetTrainer_probabilisticOversampling_033__nnUNetPlans__3d_fullres/crossval_results_folds_0_1_2/PETCT_8de6953d23_01192001.nii.gz,/well/papiez/users/hri611/python/nnUnet_raw/Dataset219_PETCT/labelsTr/PETCT_8de6953d23_01192001.nii.gz,0.8071467539552646,1.1072508659362792,0.024882041931152343
287,0.782051282051282,0,102,0.6421052631578947,52159715,183,285,183,/well/papiez/users/hri611/python/nnUNet_results/Dataset219_PETCT/nnUNetTrainer_probabilisticOversampling_033__nnUNetPlans__3d_fullres/crossval_results_folds_0_1_2/PETCT_8e905366fe_04272001.nii.gz,/well/papiez/users/hri611/python/nnUnet_raw/Dataset219_PETCT/labelsTr/PETCT_8e905366fe_04272001.nii.gz,0.782051282051282,0.04976408386230469,0.0
288,0.782910455677404,40888,2089,0.643264465896923,52039527,77496,79585,118384,/well/papiez/users/hri611/python/nnUNet_results/Dataset219_PETCT/nnUNetTrainer_probabilisticOversampling_033__nnUNetPlans__3d_fullres/crossval_results_folds_0_1_2/PETCT_8ec13728df_10141999.nii.gz,/well/papiez/users/hri611/python/nnUnet_raw/Dataset219_PETCT/labelsTr/PETCT_8ec13728df_10141999.nii.gz,0.782910455677404,0.04976408386230469,52.87433910369873
289,0.0,0,3,0.0,52159997,0,3,0,/well/papiez/users/hri611/python/nnUNet_results/Dataset219_PETCT/nnUNetTrainer_probabilisticOversampling_033__nnUNetPlans__3d_fullres/crossval_results_folds_0_1_2/PETCT_8f2878df50_02212003.nii.gz,/well/papiez/users/hri611/python/nnUnet_raw/Dataset219_PETCT/labelsTr/PETCT_8f2878df50_02212003.nii.gz,0.0,0.037323062896728515,0.0
290,0.0,0,259,0.0,37759741,0,259,0,/well/papiez/users/hri611/python/nnUNet_results/Dataset219_PETCT/nnUNetTrainer_probabilisticOversampling_033__nnUNetPlans__3d_fullres/crossval_results_folds_0_1_2/PETCT_8fea5f0537_09262005.nii.gz,/well/papiez/users/hri611/python/nnUnet_raw/Dataset219_PETCT/labelsTr/PETCT_8fea5f0537_09262005.nii.gz,0.0,3.2222244300842284,0.0
291,0.6792227917511027,3294,7470,0.5142599277978339,52137840,11396,18866,14690,/well/papiez/users/hri611/python/nnUNet_results/Dataset219_PETCT/nnUNetTrainer_probabilisticOversampling_033__nnUNetPlans__3d_fullres/crossval_results_folds_0_1_2/PETCT_901573a747_05132005.nii.gz,/well/papiez/users/hri611/python/nnUnet_raw/Dataset219_PETCT/labelsTr/PETCT_901573a747_05132005.nii.gz,0.6792227917511027,24.123139652252195,2.8365527801513672
292,,0,0,,45440000,0,0,0,/well/papiez/users/hri611/python/nnUNet_results/Dataset219_PETCT/nnUNetTrainer_probabilisticOversampling_033__nnUNetPlans__3d_fullres/crossval_results_folds_0_1_2/PETCT_90d668ed29_06072003.nii.gz,/well/papiez/users/hri611/python/nnUnet_raw/Dataset219_PETCT/labelsTr/PETCT_90d668ed29_06072003.nii.gz,,0.0,0.0
293,0.8929349736379614,2234,812,0.8065786131572263,52144252,12702,13514,14936,/well/papiez/users/hri611/python/nnUNet_results/Dataset219_PETCT/nnUNetTrainer_probabilisticOversampling_033__nnUNetPlans__3d_fullres/crossval_results_folds_0_1_2/PETCT_90ea6a6aaf_07272001.nii.gz,/well/papiez/users/hri611/python/nnUnet_raw/Dataset219_PETCT/labelsTr/PETCT_90ea6a6aaf_07272001.nii.gz,0.8929349736379614,4.018449771881103,0.19905633544921875
294,0.5430379746835443,36,686,0.37271937445699393,90078849,429,1115,465,/well/papiez/users/hri611/python/nnUNet_results/Dataset219_PETCT/nnUNetTrainer_probabilisticOversampling_033__nnUNetPlans__3d_fullres/crossval_results_folds_0_1_2/PETCT_912a25778f_05172007.nii.gz,/well/papiez/users/hri611/python/nnUnet_raw/Dataset219_PETCT/labelsTr/PETCT_912a25778f_05172007.nii.gz,0.5430379746835443,7.812961166381836,0.0
295,0.45440494590417313,20,333,0.294,47999500,147,480,167,/well/papiez/users/hri611/python/nnUNet_results/Dataset219_PETCT/nnUNetTrainer_probabilisticOversampling_033__nnUNetPlans__3d_fullres/crossval_results_folds_0_1_2/PETCT_91cfa804b0_09222006.nii.gz,/well/papiez/users/hri611/python/nnUnet_raw/Dataset219_PETCT/labelsTr/PETCT_91cfa804b0_09222006.nii.gz,0.45440494590417313,4.030890792846679,0.06220510482788086
296,0.6927059891173489,83346,631,0.5298777347336364,45261372,94651,95282,177997,/well/papiez/users/hri611/python/nnUNet_results/Dataset219_PETCT/nnUNetTrainer_probabilisticOversampling_033__nnUNetPlans__3d_fullres/crossval_results_folds_0_1_2/PETCT_92c5c944a5_07152002.nii.gz,/well/papiez/users/hri611/python/nnUnet_raw/Dataset219_PETCT/labelsTr/PETCT_92c5c944a5_07152002.nii.gz,0.6927059891173489,0.012441020965576172,14.65552269744873
297,0.6161137440758294,0,648,0.4452054794520548,49758832,520,1168,520,/well/papiez/users/hri611/python/nnUNet_results/Dataset219_PETCT/nnUNetTrainer_probabilisticOversampling_033__nnUNetPlans__3d_fullres/crossval_results_folds_0_1_2/PETCT_94962fe878_06012007.nii.gz,/well/papiez/users/hri611/python/nnUnet_raw/Dataset219_PETCT/labelsTr/PETCT_94962fe878_06012007.nii.gz,0.6161137440758294,7.078940929412842,0.0
298,0.43478260869565216,49,42,0.2777777777777778,102719874,35,77,84,/well/papiez/users/hri611/python/nnUNet_results/Dataset219_PETCT/nnUNetTrainer_probabilisticOversampling_033__nnUNetPlans__3d_fullres/crossval_results_folds_0_1_2/PETCT_94cc0dac49_03092007.nii.gz,/well/papiez/users/hri611/python/nnUnet_raw/Dataset219_PETCT/labelsTr/PETCT_94cc0dac49_03092007.nii.gz,0.43478260869565216,0.5225228805541993,0.0
299,0.0,0,133,0.0,50879867,0,133,0,/well/papiez/users/hri611/python/nnUNet_results/Dataset219_PETCT/nnUNetTrainer_probabilisticOversampling_033__nnUNetPlans__3d_fullres/crossval_results_folds_0_1_2/PETCT_94cc0dac49_03102006.nii.gz,/well/papiez/users/hri611/python/nnUnet_raw/Dataset219_PETCT/labelsTr/PETCT_94cc0dac49_03102006.nii.gz,0.0,1.6546557884216309,0.0
300,0.0,0,48,0.0,45439952,0,48,0,/well/papiez/users/hri611/python/nnUNet_results/Dataset219_PETCT/nnUNetTrainer_probabilisticOversampling_033__nnUNetPlans__3d_fullres/crossval_results_folds_0_1_2/PETCT_956520090b_11012003.nii.gz,/well/papiez/users/hri611/python/nnUnet_raw/Dataset219_PETCT/labelsTr/PETCT_956520090b_11012003.nii.gz,0.0,0.5971690063476562,0.0
301,0.16716417910447762,102,177,0.09120521172638436,85599693,28,205,130,/well/papiez/users/hri611/python/nnUNet_results/Dataset219_PETCT/nnUNetTrainer_probabilisticOversampling_033__nnUNetPlans__3d_fullres/crossval_results_folds_0_1_2/PETCT_95efdaba3c_10112003.nii.gz,/well/papiez/users/hri611/python/nnUnet_raw/Dataset219_PETCT/labelsTr/PETCT_95efdaba3c_10112003.nii.gz,0.16716417910447762,2.0776505012512207,1.2689841384887695
302,0.0,0,9,0.0,58879991,0,9,0,/well/papiez/users/hri611/python/nnUNet_results/Dataset219_PETCT/nnUNetTrainer_probabilisticOversampling_033__nnUNetPlans__3d_fullres/crossval_results_folds_0_1_2/PETCT_960c5f4262_01162003.nii.gz,/well/papiez/users/hri611/python/nnUnet_raw/Dataset219_PETCT/labelsTr/PETCT_960c5f4262_01162003.nii.gz,0.0,0.11196918869018554,0.0
303,0.0,0,167,0.0,52159833,0,167,0,/well/papiez/users/hri611/python/nnUNet_results/Dataset219_PETCT/nnUNetTrainer_probabilisticOversampling_033__nnUNetPlans__3d_fullres/crossval_results_folds_0_1_2/PETCT_960c5f4262_02252005.nii.gz,/well/papiez/users/hri611/python/nnUnet_raw/Dataset219_PETCT/labelsTr/PETCT_960c5f4262_02252005.nii.gz,0.0,2.0776505012512207,0.0
304,0.9334428310127291,3007,2342,0.875192496150077,45397142,37509,39851,40516,/well/papiez/users/hri611/python/nnUNet_results/Dataset219_PETCT/nnUNetTrainer_probabilisticOversampling_033__nnUNetPlans__3d_fullres/crossval_results_folds_0_1_2/PETCT_97320b0b58_04172005.nii.gz,/well/papiez/users/hri611/python/nnUnet_raw/Dataset219_PETCT/labelsTr/PETCT_97320b0b58_04172005.nii.gz,0.9334428310127291,3.844275478363037,1.0201637191772461
305,0.0,0,7646,0.0,42872354,0,7646,0,/well/papiez/users/hri611/python/nnUNet_results/Dataset219_PETCT/nnUNetTrainer_probabilisticOversampling_033__nnUNetPlans__3d_fullres/crossval_results_folds_0_1_2/PETCT_97320b0b58_07282005.nii.gz,/well/papiez/users/hri611/python/nnUnet_raw/Dataset219_PETCT/labelsTr/PETCT_97320b0b58_07282005.nii.gz,0.0,95.1240463027954,0.0
306,0.8923421183490801,4941,1987,0.805611672278339,45404360,28712,30699,33653,/well/papiez/users/hri611/python/nnUNet_results/Dataset219_PETCT/nnUNetTrainer_probabilisticOversampling_033__nnUNetPlans__3d_fullres/crossval_results_folds_0_1_2/PETCT_9775598501_05042001.nii.gz,/well/papiez/users/hri611/python/nnUnet_raw/Dataset219_PETCT/labelsTr/PETCT_9775598501_05042001.nii.gz,0.8923421183490801,1.3187482223510743,4.93908532333374
307,0.9030206677265501,183,61,0.8231884057971014,88158620,1136,1197,1319,/well/papiez/users/hri611/python/nnUNet_results/Dataset219_PETCT/nnUNetTrainer_probabilisticOversampling_033__nnUNetPlans__3d_fullres/crossval_results_folds_0_1_2/PETCT_979f9c3dba_06222006.nii.gz,/well/papiez/users/hri611/python/nnUnet_raw/Dataset219_PETCT/labelsTr/PETCT_979f9c3dba_06222006.nii.gz,0.9030206677265501,0.0,0.0
308,0.0,0,163,0.0,52159837,0,163,0,/well/papiez/users/hri611/python/nnUNet_results/Dataset219_PETCT/nnUNetTrainer_probabilisticOversampling_033__nnUNetPlans__3d_fullres/crossval_results_folds_0_1_2/PETCT_9860ffe82d_11192004.nii.gz,/well/papiez/users/hri611/python/nnUnet_raw/Dataset219_PETCT/labelsTr/PETCT_9860ffe82d_11192004.nii.gz,0.0,2.027886417388916,0.0
309,0.910700995927651,9768,911,0.8360431731994534,45374867,54454,55365,64222,/well/papiez/users/hri611/python/nnUNet_results/Dataset219_PETCT/nnUNetTrainer_probabilisticOversampling_033__nnUNetPlans__3d_fullres/crossval_results_folds_0_1_2/PETCT_98c6af8b90_05262003.nii.gz,/well/papiez/users/hri611/python/nnUnet_raw/Dataset219_PETCT/labelsTr/PETCT_98c6af8b90_05262003.nii.gz,0.910700995927651,0.21149735641479492,0.0
310,0.0,0,720,0.0,52159280,0,720,0,/well/papiez/users/hri611/python/nnUNet_results/Dataset219_PETCT/nnUNetTrainer_probabilisticOversampling_033__nnUNetPlans__3d_fullres/crossval_results_folds_0_1_2/PETCT_98cd91d44e_09062003.nii.gz,/well/papiez/users/hri611/python/nnUnet_raw/Dataset219_PETCT/labelsTr/PETCT_98cd91d44e_09062003.nii.gz,0.0,8.957535095214844,0.0
311,0.0,0,237,0.0,58879763,0,237,0,/well/papiez/users/hri611/python/nnUNet_results/Dataset219_PETCT/nnUNetTrainer_probabilisticOversampling_033__nnUNetPlans__3d_fullres/crossval_results_folds_0_1_2/PETCT_9902caa7ec_08132006.nii.gz,/well/papiez/users/hri611/python/nnUnet_raw/Dataset219_PETCT/labelsTr/PETCT_9902caa7ec_08132006.nii.gz,0.0,2.9485219688415527,0.0
312,,0,0,,48160000,0,0,0,/well/papiez/users/hri611/python/nnUNet_results/Dataset219_PETCT/nnUNetTrainer_probabilisticOversampling_033__nnUNetPlans__3d_fullres/crossval_results_folds_0_1_2/PETCT_9a2bfe901f_08062005.nii.gz,/well/papiez/users/hri611/python/nnUnet_raw/Dataset219_PETCT/labelsTr/PETCT_9a2bfe901f_08062005.nii.gz,,0.0,0.0
313,0.8772267252827769,571,2110,0.7813035320988662,45427741,9578,11688,10149,/well/papiez/users/hri611/python/nnUNet_results/Dataset219_PETCT/nnUNetTrainer_probabilisticOversampling_033__nnUNetPlans__3d_fullres/crossval_results_folds_0_1_2/PETCT_9a2c6e618a_02142000.nii.gz,/well/papiez/users/hri611/python/nnUnet_raw/Dataset219_PETCT/labelsTr/PETCT_9a2c6e618a_02142000.nii.gz,0.8772267252827769,0.9330765724182128,0.4105536918640137
314,0.0,0,1,0.0,45439999,0,1,0,/well/papiez/users/hri611/python/nnUNet_results/Dataset219_PETCT/nnUNetTrainer_probabilisticOversampling_033__nnUNetPlans__3d_fullres/crossval_results_folds_0_1_2/PETCT_9a418f3b3a_05112003.nii.gz,/well/papiez/users/hri611/python/nnUnet_raw/Dataset219_PETCT/labelsTr/PETCT_9a418f3b3a_05112003.nii.gz,0.0,0.012441020965576172,0.0
315,0.0,0,396,0.0,51679604,0,396,0,/well/papiez/users/hri611/python/nnUNet_results/Dataset219_PETCT/nnUNetTrainer_probabilisticOversampling_033__nnUNetPlans__3d_fullres/crossval_results_folds_0_1_2/PETCT_9a66a81ad1_05132006.nii.gz,/well/papiez/users/hri611/python/nnUnet_raw/Dataset219_PETCT/labelsTr/PETCT_9a66a81ad1_05132006.nii.gz,0.0,4.926644302368164,0.0
316,0.0,0,1,0.0,52959999,0,1,0,/well/papiez/users/hri611/python/nnUNet_results/Dataset219_PETCT/nnUNetTrainer_probabilisticOversampling_033__nnUNetPlans__3d_fullres/crossval_results_folds_0_1_2/PETCT_9a66a81ad1_10212005.nii.gz,/well/papiez/users/hri611/python/nnUnet_raw/Dataset219_PETCT/labelsTr/PETCT_9a66a81ad1_10212005.nii.gz,0.0,0.012441020965576172,0.0
317,0.0,0,7977,0.0,105752023,0,7977,0,/well/papiez/users/hri611/python/nnUNet_results/Dataset219_PETCT/nnUNetTrainer_probabilisticOversampling_033__nnUNetPlans__3d_fullres/crossval_results_folds_0_1_2/PETCT_9a66a81ad1_10312004.nii.gz,/well/papiez/users/hri611/python/nnUnet_raw/Dataset219_PETCT/labelsTr/PETCT_9a66a81ad1_10312004.nii.gz,0.0,99.24202424240111,0.0
318,0.0,0,666,0.0,52159334,0,666,0,/well/papiez/users/hri611/python/nnUNet_results/Dataset219_PETCT/nnUNetTrainer_probabilisticOversampling_033__nnUNetPlans__3d_fullres/crossval_results_folds_0_1_2/PETCT_9a83943958_08032003.nii.gz,/well/papiez/users/hri611/python/nnUnet_raw/Dataset219_PETCT/labelsTr/PETCT_9a83943958_08032003.nii.gz,0.0,8.28571996307373,0.0
319,0.7413439315722401,6949,5026,0.5889964305326744,52130864,17161,22187,24110,/well/papiez/users/hri611/python/nnUNet_results/Dataset219_PETCT/nnUNetTrainer_probabilisticOversampling_033__nnUNetPlans__3d_fullres/crossval_results_folds_0_1_2/PETCT_9aa97cf103_07182004.nii.gz,/well/papiez/users/hri611/python/nnUnet_raw/Dataset219_PETCT/labelsTr/PETCT_9aa97cf103_07182004.nii.gz,0.7413439315722401,33.25484904098511,1.3809533271789551
320,0.8104956268221575,61,199,0.6813725490196079,52159184,556,755,617,/well/papiez/users/hri611/python/nnUNet_results/Dataset219_PETCT/nnUNetTrainer_probabilisticOversampling_033__nnUNetPlans__3d_fullres/crossval_results_folds_0_1_2/PETCT_9abb9583ec_05302002.nii.gz,/well/papiez/users/hri611/python/nnUnet_raw/Dataset219_PETCT/labelsTr/PETCT_9abb9583ec_05302002.nii.gz,0.8104956268221575,0.37323062896728515,0.1368512306213379
321,0.0,0,90,0.0,52159910,0,90,0,/well/papiez/users/hri611/python/nnUNet_results/Dataset219_PETCT/nnUNetTrainer_probabilisticOversampling_033__nnUNetPlans__3d_fullres/crossval_results_folds_0_1_2/PETCT_9ad7dffae6_05222003.nii.gz,/well/papiez/users/hri611/python/nnUnet_raw/Dataset219_PETCT/labelsTr/PETCT_9ad7dffae6_05222003.nii.gz,0.0,1.1196918869018555,0.0
322,0.0,0,61,0.0,52159939,0,61,0,/well/papiez/users/hri611/python/nnUNet_results/Dataset219_PETCT/nnUNetTrainer_probabilisticOversampling_033__nnUNetPlans__3d_fullres/crossval_results_folds_0_1_2/PETCT_9b1bb2165a_10132002.nii.gz,/well/papiez/users/hri611/python/nnUnet_raw/Dataset219_PETCT/labelsTr/PETCT_9b1bb2165a_10132002.nii.gz,0.0,0.7589022789001465,0.0
323,,0,0,,99040000,0,0,0,/well/papiez/users/hri611/python/nnUNet_results/Dataset219_PETCT/nnUNetTrainer_probabilisticOversampling_033__nnUNetPlans__3d_fullres/crossval_results_folds_0_1_2/PETCT_9c68e484a7_08142003.nii.gz,/well/papiez/users/hri611/python/nnUnet_raw/Dataset219_PETCT/labelsTr/PETCT_9c68e484a7_08142003.nii.gz,,0.0,0.0
324,0.922174130181455,189,1681,0.8555873040389219,45427051,11079,12760,11268,/well/papiez/users/hri611/python/nnUNet_results/Dataset219_PETCT/nnUNetTrainer_probabilisticOversampling_033__nnUNetPlans__3d_fullres/crossval_results_folds_0_1_2/PETCT_9c8842d12e_01252004.nii.gz,/well/papiez/users/hri611/python/nnUnet_raw/Dataset219_PETCT/labelsTr/PETCT_9c8842d12e_01252004.nii.gz,0.922174130181455,1.3809533271789551,0.04976408386230469
325,0.7367972223914235,4148,173,0.5832770758993152,52149631,6048,6221,10196,/well/papiez/users/hri611/python/nnUNet_results/Dataset219_PETCT/nnUNetTrainer_probabilisticOversampling_033__nnUNetPlans__3d_fullres/crossval_results_folds_0_1_2/PETCT_9c9a347388_09092000.nii.gz,/well/papiez/users/hri611/python/nnUnet_raw/Dataset219_PETCT/labelsTr/PETCT_9c9a347388_09092000.nii.gz,0.7367972223914235,0.0,8.335484046936035
326,0.3983487320621191,15157,146,0.24871127694044873,52139631,5066,5212,20223,/well/papiez/users/hri611/python/nnUNet_results/Dataset219_PETCT/nnUNetTrainer_probabilisticOversampling_033__nnUNetPlans__3d_fullres/crossval_results_folds_0_1_2/PETCT_9da159b835_03232002.nii.gz,/well/papiez/users/hri611/python/nnUnet_raw/Dataset219_PETCT/labelsTr/PETCT_9da159b835_03232002.nii.gz,0.3983487320621191,0.37323062896728515,55.54915861129761
327,0.0,0,3931,0.0,52156069,0,3931,0,/well/papiez/users/hri611/python/nnUNet_results/Dataset219_PETCT/nnUNetTrainer_probabilisticOversampling_033__nnUNetPlans__3d_fullres/crossval_results_folds_0_1_2/PETCT_9e864bb710_09142003.nii.gz,/well/papiez/users/hri611/python/nnUnet_raw/Dataset219_PETCT/labelsTr/PETCT_9e864bb710_09142003.nii.gz,0.0,48.90565341567993,0.0
328,0.9396009135455647,3360,2273,0.8860823491344443,52110552,43815,46088,47175,/well/papiez/users/hri611/python/nnUNet_results/Dataset219_PETCT/nnUNetTrainer_probabilisticOversampling_033__nnUNetPlans__3d_fullres/crossval_results_folds_0_1_2/PETCT_9f206193d3_04072003.nii.gz,/well/papiez/users/hri611/python/nnUnet_raw/Dataset219_PETCT/labelsTr/PETCT_9f206193d3_04072003.nii.gz,0.9396009135455647,0.6966971740722656,0.58472798538208
329,0.0,0,88,0.0,48159912,0,88,0,/well/papiez/users/hri611/python/nnUNet_results/Dataset219_PETCT/nnUNetTrainer_probabilisticOversampling_033__nnUNetPlans__3d_fullres/crossval_results_folds_0_1_2/PETCT_9f491f1481_02122006.nii.gz,/well/papiez/users/hri611/python/nnUnet_raw/Dataset219_PETCT/labelsTr/PETCT_9f491f1481_02122006.nii.gz,0.0,1.094809844970703,0.0
330,,0,0,,52160000,0,0,0,/well/papiez/users/hri611/python/nnUNet_results/Dataset219_PETCT/nnUNetTrainer_probabilisticOversampling_033__nnUNetPlans__3d_fullres/crossval_results_folds_0_1_2/PETCT_9f6e8b1b43_11162002.nii.gz,/well/papiez/users/hri611/python/nnUnet_raw/Dataset219_PETCT/labelsTr/PETCT_9f6e8b1b43_11162002.nii.gz,,0.0,0.0
331,0.2235142118863049,37,1165,0.12581818181818183,52158625,173,1338,210,/well/papiez/users/hri611/python/nnUNet_results/Dataset219_PETCT/nnUNetTrainer_probabilisticOversampling_033__nnUNetPlans__3d_fullres/crossval_results_folds_0_1_2/PETCT_9f7c68f5ca_12212001.nii.gz,/well/papiez/users/hri611/python/nnUnet_raw/Dataset219_PETCT/labelsTr/PETCT_9f7c68f5ca_12212001.nii.gz,0.2235142118863049,13.809533271789551,0.0
332,0.8545603944124898,329,25,0.7460545193687231,49758606,1040,1065,1369,/well/papiez/users/hri611/python/nnUNet_results/Dataset219_PETCT/nnUNetTrainer_probabilisticOversampling_033__nnUNetPlans__3d_fullres/crossval_results_folds_0_1_2/PETCT_9ffd8409b3_07152005.nii.gz,/well/papiez/users/hri611/python/nnUnet_raw/Dataset219_PETCT/labelsTr/PETCT_9ffd8409b3_07152005.nii.gz,0.8545603944124898,0.1368512306213379,1.7666249771118163
333,,0,0,,51040000,0,0,0,/well/papiez/users/hri611/python/nnUNet_results/Dataset219_PETCT/nnUNetTrainer_probabilisticOversampling_033__nnUNetPlans__3d_fullres/crossval_results_folds_0_1_2/PETCT_a09210d96b_12112005.nii.gz,/well/papiez/users/hri611/python/nnUnet_raw/Dataset219_PETCT/labelsTr/PETCT_a09210d96b_12112005.nii.gz,,0.0,0.0
334,0.9075460676543997,878,2604,0.8307408127552013,52139428,17090,19694,17968,/well/papiez/users/hri611/python/nnUNet_results/Dataset219_PETCT/nnUNetTrainer_probabilisticOversampling_033__nnUNetPlans__3d_fullres/crossval_results_folds_0_1_2/PETCT_a0c4dc1ef1_01192003.nii.gz,/well/papiez/users/hri611/python/nnUnet_raw/Dataset219_PETCT/labelsTr/PETCT_a0c4dc1ef1_01192003.nii.gz,0.9075460676543997,10.17675514984131,3.6576601638793944
335,,0,0,,47200000,0,0,0,/well/papiez/users/hri611/python/nnUNet_results/Dataset219_PETCT/nnUNetTrainer_probabilisticOversampling_033__nnUNetPlans__3d_fullres/crossval_results_folds_0_1_2/PETCT_a19c2a0c65_03052006.nii.gz,/well/papiez/users/hri611/python/nnUnet_raw/Dataset219_PETCT/labelsTr/PETCT_a19c2a0c65_03052006.nii.gz,,0.0,0.0
336,0.4372201108663552,90710,2286,0.27977075588599754,52030880,36124,38410,126834,/well/papiez/users/hri611/python/nnUNet_results/Dataset219_PETCT/nnUNetTrainer_probabilisticOversampling_033__nnUNetPlans__3d_fullres/crossval_results_folds_0_1_2/PETCT_a19ef8e0d2_12261999.nii.gz,/well/papiez/users/hri611/python/nnUnet_raw/Dataset219_PETCT/labelsTr/PETCT_a19ef8e0d2_12261999.nii.gz,0.4372201108663552,0.721579216003418,0.1368512306213379
337,0.0,0,31196,0.0,85568804,0,31196,0,/well/papiez/users/hri611/python/nnUNet_results/Dataset219_PETCT/nnUNetTrainer_probabilisticOversampling_033__nnUNetPlans__3d_fullres/crossval_results_folds_0_1_2/PETCT_a1d93ebc74_09012003.nii.gz,/well/papiez/users/hri611/python/nnUnet_raw/Dataset219_PETCT/labelsTr/PETCT_a1d93ebc74_09012003.nii.gz,0.0,388.1100900421142,0.0
338,0.9263657957244655,89,35,0.8628318584070797,52159096,780,815,869,/well/papiez/users/hri611/python/nnUNet_results/Dataset219_PETCT/nnUNetTrainer_probabilisticOversampling_033__nnUNetPlans__3d_fullres/crossval_results_folds_0_1_2/PETCT_a1db71e797_03252005.nii.gz,/well/papiez/users/hri611/python/nnUnet_raw/Dataset219_PETCT/labelsTr/PETCT_a1db71e797_03252005.nii.gz,0.9263657957244655,0.2861434822082519,0.0
339,0.0,0,474,0.0,91679526,0,474,0,/well/papiez/users/hri611/python/nnUNet_results/Dataset219_PETCT/nnUNetTrainer_probabilisticOversampling_033__nnUNetPlans__3d_fullres/crossval_results_folds_0_1_2/PETCT_a22ec7f62b_06302007.nii.gz,/well/papiez/users/hri611/python/nnUnet_raw/Dataset219_PETCT/labelsTr/PETCT_a22ec7f62b_06302007.nii.gz,0.0,5.897043937683105,0.0
340,0.0,0,13,0.0,72159987,0,13,0,/well/papiez/users/hri611/python/nnUNet_results/Dataset219_PETCT/nnUNetTrainer_probabilisticOversampling_033__nnUNetPlans__3d_fullres/crossval_results_folds_0_1_2/PETCT_a2676f03c0_05092003.nii.gz,/well/papiez/users/hri611/python/nnUnet_raw/Dataset219_PETCT/labelsTr/PETCT_a2676f03c0_05092003.nii.gz,0.0,0.16173327255249023,0.0
341,0.0,0,29,0.0,48479971,0,29,0,/well/papiez/users/hri611/python/nnUNet_results/Dataset219_PETCT/nnUNetTrainer_probabilisticOversampling_033__nnUNetPlans__3d_fullres/crossval_results_folds_0_1_2/PETCT_a29cae0316_06292006.nii.gz,/well/papiez/users/hri611/python/nnUnet_raw/Dataset219_PETCT/labelsTr/PETCT_a29cae0316_06292006.nii.gz,0.0,0.360789608001709,0.0
342,0.9341627786417833,13,114,0.8764591439688716,52158972,901,1015,914,/well/papiez/users/hri611/python/nnUNet_results/Dataset219_PETCT/nnUNetTrainer_probabilisticOversampling_033__nnUNetPlans__3d_fullres/crossval_results_folds_0_1_2/PETCT_a2a68bbe97_08212003.nii.gz,/well/papiez/users/hri611/python/nnUnet_raw/Dataset219_PETCT/labelsTr/PETCT_a2a68bbe97_08212003.nii.gz,0.9341627786417833,0.1368512306213379,0.0
343,0.0,0,11927,0.0,45428073,0,11927,0,/well/papiez/users/hri611/python/nnUNet_results/Dataset219_PETCT/nnUNetTrainer_probabilisticOversampling_033__nnUNetPlans__3d_fullres/crossval_results_folds_0_1_2/PETCT_a37c4e231f_12132002.nii.gz,/well/papiez/users/hri611/python/nnUnet_raw/Dataset219_PETCT/labelsTr/PETCT_a37c4e231f_12132002.nii.gz,0.0,148.384057056427,0.0
344,0.8451723730969459,11452,355,0.7318601957622692,45395967,32226,32581,43678,/well/papiez/users/hri611/python/nnUNet_results/Dataset219_PETCT/nnUNetTrainer_probabilisticOversampling_033__nnUNetPlans__3d_fullres/crossval_results_folds_0_1_2/PETCT_a37da9e85d_03022002.nii.gz,/well/papiez/users/hri611/python/nnUnet_raw/Dataset219_PETCT/labelsTr/PETCT_a37da9e85d_03022002.nii.gz,0.8451723730969459,0.0,6.95453071975708
345,0.8641666144952942,5966,543,0.7608216359226868,52132786,20705,21248,26671,/well/papiez/users/hri611/python/nnUNet_results/Dataset219_PETCT/nnUNetTrainer_probabilisticOversampling_033__nnUNetPlans__3d_fullres/crossval_results_folds_0_1_2/PETCT_a3df01d3a3_10052002.nii.gz,/well/papiez/users/hri611/python/nnUnet_raw/Dataset219_PETCT/labelsTr/PETCT_a3df01d3a3_10052002.nii.gz,0.8641666144952942,0.5100818595886231,6.170746398925781
346,0.2738669238187078,604,7679,0.15865921787709497,52150155,1562,9241,2166,/well/papiez/users/hri611/python/nnUNet_results/Dataset219_PETCT/nnUNetTrainer_probabilisticOversampling_033__nnUNetPlans__3d_fullres/crossval_results_folds_0_1_2/PETCT_a471649d35_05062002.nii.gz,/well/papiez/users/hri611/python/nnUnet_raw/Dataset219_PETCT/labelsTr/PETCT_a471649d35_05062002.nii.gz,0.2738669238187078,94.47711321258545,0.6469330902099609
347,0.0,0,48,0.0,49119952,0,48,0,/well/papiez/users/hri611/python/nnUNet_results/Dataset219_PETCT/nnUNetTrainer_probabilisticOversampling_033__nnUNetPlans__3d_fullres/crossval_results_folds_0_1_2/PETCT_a4a66c4fa7_07072006.nii.gz,/well/papiez/users/hri611/python/nnUnet_raw/Dataset219_PETCT/labelsTr/PETCT_a4a66c4fa7_07072006.nii.gz,0.0,0.5971690063476562,0.0
348,0.0,0,23507,0.0,45416493,0,23507,0,/well/papiez/users/hri611/python/nnUNet_results/Dataset219_PETCT/nnUNetTrainer_probabilisticOversampling_033__nnUNetPlans__3d_fullres/crossval_results_folds_0_1_2/PETCT_a4ccc397a9_11302002.nii.gz,/well/papiez/users/hri611/python/nnUnet_raw/Dataset219_PETCT/labelsTr/PETCT_a4ccc397a9_11302002.nii.gz,0.0,292.45107983779906,0.0
349,0.8018794048551292,152,101,0.6692810457516339,58879235,512,613,664,/well/papiez/users/hri611/python/nnUNet_results/Dataset219_PETCT/nnUNetTrainer_probabilisticOversampling_033__nnUNetPlans__3d_fullres/crossval_results_folds_0_1_2/PETCT_a4cd2b10de_12292001.nii.gz,/well/papiez/users/hri611/python/nnUnet_raw/Dataset219_PETCT/labelsTr/PETCT_a4cd2b10de_12292001.nii.gz,0.8018794048551292,0.6842561531066894,0.09952816772460937
350,0.9433723238038935,212,1129,0.892814323395412,92307489,11170,12299,11382,/well/papiez/users/hri611/python/nnUNet_results/Dataset219_PETCT/nnUNetTrainer_probabilisticOversampling_033__nnUNetPlans__3d_fullres/crossval_results_folds_0_1_2/PETCT_a61d8768d0_03262004.nii.gz,/well/papiez/users/hri611/python/nnUnet_raw/Dataset219_PETCT/labelsTr/PETCT_a61d8768d0_03262004.nii.gz,0.9433723238038935,1.9781223335266114,0.0
351,0.0,0,3341,0.0,52156659,0,3341,0,/well/papiez/users/hri611/python/nnUNet_results/Dataset219_PETCT/nnUNetTrainer_probabilisticOversampling_033__nnUNetPlans__3d_fullres/crossval_results_folds_0_1_2/PETCT_a627fc68a1_02142003.nii.gz,/well/papiez/users/hri611/python/nnUnet_raw/Dataset219_PETCT/labelsTr/PETCT_a627fc68a1_02142003.nii.gz,0.0,41.56545104598999,0.0
352,0.07347597900686315,0,4590,0.038139145012573344,99035228,182,4772,182,/well/papiez/users/hri611/python/nnUNet_results/Dataset219_PETCT/nnUNetTrainer_probabilisticOversampling_033__nnUNetPlans__3d_fullres/crossval_results_folds_0_1_2/PETCT_a86b2dc6ce_10142002.nii.gz,/well/papiez/users/hri611/python/nnUnet_raw/Dataset219_PETCT/labelsTr/PETCT_a86b2dc6ce_10142002.nii.gz,0.07347597900686315,54.91466654205322,0.0
353,0.0,0,22,0.0,45439978,0,22,0,/well/papiez/users/hri611/python/nnUNet_results/Dataset219_PETCT/nnUNetTrainer_probabilisticOversampling_033__nnUNetPlans__3d_fullres/crossval_results_folds_0_1_2/PETCT_a87dda9193_01262003.nii.gz,/well/papiez/users/hri611/python/nnUnet_raw/Dataset219_PETCT/labelsTr/PETCT_a87dda9193_01262003.nii.gz,0.0,0.2737024612426758,0.0
354,0.0,0,226,0.0,52159774,0,226,0,/well/papiez/users/hri611/python/nnUNet_results/Dataset219_PETCT/nnUNetTrainer_probabilisticOversampling_033__nnUNetPlans__3d_fullres/crossval_results_folds_0_1_2/PETCT_a8a5e96821_03112005.nii.gz,/well/papiez/users/hri611/python/nnUnet_raw/Dataset219_PETCT/labelsTr/PETCT_a8a5e96821_03112005.nii.gz,0.0,2.8116707382202146,0.0
355,0.0,0,1423,0.0,46718577,0,1423,0,/well/papiez/users/hri611/python/nnUNet_results/Dataset219_PETCT/nnUNetTrainer_probabilisticOversampling_033__nnUNetPlans__3d_fullres/crossval_results_folds_0_1_2/PETCT_a8a5e96821_09302005.nii.gz,/well/papiez/users/hri611/python/nnUnet_raw/Dataset219_PETCT/labelsTr/PETCT_a8a5e96821_09302005.nii.gz,0.0,17.703572834014892,0.0
356,0.0,0,967,0.0,52159033,0,967,0,/well/papiez/users/hri611/python/nnUNet_results/Dataset219_PETCT/nnUNetTrainer_probabilisticOversampling_033__nnUNetPlans__3d_fullres/crossval_results_folds_0_1_2/PETCT_a90955352e_05162003.nii.gz,/well/papiez/users/hri611/python/nnUnet_raw/Dataset219_PETCT/labelsTr/PETCT_a90955352e_05162003.nii.gz,0.0,12.030467273712159,0.0
357,0.6374947807933194,4097,244,0.4678842853640598,45431842,3817,4061,7914,/well/papiez/users/hri611/python/nnUNet_results/Dataset219_PETCT/nnUNetTrainer_probabilisticOversampling_033__nnUNetPlans__3d_fullres/crossval_results_folds_0_1_2/PETCT_ab1fa26e5e_06232001.nii.gz,/well/papiez/users/hri611/python/nnUnet_raw/Dataset219_PETCT/labelsTr/PETCT_ab1fa26e5e_06232001.nii.gz,0.6374947807933194,0.0,2.052768459320068
358,0.8631822985919334,1117,2896,0.7592970249520153,105743328,12659,15555,13776,/well/papiez/users/hri611/python/nnUNet_results/Dataset219_PETCT/nnUNetTrainer_probabilisticOversampling_033__nnUNetPlans__3d_fullres/crossval_results_folds_0_1_2/PETCT_ab953a5230_11032003.nii.gz,/well/papiez/users/hri611/python/nnUnet_raw/Dataset219_PETCT/labelsTr/PETCT_ab953a5230_11032003.nii.gz,0.8631822985919334,5.760192707061767,3.1724603462219236
359,0.6201464912971568,9129,517,0.44942922374429223,45422480,7874,8391,17003,/well/papiez/users/hri611/python/nnUNet_results/Dataset219_PETCT/nnUNetTrainer_probabilisticOversampling_033__nnUNetPlans__3d_fullres/crossval_results_folds_0_1_2/PETCT_ac11b344b6_11032002.nii.gz,/well/papiez/users/hri611/python/nnUnet_raw/Dataset219_PETCT/labelsTr/PETCT_ac11b344b6_11032002.nii.gz,0.6201464912971568,0.0,2.0652094802856444
360,0.7619614768573658,7963,3629,0.6154586166860175,52129855,18553,22182,26516,/well/papiez/users/hri611/python/nnUNet_results/Dataset219_PETCT/nnUNetTrainer_probabilisticOversampling_033__nnUNetPlans__3d_fullres/crossval_results_folds_0_1_2/PETCT_ad7c6a4a58_03282003.nii.gz,/well/papiez/users/hri611/python/nnUnet_raw/Dataset219_PETCT/labelsTr/PETCT_ad7c6a4a58_03282003.nii.gz,0.7619614768573658,1.7541839561462402,10.898334365844727
361,0.0,0,599,0.0,52799401,0,599,0,/well/papiez/users/hri611/python/nnUNet_results/Dataset219_PETCT/nnUNetTrainer_probabilisticOversampling_033__nnUNetPlans__3d_fullres/crossval_results_folds_0_1_2/PETCT_ad99263bec_01292006.nii.gz,/well/papiez/users/hri611/python/nnUnet_raw/Dataset219_PETCT/labelsTr/PETCT_ad99263bec_01292006.nii.gz,0.0,7.452171558380127,0.0
362,0.0,0,188086,0.0,51971914,0,188086,0,/well/papiez/users/hri611/python/nnUNet_results/Dataset219_PETCT/nnUNetTrainer_probabilisticOversampling_033__nnUNetPlans__3d_fullres/crossval_results_folds_0_1_2/PETCT_adc49adb3d_09222002.nii.gz,/well/papiez/users/hri611/python/nnUnet_raw/Dataset219_PETCT/labelsTr/PETCT_adc49adb3d_09222002.nii.gz,0.0,2339.98186933136,0.0
363,0.917671197743011,1,1925,0.8478672985781991,45427340,10734,12659,10735,/well/papiez/users/hri611/python/nnUNet_results/Dataset219_PETCT/nnUNetTrainer_probabilisticOversampling_033__nnUNetPlans__3d_fullres/crossval_results_folds_0_1_2/PETCT_ae3074834a_07262003.nii.gz,/well/papiez/users/hri611/python/nnUnet_raw/Dataset219_PETCT/labelsTr/PETCT_ae3074834a_07262003.nii.gz,0.917671197743011,0.04976408386230469,0.0
364,0.0,0,4,0.0,52159996,0,4,0,/well/papiez/users/hri611/python/nnUNet_results/Dataset219_PETCT/nnUNetTrainer_probabilisticOversampling_033__nnUNetPlans__3d_fullres/crossval_results_folds_0_1_2/PETCT_ae46202abb_02282003.nii.gz,/well/papiez/users/hri611/python/nnUnet_raw/Dataset219_PETCT/labelsTr/PETCT_ae46202abb_02282003.nii.gz,0.0,0.04976408386230469,0.0
365,0.0,0,66,0.0,38719934,0,66,0,/well/papiez/users/hri611/python/nnUNet_results/Dataset219_PETCT/nnUNetTrainer_probabilisticOversampling_033__nnUNetPlans__3d_fullres/crossval_results_folds_0_1_2/PETCT_ae4dcc5dd3_10082004.nii.gz,/well/papiez/users/hri611/python/nnUnet_raw/Dataset219_PETCT/labelsTr/PETCT_ae4dcc5dd3_10082004.nii.gz,0.0,0.8211073837280274,0.0
366,0.0,0,1374,0.0,52158626,0,1374,0,/well/papiez/users/hri611/python/nnUNet_results/Dataset219_PETCT/nnUNetTrainer_probabilisticOversampling_033__nnUNetPlans__3d_fullres/crossval_results_folds_0_1_2/PETCT_ae6a37a9d6_02102005.nii.gz,/well/papiez/users/hri611/python/nnUnet_raw/Dataset219_PETCT/labelsTr/PETCT_ae6a37a9d6_02102005.nii.gz,0.0,17.09396280670166,0.0
367,0.0,0,2030,0.0,48157970,0,2030,0,/well/papiez/users/hri611/python/nnUNet_results/Dataset219_PETCT/nnUNetTrainer_probabilisticOversampling_033__nnUNetPlans__3d_fullres/crossval_results_folds_0_1_2/PETCT_ae6a37a9d6_08182005.nii.gz,/well/papiez/users/hri611/python/nnUnet_raw/Dataset219_PETCT/labelsTr/PETCT_ae6a37a9d6_08182005.nii.gz,0.0,25.25527256011963,0.0
368,0.0,0,133,0.0,52159867,0,133,0,/well/papiez/users/hri611/python/nnUNet_results/Dataset219_PETCT/nnUNetTrainer_probabilisticOversampling_033__nnUNetPlans__3d_fullres/crossval_results_folds_0_1_2/PETCT_ae6a37a9d6_09132003.nii.gz,/well/papiez/users/hri611/python/nnUnet_raw/Dataset219_PETCT/labelsTr/PETCT_ae6a37a9d6_09132003.nii.gz,0.0,1.6546557884216309,0.0
369,0.0,0,68,0.0,52159932,0,68,0,/well/papiez/users/hri611/python/nnUNet_results/Dataset219_PETCT/nnUNetTrainer_probabilisticOversampling_033__nnUNetPlans__3d_fullres/crossval_results_folds_0_1_2/PETCT_ae6a37a9d6_09152002.nii.gz,/well/papiez/users/hri611/python/nnUnet_raw/Dataset219_PETCT/labelsTr/PETCT_ae6a37a9d6_09152002.nii.gz,0.0,0.8459894256591797,0.0
370,0.0,0,12,0.0,52159988,0,12,0,/well/papiez/users/hri611/python/nnUNet_results/Dataset219_PETCT/nnUNetTrainer_probabilisticOversampling_033__nnUNetPlans__3d_fullres/crossval_results_folds_0_1_2/PETCT_ae96f738c0_09112003.nii.gz,/well/papiez/users/hri611/python/nnUnet_raw/Dataset219_PETCT/labelsTr/PETCT_ae96f738c0_09112003.nii.gz,0.0,0.14929225158691406,0.0
371,,0,0,,99040000,0,0,0,/well/papiez/users/hri611/python/nnUNet_results/Dataset219_PETCT/nnUNetTrainer_probabilisticOversampling_033__nnUNetPlans__3d_fullres/crossval_results_folds_0_1_2/PETCT_af119148fe_02112005.nii.gz,/well/papiez/users/hri611/python/nnUnet_raw/Dataset219_PETCT/labelsTr/PETCT_af119148fe_02112005.nii.gz,,0.0,0.0
372,,0,0,,99040000,0,0,0,/well/papiez/users/hri611/python/nnUNet_results/Dataset219_PETCT/nnUNetTrainer_probabilisticOversampling_033__nnUNetPlans__3d_fullres/crossval_results_folds_0_1_2/PETCT_af119148fe_12052002.nii.gz,/well/papiez/users/hri611/python/nnUnet_raw/Dataset219_PETCT/labelsTr/PETCT_af119148fe_12052002.nii.gz,,0.0,0.0
373,0.0,0,1495,0.0,45438505,0,1495,0,/well/papiez/users/hri611/python/nnUNet_results/Dataset219_PETCT/nnUNetTrainer_probabilisticOversampling_033__nnUNetPlans__3d_fullres/crossval_results_folds_0_1_2/PETCT_af547fa618_03112006.nii.gz,/well/papiez/users/hri611/python/nnUnet_raw/Dataset219_PETCT/labelsTr/PETCT_af547fa618_03112006.nii.gz,0.0,18.599326343536376,0.0
374,0.8935409752361502,825,9,0.8075680664513152,99035666,3500,3509,4325,/well/papiez/users/hri611/python/nnUNet_results/Dataset219_PETCT/nnUNetTrainer_probabilisticOversampling_033__nnUNetPlans__3d_fullres/crossval_results_folds_0_1_2/PETCT_af73b85f2c_06192003.nii.gz,/well/papiez/users/hri611/python/nnUnet_raw/Dataset219_PETCT/labelsTr/PETCT_af73b85f2c_06192003.nii.gz,0.8935409752361502,0.0,0.0
375,,0,0,,49440000,0,0,0,/well/papiez/users/hri611/python/nnUNet_results/Dataset219_PETCT/nnUNetTrainer_probabilisticOversampling_033__nnUNetPlans__3d_fullres/crossval_results_folds_0_1_2/PETCT_b0e002e974_03112007.nii.gz,/well/papiez/users/hri611/python/nnUnet_raw/Dataset219_PETCT/labelsTr/PETCT_b0e002e974_03112007.nii.gz,,0.0,0.0
376,,0,0,,52800000,0,0,0,/well/papiez/users/hri611/python/nnUNet_results/Dataset219_PETCT/nnUNetTrainer_probabilisticOversampling_033__nnUNetPlans__3d_fullres/crossval_results_folds_0_1_2/PETCT_b0e002e974_09232005.nii.gz,/well/papiez/users/hri611/python/nnUnet_raw/Dataset219_PETCT/labelsTr/PETCT_b0e002e974_09232005.nii.gz,,0.0,0.0
377,0.8336467343612887,1156,171,0.7147463456577816,52155348,3325,3496,4481,/well/papiez/users/hri611/python/nnUNet_results/Dataset219_PETCT/nnUNetTrainer_probabilisticOversampling_033__nnUNetPlans__3d_fullres/crossval_results_folds_0_1_2/PETCT_b1aa7ce13e_03092003.nii.gz,/well/papiez/users/hri611/python/nnUnet_raw/Dataset219_PETCT/labelsTr/PETCT_b1aa7ce13e_03092003.nii.gz,0.8336467343612887,0.19905633544921875,2.749465633392334
378,0.0,0,3,0.0,50079997,0,3,0,/well/papiez/users/hri611/python/nnUNet_results/Dataset219_PETCT/nnUNetTrainer_probabilisticOversampling_033__nnUNetPlans__3d_fullres/crossval_results_folds_0_1_2/PETCT_b1d6679284_05282007.nii.gz,/well/papiez/users/hri611/python/nnUnet_raw/Dataset219_PETCT/labelsTr/PETCT_b1d6679284_05282007.nii.gz,0.0,0.037323062896728515,0.0
379,0.0,0,6,0.0,45439994,0,6,0,/well/papiez/users/hri611/python/nnUNet_results/Dataset219_PETCT/nnUNetTrainer_probabilisticOversampling_033__nnUNetPlans__3d_fullres/crossval_results_folds_0_1_2/PETCT_b2f82ed4b9_04172003.nii.gz,/well/papiez/users/hri611/python/nnUnet_raw/Dataset219_PETCT/labelsTr/PETCT_b2f82ed4b9_04172003.nii.gz,0.0,0.07464612579345703,0.0
380,0.7876713380097929,6408,7425,0.6497176571877137,45400509,25658,33083,32066,/well/papiez/users/hri611/python/nnUNet_results/Dataset219_PETCT/nnUNetTrainer_probabilisticOversampling_033__nnUNetPlans__3d_fullres/crossval_results_folds_0_1_2/PETCT_b327726c24_08272000.nii.gz,/well/papiez/users/hri611/python/nnUnet_raw/Dataset219_PETCT/labelsTr/PETCT_b327726c24_08272000.nii.gz,0.7876713380097929,40.23426180267334,0.18661531448364257
381,0.6156989744776005,9113,855,0.44477246142705956,52142047,7985,8840,17098,/well/papiez/users/hri611/python/nnUNet_results/Dataset219_PETCT/nnUNetTrainer_probabilisticOversampling_033__nnUNetPlans__3d_fullres/crossval_results_folds_0_1_2/PETCT_b3d4773f85_11042000.nii.gz,/well/papiez/users/hri611/python/nnUnet_raw/Dataset219_PETCT/labelsTr/PETCT_b3d4773f85_11042000.nii.gz,0.6156989744776005,2.525527256011963,13.175041202545167
382,0.0,0,269,0.0,52159731,0,269,0,/well/papiez/users/hri611/python/nnUNet_results/Dataset219_PETCT/nnUNetTrainer_probabilisticOversampling_033__nnUNetPlans__3d_fullres/crossval_results_folds_0_1_2/PETCT_b3e923029c_11212003.nii.gz,/well/papiez/users/hri611/python/nnUnet_raw/Dataset219_PETCT/labelsTr/PETCT_b3e923029c_11212003.nii.gz,0.0,3.34663463973999,0.0
383,0.7391304347826086,0,108,0.5862068965517241,58879739,153,261,153,/well/papiez/users/hri611/python/nnUNet_results/Dataset219_PETCT/nnUNetTrainer_probabilisticOversampling_033__nnUNetPlans__3d_fullres/crossval_results_folds_0_1_2/PETCT_b41bc7c1e5_03122005.nii.gz,/well/papiez/users/hri611/python/nnUnet_raw/Dataset219_PETCT/labelsTr/PETCT_b41bc7c1e5_03122005.nii.gz,0.7391304347826086,0.0,0.0
384,0.0,0,366,0.0,45119634,0,366,0,/well/papiez/users/hri611/python/nnUNet_results/Dataset219_PETCT/nnUNetTrainer_probabilisticOversampling_033__nnUNetPlans__3d_fullres/crossval_results_folds_0_1_2/PETCT_b4247b8ecd_10202006.nii.gz,/well/papiez/users/hri611/python/nnUnet_raw/Dataset219_PETCT/labelsTr/PETCT_b4247b8ecd_10202006.nii.gz,0.0,4.553413673400879,0.0
385,0.0,0,18178,0.0,52141822,0,18178,0,/well/papiez/users/hri611/python/nnUNet_results/Dataset219_PETCT/nnUNetTrainer_probabilisticOversampling_033__nnUNetPlans__3d_fullres/crossval_results_folds_0_1_2/PETCT_b42adab18e_09052003.nii.gz,/well/papiez/users/hri611/python/nnUnet_raw/Dataset219_PETCT/labelsTr/PETCT_b42adab18e_09052003.nii.gz,0.0,226.15287911224365,0.0
386,0.0,0,71,0.0,52159929,0,71,0,/well/papiez/users/hri611/python/nnUNet_results/Dataset219_PETCT/nnUNetTrainer_probabilisticOversampling_033__nnUNetPlans__3d_fullres/crossval_results_folds_0_1_2/PETCT_b4e5c1047c_10102004.nii.gz,/well/papiez/users/hri611/python/nnUnet_raw/Dataset219_PETCT/labelsTr/PETCT_b4e5c1047c_10102004.nii.gz,0.0,0.8833124885559082,0.0
387,0.8208848472463472,123,5136,0.6961871750433276,52142690,12051,17187,12174,/well/papiez/users/hri611/python/nnUNet_results/Dataset219_PETCT/nnUNetTrainer_probabilisticOversampling_033__nnUNetPlans__3d_fullres/crossval_results_folds_0_1_2/PETCT_b509ace2a2_05272002.nii.gz,/well/papiez/users/hri611/python/nnUnet_raw/Dataset219_PETCT/labelsTr/PETCT_b509ace2a2_05272002.nii.gz,0.8208848472463472,1.3933943481445312,0.8584304466247559
388,0.29949238578680204,0,1104,0.1761194029850746,52158660,236,1340,236,/well/papiez/users/hri611/python/nnUNet_results/Dataset219_PETCT/nnUNetTrainer_probabilisticOversampling_033__nnUNetPlans__3d_fullres/crossval_results_folds_0_1_2/PETCT_b510436d83_11102002.nii.gz,/well/papiez/users/hri611/python/nnUnet_raw/Dataset219_PETCT/labelsTr/PETCT_b510436d83_11102002.nii.gz,0.29949238578680204,13.06307201385498,0.0
389,0.9257950530035336,6,15,0.8618421052631579,45439848,131,146,137,/well/papiez/users/hri611/python/nnUNet_results/Dataset219_PETCT/nnUNetTrainer_probabilisticOversampling_033__nnUNetPlans__3d_fullres/crossval_results_folds_0_1_2/PETCT_b510436d83_11142003.nii.gz,/well/papiez/users/hri611/python/nnUnet_raw/Dataset219_PETCT/labelsTr/PETCT_b510436d83_11142003.nii.gz,0.9257950530035336,0.0,0.0
390,,0,0,,55520000,0,0,0,/well/papiez/users/hri611/python/nnUNet_results/Dataset219_PETCT/nnUNetTrainer_probabilisticOversampling_033__nnUNetPlans__3d_fullres/crossval_results_folds_0_1_2/PETCT_b57e1c1f5f_06252006.nii.gz,/well/papiez/users/hri611/python/nnUnet_raw/Dataset219_PETCT/labelsTr/PETCT_b57e1c1f5f_06252006.nii.gz,,0.0,0.0
391,0.9441141498216409,41,53,0.8941441441441441,52799112,794,847,835,/well/papiez/users/hri611/python/nnUNet_results/Dataset219_PETCT/nnUNetTrainer_probabilisticOversampling_033__nnUNetPlans__3d_fullres/crossval_results_folds_0_1_2/PETCT_b5923963ac_02172007.nii.gz,/well/papiez/users/hri611/python/nnUnet_raw/Dataset219_PETCT/labelsTr/PETCT_b5923963ac_02172007.nii.gz,0.9441141498216409,0.1741742935180664,0.0
392,0.0,0,32,0.0,52159968,0,32,0,/well/papiez/users/hri611/python/nnUNet_results/Dataset219_PETCT/nnUNetTrainer_probabilisticOversampling_033__nnUNetPlans__3d_fullres/crossval_results_folds_0_1_2/PETCT_b62864161e_07282002.nii.gz,/well/papiez/users/hri611/python/nnUnet_raw/Dataset219_PETCT/labelsTr/PETCT_b62864161e_07282002.nii.gz,0.0,0.3981126708984375,0.0
393,0.0,0,28,0.0,52159972,0,28,0,/well/papiez/users/hri611/python/nnUNet_results/Dataset219_PETCT/nnUNetTrainer_probabilisticOversampling_033__nnUNetPlans__3d_fullres/crossval_results_folds_0_1_2/PETCT_b66ba83594_03132003.nii.gz,/well/papiez/users/hri611/python/nnUnet_raw/Dataset219_PETCT/labelsTr/PETCT_b66ba83594_03132003.nii.gz,0.0,0.3483485870361328,0.0
394,0.42281368821292775,731,28,0.26808100289296044,52158963,278,306,1009,/well/papiez/users/hri611/python/nnUNet_results/Dataset219_PETCT/nnUNetTrainer_probabilisticOversampling_033__nnUNetPlans__3d_fullres/crossval_results_folds_0_1_2/PETCT_b6a3c72db6_07132002.nii.gz,/well/papiez/users/hri611/python/nnUnet_raw/Dataset219_PETCT/labelsTr/PETCT_b6a3c72db6_07132002.nii.gz,0.42281368821292775,0.2861434822082519,7.825402187347412
395,0.8480887898525883,13575,605,0.7362449313641606,45386238,39582,40187,53157,/well/papiez/users/hri611/python/nnUNet_results/Dataset219_PETCT/nnUNetTrainer_probabilisticOversampling_033__nnUNetPlans__3d_fullres/crossval_results_folds_0_1_2/PETCT_b6fc20942c_12282001.nii.gz,/well/papiez/users/hri611/python/nnUnet_raw/Dataset219_PETCT/labelsTr/PETCT_b6fc20942c_12282001.nii.gz,0.8480887898525883,0.09952816772460937,0.58472798538208
396,0.764404609475032,3600,816,0.6186528497409326,38708420,7164,7980,10764,/well/papiez/users/hri611/python/nnUNet_results/Dataset219_PETCT/nnUNetTrainer_probabilisticOversampling_033__nnUNetPlans__3d_fullres/crossval_results_folds_0_1_2/PETCT_b899150306_08112002.nii.gz,/well/papiez/users/hri611/python/nnUnet_raw/Dataset219_PETCT/labelsTr/PETCT_b899150306_08112002.nii.gz,0.764404609475032,4.976408386230469,10.251401275634766
397,0.0,0,173,0.0,52159827,0,173,0,/well/papiez/users/hri611/python/nnUNet_results/Dataset219_PETCT/nnUNetTrainer_probabilisticOversampling_033__nnUNetPlans__3d_fullres/crossval_results_folds_0_1_2/PETCT_b926177c87_10102004.nii.gz,/well/papiez/users/hri611/python/nnUnet_raw/Dataset219_PETCT/labelsTr/PETCT_b926177c87_10102004.nii.gz,0.0,2.1522966270446777,0.0
398,0.0,0,286,0.0,51519714,0,286,0,/well/papiez/users/hri611/python/nnUNet_results/Dataset219_PETCT/nnUNetTrainer_probabilisticOversampling_033__nnUNetPlans__3d_fullres/crossval_results_folds_0_1_2/PETCT_ba81e4b04b_12022005.nii.gz,/well/papiez/users/hri611/python/nnUnet_raw/Dataset219_PETCT/labelsTr/PETCT_ba81e4b04b_12022005.nii.gz,0.0,3.5581319961547853,0.0
399,0.8132330827067669,0,1242,0.685250886974151,92316054,2704,3946,2704,/well/papiez/users/hri611/python/nnUNet_results/Dataset219_PETCT/nnUNetTrainer_probabilisticOversampling_033__nnUNetPlans__3d_fullres/crossval_results_folds_0_1_2/PETCT_bc80d06f97_02182002.nii.gz,/well/papiez/users/hri611/python/nnUnet_raw/Dataset219_PETCT/labelsTr/PETCT_bc80d06f97_02182002.nii.gz,0.8132330827067669,2.1149735641479492,0.0
400,0.9218923418423973,2614,764,0.8551023034358513,45416687,19935,20699,22549,/well/papiez/users/hri611/python/nnUNet_results/Dataset219_PETCT/nnUNetTrainer_probabilisticOversampling_033__nnUNetPlans__3d_fullres/crossval_results_folds_0_1_2/PETCT_bca97006e4_05062001.nii.gz,/well/papiez/users/hri611/python/nnUnet_raw/Dataset219_PETCT/labelsTr/PETCT_bca97006e4_05062001.nii.gz,0.9218923418423973,0.04976408386230469,0.0
401,0.6563665423548215,566,79,0.48850118953211735,45438739,616,695,1182,/well/papiez/users/hri611/python/nnUNet_results/Dataset219_PETCT/nnUNetTrainer_probabilisticOversampling_033__nnUNetPlans__3d_fullres/crossval_results_folds_0_1_2/PETCT_bd52fdf529_12032000.nii.gz,/well/papiez/users/hri611/python/nnUnet_raw/Dataset219_PETCT/labelsTr/PETCT_bd52fdf529_12032000.nii.gz,0.6563665423548215,0.0,3.8940395622253416
402,0.0,0,2392,0.0,45437608,0,2392,0,/well/papiez/users/hri611/python/nnUNet_results/Dataset219_PETCT/nnUNetTrainer_probabilisticOversampling_033__nnUNetPlans__3d_fullres/crossval_results_folds_0_1_2/PETCT_bd76c8d299_10252002.nii.gz,/well/papiez/users/hri611/python/nnUnet_raw/Dataset219_PETCT/labelsTr/PETCT_bd76c8d299_10252002.nii.gz,0.0,29.758922149658204,0.0
403,0.8320851399290501,2493,915,0.7124535943300708,45428148,8444,9359,10937,/well/papiez/users/hri611/python/nnUNet_results/Dataset219_PETCT/nnUNetTrainer_probabilisticOversampling_033__nnUNetPlans__3d_fullres/crossval_results_folds_0_1_2/PETCT_bd7c02faa9_05042002.nii.gz,/well/papiez/users/hri611/python/nnUnet_raw/Dataset219_PETCT/labelsTr/PETCT_bd7c02faa9_05042002.nii.gz,0.8320851399290501,0.3359075660705566,3.3839577026367187
404,0.0,0,3910,0.0,50396090,0,3910,0,/well/papiez/users/hri611/python/nnUNet_results/Dataset219_PETCT/nnUNetTrainer_probabilisticOversampling_033__nnUNetPlans__3d_fullres/crossval_results_folds_0_1_2/PETCT_be0d3c767e_05292006.nii.gz,/well/papiez/users/hri611/python/nnUnet_raw/Dataset219_PETCT/labelsTr/PETCT_be0d3c767e_05292006.nii.gz,0.0,48.64439197540283,0.0
405,0.8505293751297488,577,863,0.7399313707783999,45434463,4097,4960,4674,/well/papiez/users/hri611/python/nnUNet_results/Dataset219_PETCT/nnUNetTrainer_probabilisticOversampling_033__nnUNetPlans__3d_fullres/crossval_results_folds_0_1_2/PETCT_be3e55a32f_04052001.nii.gz,/well/papiez/users/hri611/python/nnUnet_raw/Dataset219_PETCT/labelsTr/PETCT_be3e55a32f_04052001.nii.gz,0.8505293751297488,0.945517593383789,0.012441020965576172
406,0.0,0,622,0.0,51679378,0,622,0,/well/papiez/users/hri611/python/nnUNet_results/Dataset219_PETCT/nnUNetTrainer_probabilisticOversampling_033__nnUNetPlans__3d_fullres/crossval_results_folds_0_1_2/PETCT_bef465b4ad_05042007.nii.gz,/well/papiez/users/hri611/python/nnUnet_raw/Dataset219_PETCT/labelsTr/PETCT_bef465b4ad_05042007.nii.gz,0.0,7.738315040588379,0.0
407,0.391660367850844,18565,751,0.2435184459935772,45414466,6218,6969,24783,/well/papiez/users/hri611/python/nnUNet_results/Dataset219_PETCT/nnUNetTrainer_probabilisticOversampling_033__nnUNetPlans__3d_fullres/crossval_results_folds_0_1_2/PETCT_bf178a41b2_06082002.nii.gz,/well/papiez/users/hri611/python/nnUnet_raw/Dataset219_PETCT/labelsTr/PETCT_bf178a41b2_06082002.nii.gz,0.391660367850844,5.075936553955078,56.0219174079895
408,,0,0,,47360000,0,0,0,/well/papiez/users/hri611/python/nnUNet_results/Dataset219_PETCT/nnUNetTrainer_probabilisticOversampling_033__nnUNetPlans__3d_fullres/crossval_results_folds_0_1_2/PETCT_bfd89440db_03112007.nii.gz,/well/papiez/users/hri611/python/nnUnet_raw/Dataset219_PETCT/labelsTr/PETCT_bfd89440db_03112007.nii.gz,,0.0,0.0
409,0.0,0,18,0.0,48159982,0,18,0,/well/papiez/users/hri611/python/nnUNet_results/Dataset219_PETCT/nnUNetTrainer_probabilisticOversampling_033__nnUNetPlans__3d_fullres/crossval_results_folds_0_1_2/PETCT_c018b45a49_11262006.nii.gz,/well/papiez/users/hri611/python/nnUnet_raw/Dataset219_PETCT/labelsTr/PETCT_c018b45a49_11262006.nii.gz,0.0,0.2239383773803711,0.0
410,0.0,0,23,0.0,52799977,0,23,0,/well/papiez/users/hri611/python/nnUNet_results/Dataset219_PETCT/nnUNetTrainer_probabilisticOversampling_033__nnUNetPlans__3d_fullres/crossval_results_folds_0_1_2/PETCT_c08293f2b2_07132006.nii.gz,/well/papiez/users/hri611/python/nnUnet_raw/Dataset219_PETCT/labelsTr/PETCT_c08293f2b2_07132006.nii.gz,0.0,0.2861434822082519,0.0
411,,0,0,,50400000,0,0,0,/well/papiez/users/hri611/python/nnUNet_results/Dataset219_PETCT/nnUNetTrainer_probabilisticOversampling_033__nnUNetPlans__3d_fullres/crossval_results_folds_0_1_2/PETCT_c094a24c03_01292006.nii.gz,/well/papiez/users/hri611/python/nnUnet_raw/Dataset219_PETCT/labelsTr/PETCT_c094a24c03_01292006.nii.gz,,0.0,0.0
412,0.0,0,18,0.0,52159982,0,18,0,/well/papiez/users/hri611/python/nnUNet_results/Dataset219_PETCT/nnUNetTrainer_probabilisticOversampling_033__nnUNetPlans__3d_fullres/crossval_results_folds_0_1_2/PETCT_c094a24c03_03042007.nii.gz,/well/papiez/users/hri611/python/nnUnet_raw/Dataset219_PETCT/labelsTr/PETCT_c094a24c03_03042007.nii.gz,0.0,0.2239383773803711,0.0
413,0.0,0,4477,0.0,52155523,0,4477,0,/well/papiez/users/hri611/python/nnUNet_results/Dataset219_PETCT/nnUNetTrainer_probabilisticOversampling_033__nnUNetPlans__3d_fullres/crossval_results_folds_0_1_2/PETCT_c10f48b173_11272004.nii.gz,/well/papiez/users/hri611/python/nnUnet_raw/Dataset219_PETCT/labelsTr/PETCT_c10f48b173_11272004.nii.gz,0.0,55.69845086288452,0.0
414,0.6922246220302376,171,399,0.5293146160198183,45438789,641,1040,812,/well/papiez/users/hri611/python/nnUNet_results/Dataset219_PETCT/nnUNetTrainer_probabilisticOversampling_033__nnUNetPlans__3d_fullres/crossval_results_folds_0_1_2/PETCT_c16c13211c_10262003.nii.gz,/well/papiez/users/hri611/python/nnUnet_raw/Dataset219_PETCT/labelsTr/PETCT_c16c13211c_10262003.nii.gz,0.6922246220302376,2.6499374656677244,0.0
415,0.883063306330633,75,3043,0.7906117789268686,72145109,11773,14816,11848,/well/papiez/users/hri611/python/nnUNet_results/Dataset219_PETCT/nnUNetTrainer_probabilisticOversampling_033__nnUNetPlans__3d_fullres/crossval_results_folds_0_1_2/PETCT_c16d325d12_02152003.nii.gz,/well/papiez/users/hri611/python/nnUnet_raw/Dataset219_PETCT/labelsTr/PETCT_c16d325d12_02152003.nii.gz,0.883063306330633,0.19905633544921875,0.024882041931152343
416,,0,0,,51040000,0,0,0,/well/papiez/users/hri611/python/nnUNet_results/Dataset219_PETCT/nnUNetTrainer_probabilisticOversampling_033__nnUNetPlans__3d_fullres/crossval_results_folds_0_1_2/PETCT_c1c9e78e0e_05142007.nii.gz,/well/papiez/users/hri611/python/nnUnet_raw/Dataset219_PETCT/labelsTr/PETCT_c1c9e78e0e_05142007.nii.gz,,0.0,0.0
417,0.6505848713283078,12932,510,0.4821235937740792,52134044,12514,13024,25446,/well/papiez/users/hri611/python/nnUNet_results/Dataset219_PETCT/nnUNetTrainer_probabilisticOversampling_033__nnUNetPlans__3d_fullres/crossval_results_folds_0_1_2/PETCT_c29aba73da_08232002.nii.gz,/well/papiez/users/hri611/python/nnUnet_raw/Dataset219_PETCT/labelsTr/PETCT_c29aba73da_08232002.nii.gz,0.6505848713283078,0.012441020965576172,23.165181037902833
418,0.0,0,709,0.0,72159291,0,709,0,/well/papiez/users/hri611/python/nnUNet_results/Dataset219_PETCT/nnUNetTrainer_probabilisticOversampling_033__nnUNetPlans__3d_fullres/crossval_results_folds_0_1_2/PETCT_c2b776974a_05092005.nii.gz,/well/papiez/users/hri611/python/nnUnet_raw/Dataset219_PETCT/labelsTr/PETCT_c2b776974a_05092005.nii.gz,0.0,8.820683864593505,0.0
419,0.0,0,22,0.0,38719978,0,22,0,/well/papiez/users/hri611/python/nnUNet_results/Dataset219_PETCT/nnUNetTrainer_probabilisticOversampling_033__nnUNetPlans__3d_fullres/crossval_results_folds_0_1_2/PETCT_c2ffda4725_04112003.nii.gz,/well/papiez/users/hri611/python/nnUnet_raw/Dataset219_PETCT/labelsTr/PETCT_c2ffda4725_04112003.nii.gz,0.0,0.2737024612426758,0.0
420,0.0,0,3240,0.0,38716760,0,3240,0,/well/papiez/users/hri611/python/nnUNet_results/Dataset219_PETCT/nnUNetTrainer_probabilisticOversampling_033__nnUNetPlans__3d_fullres/crossval_results_folds_0_1_2/PETCT_c2ffda4725_09192003.nii.gz,/well/papiez/users/hri611/python/nnUnet_raw/Dataset219_PETCT/labelsTr/PETCT_c2ffda4725_09192003.nii.gz,0.0,40.308907928466795,0.0
421,0.0,0,30,0.0,58879970,0,30,0,/well/papiez/users/hri611/python/nnUNet_results/Dataset219_PETCT/nnUNetTrainer_probabilisticOversampling_033__nnUNetPlans__3d_fullres/crossval_results_folds_0_1_2/PETCT_c395306306_08242002.nii.gz,/well/papiez/users/hri611/python/nnUnet_raw/Dataset219_PETCT/labelsTr/PETCT_c395306306_08242002.nii.gz,0.0,0.37323062896728515,0.0
422,0.9010662038184974,4377,1608,0.8199458483754513,52126760,27255,28863,31632,/well/papiez/users/hri611/python/nnUNet_results/Dataset219_PETCT/nnUNetTrainer_probabilisticOversampling_033__nnUNetPlans__3d_fullres/crossval_results_folds_0_1_2/PETCT_c517c47bed_02062003.nii.gz,/well/papiez/users/hri611/python/nnUnet_raw/Dataset219_PETCT/labelsTr/PETCT_c517c47bed_02062003.nii.gz,0.9010662038184974,1.517804557800293,0.9703996353149413
423,0.3755186721991701,1788,18,0.23116219667943805,45437651,543,561,2331,/well/papiez/users/hri611/python/nnUNet_results/Dataset219_PETCT/nnUNetTrainer_probabilisticOversampling_033__nnUNetPlans__3d_fullres/crossval_results_folds_0_1_2/PETCT_c58477f3b4_12072002.nii.gz,/well/papiez/users/hri611/python/nnUnet_raw/Dataset219_PETCT/labelsTr/PETCT_c58477f3b4_12072002.nii.gz,0.3755186721991701,0.037323062896728515,11.906057064056396
424,0.0,0,26,0.0,43679974,0,26,0,/well/papiez/users/hri611/python/nnUNet_results/Dataset219_PETCT/nnUNetTrainer_probabilisticOversampling_033__nnUNetPlans__3d_fullres/crossval_results_folds_0_1_2/PETCT_c5a143a604_08122006.nii.gz,/well/papiez/users/hri611/python/nnUnet_raw/Dataset219_PETCT/labelsTr/PETCT_c5a143a604_08122006.nii.gz,0.0,0.32346654510498046,0.0
425,0.6540897453173427,4082,1052,0.48598317981577893,52150012,4854,5906,8936,/well/papiez/users/hri611/python/nnUNet_results/Dataset219_PETCT/nnUNetTrainer_probabilisticOversampling_033__nnUNetPlans__3d_fullres/crossval_results_folds_0_1_2/PETCT_c73c2685c0_02012001.nii.gz,/well/papiez/users/hri611/python/nnUnet_raw/Dataset219_PETCT/labelsTr/PETCT_c73c2685c0_02012001.nii.gz,0.6540897453173427,0.870871467590332,3.0729321784973145
426,0.893095218500535,1064,235,0.8068401486988848,45433275,5426,5661,6490,/well/papiez/users/hri611/python/nnUNet_results/Dataset219_PETCT/nnUNetTrainer_probabilisticOversampling_033__nnUNetPlans__3d_fullres/crossval_results_folds_0_1_2/PETCT_c799ccc2f6_08262002.nii.gz,/well/papiez/users/hri611/python/nnUnet_raw/Dataset219_PETCT/labelsTr/PETCT_c799ccc2f6_08262002.nii.gz,0.893095218500535,0.06220510482788086,0.0
427,0.0,0,291,0.0,45439709,0,291,0,/well/papiez/users/hri611/python/nnUNet_results/Dataset219_PETCT/nnUNetTrainer_probabilisticOversampling_033__nnUNetPlans__3d_fullres/crossval_results_folds_0_1_2/PETCT_c7fd7e3e30_11132003.nii.gz,/well/papiez/users/hri611/python/nnUnet_raw/Dataset219_PETCT/labelsTr/PETCT_c7fd7e3e30_11132003.nii.gz,0.0,3.620337100982666,0.0
428,0.0,0,49,0.0,45439951,0,49,0,/well/papiez/users/hri611/python/nnUNet_results/Dataset219_PETCT/nnUNetTrainer_probabilisticOversampling_033__nnUNetPlans__3d_fullres/crossval_results_folds_0_1_2/PETCT_ca16242e89_09132002.nii.gz,/well/papiez/users/hri611/python/nnUnet_raw/Dataset219_PETCT/labelsTr/PETCT_ca16242e89_09132002.nii.gz,0.0,0.6096100273132324,0.0
429,,0,0,,45440000,0,0,0,/well/papiez/users/hri611/python/nnUNet_results/Dataset219_PETCT/nnUNetTrainer_probabilisticOversampling_033__nnUNetPlans__3d_fullres/crossval_results_folds_0_1_2/PETCT_ca16242e89_09182003.nii.gz,/well/papiez/users/hri611/python/nnUnet_raw/Dataset219_PETCT/labelsTr/PETCT_ca16242e89_09182003.nii.gz,,0.0,0.0
430,0.0,0,7045,0.0,45432955,0,7045,0,/well/papiez/users/hri611/python/nnUNet_results/Dataset219_PETCT/nnUNetTrainer_probabilisticOversampling_033__nnUNetPlans__3d_fullres/crossval_results_folds_0_1_2/PETCT_ca29501275_11042004.nii.gz,/well/papiez/users/hri611/python/nnUnet_raw/Dataset219_PETCT/labelsTr/PETCT_ca29501275_11042004.nii.gz,0.0,87.64699270248413,0.0
431,0.7036247334754797,0,139,0.5427631578947368,101439696,165,304,165,/well/papiez/users/hri611/python/nnUNet_results/Dataset219_PETCT/nnUNetTrainer_probabilisticOversampling_033__nnUNetPlans__3d_fullres/crossval_results_folds_0_1_2/PETCT_cab58c1fee_03192007.nii.gz,/well/papiez/users/hri611/python/nnUnet_raw/Dataset219_PETCT/labelsTr/PETCT_cab58c1fee_03192007.nii.gz,0.7036247334754797,0.7091381950378418,0.0
432,0.0,0,47,0.0,91039953,0,47,0,/well/papiez/users/hri611/python/nnUNet_results/Dataset219_PETCT/nnUNetTrainer_probabilisticOversampling_033__nnUNetPlans__3d_fullres/crossval_results_folds_0_1_2/PETCT_cb240e6f0f_04192007.nii.gz,/well/papiez/users/hri611/python/nnUnet_raw/Dataset219_PETCT/labelsTr/PETCT_cb240e6f0f_04192007.nii.gz,0.0,0.58472798538208,0.0
433,0.8426847110460863,5651,2951,0.728137543061218,48128359,23039,25990,28690,/well/papiez/users/hri611/python/nnUNet_results/Dataset219_PETCT/nnUNetTrainer_probabilisticOversampling_033__nnUNetPlans__3d_fullres/crossval_results_folds_0_1_2/PETCT_cbbc9e2879_01162006.nii.gz,/well/papiez/users/hri611/python/nnUnet_raw/Dataset219_PETCT/labelsTr/PETCT_cbbc9e2879_01162006.nii.gz,0.8426847110460863,1.3436302642822264,2.2269427528381347
434,0.0,0,13,0.0,47199987,0,13,0,/well/papiez/users/hri611/python/nnUNet_results/Dataset219_PETCT/nnUNetTrainer_probabilisticOversampling_033__nnUNetPlans__3d_fullres/crossval_results_folds_0_1_2/PETCT_cbbc9e2879_03312006.nii.gz,/well/papiez/users/hri611/python/nnUnet_raw/Dataset219_PETCT/labelsTr/PETCT_cbbc9e2879_03312006.nii.gz,0.0,0.16173327255249023,0.0
435,,0,0,,46880000,0,0,0,/well/papiez/users/hri611/python/nnUNet_results/Dataset219_PETCT/nnUNetTrainer_probabilisticOversampling_033__nnUNetPlans__3d_fullres/crossval_results_folds_0_1_2/PETCT_cbbc9e2879_06282007.nii.gz,/well/papiez/users/hri611/python/nnUnet_raw/Dataset219_PETCT/labelsTr/PETCT_cbbc9e2879_06282007.nii.gz,,0.0,0.0
436,0.0,0,1557,0.0,45438443,0,1557,0,/well/papiez/users/hri611/python/nnUNet_results/Dataset219_PETCT/nnUNetTrainer_probabilisticOversampling_033__nnUNetPlans__3d_fullres/crossval_results_folds_0_1_2/PETCT_cc7cb73213_12182004.nii.gz,/well/papiez/users/hri611/python/nnUnet_raw/Dataset219_PETCT/labelsTr/PETCT_cc7cb73213_12182004.nii.gz,0.0,19.3706696434021,0.0
437,0.0,0,300,0.0,44159700,0,300,0,/well/papiez/users/hri611/python/nnUNet_results/Dataset219_PETCT/nnUNetTrainer_probabilisticOversampling_033__nnUNetPlans__3d_fullres/crossval_results_folds_0_1_2/PETCT_ccb9c375b2_10012005.nii.gz,/well/papiez/users/hri611/python/nnUnet_raw/Dataset219_PETCT/labelsTr/PETCT_ccb9c375b2_10012005.nii.gz,0.0,3.7323062896728514,0.0
438,0.0,0,10734,0.0,50869266,0,10734,0,/well/papiez/users/hri611/python/nnUNet_results/Dataset219_PETCT/nnUNetTrainer_probabilisticOversampling_033__nnUNetPlans__3d_fullres/crossval_results_folds_0_1_2/PETCT_ccd8f5ff71_10292006.nii.gz,/well/papiez/users/hri611/python/nnUnet_raw/Dataset219_PETCT/labelsTr/PETCT_ccd8f5ff71_10292006.nii.gz,0.0,133.54191904449462,0.0
439,0.0,0,236,0.0,52159764,0,236,0,/well/papiez/users/hri611/python/nnUNet_results/Dataset219_PETCT/nnUNetTrainer_probabilisticOversampling_033__nnUNetPlans__3d_fullres/crossval_results_folds_0_1_2/PETCT_cd50f3fec4_12012002.nii.gz,/well/papiez/users/hri611/python/nnUnet_raw/Dataset219_PETCT/labelsTr/PETCT_cd50f3fec4_12012002.nii.gz,0.0,2.9360809478759764,0.0
440,0.0,0,88,0.0,54399912,0,88,0,/well/papiez/users/hri611/python/nnUNet_results/Dataset219_PETCT/nnUNetTrainer_probabilisticOversampling_033__nnUNetPlans__3d_fullres/crossval_results_folds_0_1_2/PETCT_cd9bdca46b_10052006.nii.gz,/well/papiez/users/hri611/python/nnUnet_raw/Dataset219_PETCT/labelsTr/PETCT_cd9bdca46b_10052006.nii.gz,0.0,1.094809844970703,0.0
441,0.8010951534655844,2409,1732,0.6681891025641026,72147520,8339,10071,10748,/well/papiez/users/hri611/python/nnUNet_results/Dataset219_PETCT/nnUNetTrainer_probabilisticOversampling_033__nnUNetPlans__3d_fullres/crossval_results_folds_0_1_2/PETCT_cf20ad1656_02182005.nii.gz,/well/papiez/users/hri611/python/nnUnet_raw/Dataset219_PETCT/labelsTr/PETCT_cf20ad1656_02182005.nii.gz,0.8010951534655844,0.6096100273132324,4.055772834777832
442,0.0,0,288,0.0,89759712,0,288,0,/well/papiez/users/hri611/python/nnUNet_results/Dataset219_PETCT/nnUNetTrainer_probabilisticOversampling_033__nnUNetPlans__3d_fullres/crossval_results_folds_0_1_2/PETCT_cf3725edf0_10072005.nii.gz,/well/papiez/users/hri611/python/nnUnet_raw/Dataset219_PETCT/labelsTr/PETCT_cf3725edf0_10072005.nii.gz,0.0,3.5830140380859374,0.0
443,0.0,0,113,0.0,45439887,0,113,0,/well/papiez/users/hri611/python/nnUNet_results/Dataset219_PETCT/nnUNetTrainer_probabilisticOversampling_033__nnUNetPlans__3d_fullres/crossval_results_folds_0_1_2/PETCT_d098458d29_08012003.nii.gz,/well/papiez/users/hri611/python/nnUnet_raw/Dataset219_PETCT/labelsTr/PETCT_d098458d29_08012003.nii.gz,0.0,1.4058353691101073,0.0
444,0.0,0,352,0.0,52159648,0,352,0,/well/papiez/users/hri611/python/nnUNet_results/Dataset219_PETCT/nnUNetTrainer_probabilisticOversampling_033__nnUNetPlans__3d_fullres/crossval_results_folds_0_1_2/PETCT_d103e57f0e_12122002.nii.gz,/well/papiez/users/hri611/python/nnUnet_raw/Dataset219_PETCT/labelsTr/PETCT_d103e57f0e_12122002.nii.gz,0.0,4.379239379882812,0.0
445,0.8286987900658035,1597,16964,0.7075027183762232,52096543,44896,61860,46493,/well/papiez/users/hri611/python/nnUNet_results/Dataset219_PETCT/nnUNetTrainer_probabilisticOversampling_033__nnUNetPlans__3d_fullres/crossval_results_folds_0_1_2/PETCT_d31c9ebd93_07212003.nii.gz,/well/papiez/users/hri611/python/nnUnet_raw/Dataset219_PETCT/labelsTr/PETCT_d31c9ebd93_07212003.nii.gz,0.8286987900658035,0.3359075660705566,11.40841622543335
446,0.5373789069639919,2303,228,0.36740814796300925,45435999,1470,1698,3773,/well/papiez/users/hri611/python/nnUNet_results/Dataset219_PETCT/nnUNetTrainer_probabilisticOversampling_033__nnUNetPlans__3d_fullres/crossval_results_folds_0_1_2/PETCT_d393ab6c7b_09222002.nii.gz,/well/papiez/users/hri611/python/nnUnet_raw/Dataset219_PETCT/labelsTr/PETCT_d393ab6c7b_09222002.nii.gz,0.5373789069639919,2.2891478576660154,0.0
447,,0,0,,48480000,0,0,0,/well/papiez/users/hri611/python/nnUNet_results/Dataset219_PETCT/nnUNetTrainer_probabilisticOversampling_033__nnUNetPlans__3d_fullres/crossval_results_folds_0_1_2/PETCT_d3d3b7d4ff_08312006.nii.gz,/well/papiez/users/hri611/python/nnUnet_raw/Dataset219_PETCT/labelsTr/PETCT_d3d3b7d4ff_08312006.nii.gz,,0.0,0.0
448,0.8658682940530603,3090,2163,0.7634636167146974,52137792,16955,19118,20045,/well/papiez/users/hri611/python/nnUNet_results/Dataset219_PETCT/nnUNetTrainer_probabilisticOversampling_033__nnUNetPlans__3d_fullres/crossval_results_folds_0_1_2/PETCT_d3d61785e6_10192001.nii.gz,/well/papiez/users/hri611/python/nnUnet_raw/Dataset219_PETCT/labelsTr/PETCT_d3d61785e6_10192001.nii.gz,0.8658682940530603,2.3513529624938965,19.880751502990723
449,0.0,0,16,0.0,45439984,0,16,0,/well/papiez/users/hri611/python/nnUNet_results/Dataset219_PETCT/nnUNetTrainer_probabilisticOversampling_033__nnUNetPlans__3d_fullres/crossval_results_folds_0_1_2/PETCT_d3f13dff4b_08242003.nii.gz,/well/papiez/users/hri611/python/nnUnet_raw/Dataset219_PETCT/labelsTr/PETCT_d3f13dff4b_08242003.nii.gz,0.0,0.19905633544921875,0.0
450,0.7455314848733657,2928,1101,0.5943006746551204,52150069,5902,7003,8830,/well/papiez/users/hri611/python/nnUNet_results/Dataset219_PETCT/nnUNetTrainer_probabilisticOversampling_033__nnUNetPlans__3d_fullres/crossval_results_folds_0_1_2/PETCT_d40a16781a_09132003.nii.gz,/well/papiez/users/hri611/python/nnUnet_raw/Dataset219_PETCT/labelsTr/PETCT_d40a16781a_09132003.nii.gz,0.7455314848733657,6.879884593963623,0.012441020965576172
451,0.725077367967125,5138,281,0.5687226422602467,52147435,7146,7427,12284,/well/papiez/users/hri611/python/nnUNet_results/Dataset219_PETCT/nnUNetTrainer_probabilisticOversampling_033__nnUNetPlans__3d_fullres/crossval_results_folds_0_1_2/PETCT_d46f0109f8_09092000.nii.gz,/well/papiez/users/hri611/python/nnUnet_raw/Dataset219_PETCT/labelsTr/PETCT_d46f0109f8_09092000.nii.gz,0.725077367967125,0.3359075660705566,36.43975040817261
452,0.0,0,196,0.0,45439804,0,196,0,/well/papiez/users/hri611/python/nnUNet_results/Dataset219_PETCT/nnUNetTrainer_probabilisticOversampling_033__nnUNetPlans__3d_fullres/crossval_results_folds_0_1_2/PETCT_d472033d3b_09282002.nii.gz,/well/papiez/users/hri611/python/nnUnet_raw/Dataset219_PETCT/labelsTr/PETCT_d472033d3b_09282002.nii.gz,0.0,2.4384401092529298,0.0
453,,0,0,,50080000,0,0,0,/well/papiez/users/hri611/python/nnUNet_results/Dataset219_PETCT/nnUNetTrainer_probabilisticOversampling_033__nnUNetPlans__3d_fullres/crossval_results_folds_0_1_2/PETCT_d4a08e4bde_03162006.nii.gz,/well/papiez/users/hri611/python/nnUnet_raw/Dataset219_PETCT/labelsTr/PETCT_d4a08e4bde_03162006.nii.gz,,0.0,0.0
454,0.4303775086199275,2732,3711,0.27419173144080206,91831123,2434,6145,5166,/well/papiez/users/hri611/python/nnUNet_results/Dataset219_PETCT/nnUNetTrainer_probabilisticOversampling_033__nnUNetPlans__3d_fullres/crossval_results_folds_0_1_2/PETCT_d4f3375362_05272005.nii.gz,/well/papiez/users/hri611/python/nnUnet_raw/Dataset219_PETCT/labelsTr/PETCT_d4f3375362_05272005.nii.gz,0.4303775086199275,44.86232160186768,4.889321239471435
455,0.9100344388356842,725,1182,0.8349203601108033,75188448,9645,10827,10370,/well/papiez/users/hri611/python/nnUNet_results/Dataset219_PETCT/nnUNetTrainer_probabilisticOversampling_033__nnUNetPlans__3d_fullres/crossval_results_folds_0_1_2/PETCT_d5103c8fbf_04142006.nii.gz,/well/papiez/users/hri611/python/nnUnet_raw/Dataset219_PETCT/labelsTr/PETCT_d5103c8fbf_04142006.nii.gz,0.9100344388356842,0.3483485870361328,0.0
456,0.0,0,374,0.0,85599626,0,374,0,/well/papiez/users/hri611/python/nnUNet_results/Dataset219_PETCT/nnUNetTrainer_probabilisticOversampling_033__nnUNetPlans__3d_fullres/crossval_results_folds_0_1_2/PETCT_d539f5a88b_06232003.nii.gz,/well/papiez/users/hri611/python/nnUnet_raw/Dataset219_PETCT/labelsTr/PETCT_d539f5a88b_06232003.nii.gz,0.0,4.652941841125489,0.0
457,0.0,0,232,0.0,72159768,0,232,0,/well/papiez/users/hri611/python/nnUNet_results/Dataset219_PETCT/nnUNetTrainer_probabilisticOversampling_033__nnUNetPlans__3d_fullres/crossval_results_folds_0_1_2/PETCT_d5e2aa7feb_04172003.nii.gz,/well/papiez/users/hri611/python/nnUnet_raw/Dataset219_PETCT/labelsTr/PETCT_d5e2aa7feb_04172003.nii.gz,0.0,2.886316864013672,0.0
458,0.0,0,586,0.0,58879414,0,586,0,/well/papiez/users/hri611/python/nnUNet_results/Dataset219_PETCT/nnUNetTrainer_probabilisticOversampling_033__nnUNetPlans__3d_fullres/crossval_results_folds_0_1_2/PETCT_d626611daf_04032003.nii.gz,/well/papiez/users/hri611/python/nnUnet_raw/Dataset219_PETCT/labelsTr/PETCT_d626611daf_04032003.nii.gz,0.0,7.290438285827636,0.0
459,0.0,0,669,0.0,55359331,0,669,0,/well/papiez/users/hri611/python/nnUNet_results/Dataset219_PETCT/nnUNetTrainer_probabilisticOversampling_033__nnUNetPlans__3d_fullres/crossval_results_folds_0_1_2/PETCT_d626611daf_06192005.nii.gz,/well/papiez/users/hri611/python/nnUnet_raw/Dataset219_PETCT/labelsTr/PETCT_d626611daf_06192005.nii.gz,0.0,8.323043025970458,0.0
460,0.0,0,1309,0.0,58878691,0,1309,0,/well/papiez/users/hri611/python/nnUNet_results/Dataset219_PETCT/nnUNetTrainer_probabilisticOversampling_033__nnUNetPlans__3d_fullres/crossval_results_folds_0_1_2/PETCT_d626611daf_11122004.nii.gz,/well/papiez/users/hri611/python/nnUnet_raw/Dataset219_PETCT/labelsTr/PETCT_d626611daf_11122004.nii.gz,0.0,16.28529644393921,0.0
461,0.9049773755656109,0,21,0.8264462809917356,52479879,100,121,100,/well/papiez/users/hri611/python/nnUNet_results/Dataset219_PETCT/nnUNetTrainer_probabilisticOversampling_033__nnUNetPlans__3d_fullres/crossval_results_folds_0_1_2/PETCT_d65cf203be_04282007.nii.gz,/well/papiez/users/hri611/python/nnUnet_raw/Dataset219_PETCT/labelsTr/PETCT_d65cf203be_04282007.nii.gz,0.9049773755656109,0.0,0.0
462,0.0,0,13,0.0,58879987,0,13,0,/well/papiez/users/hri611/python/nnUNet_results/Dataset219_PETCT/nnUNetTrainer_probabilisticOversampling_033__nnUNetPlans__3d_fullres/crossval_results_folds_0_1_2/PETCT_d6a48a629d_03062003.nii.gz,/well/papiez/users/hri611/python/nnUnet_raw/Dataset219_PETCT/labelsTr/PETCT_d6a48a629d_03062003.nii.gz,0.0,0.16173327255249023,0.0
463,,0,0,,52160000,0,0,0,/well/papiez/users/hri611/python/nnUNet_results/Dataset219_PETCT/nnUNetTrainer_probabilisticOversampling_033__nnUNetPlans__3d_fullres/crossval_results_folds_0_1_2/PETCT_d6a48a629d_07272002.nii.gz,/well/papiez/users/hri611/python/nnUnet_raw/Dataset219_PETCT/labelsTr/PETCT_d6a48a629d_07272002.nii.gz,,0.0,0.0
464,0.0,0,3121,0.0,99036879,0,3121,0,/well/papiez/users/hri611/python/nnUNet_results/Dataset219_PETCT/nnUNetTrainer_probabilisticOversampling_033__nnUNetPlans__3d_fullres/crossval_results_folds_0_1_2/PETCT_d6a491e16d_05302003.nii.gz,/well/papiez/users/hri611/python/nnUnet_raw/Dataset219_PETCT/labelsTr/PETCT_d6a491e16d_05302003.nii.gz,0.0,38.82842643356323,0.0
465,,0,0,,45440000,0,0,0,/well/papiez/users/hri611/python/nnUNet_results/Dataset219_PETCT/nnUNetTrainer_probabilisticOversampling_033__nnUNetPlans__3d_fullres/crossval_results_folds_0_1_2/PETCT_d6b2218bf3_12182004.nii.gz,/well/papiez/users/hri611/python/nnUnet_raw/Dataset219_PETCT/labelsTr/PETCT_d6b2218bf3_12182004.nii.gz,,0.0,0.0
466,0.5873134328358209,672,434,0.4157422081352351,47838107,787,1221,1459,/well/papiez/users/hri611/python/nnUNet_results/Dataset219_PETCT/nnUNetTrainer_probabilisticOversampling_033__nnUNetPlans__3d_fullres/crossval_results_folds_0_1_2/PETCT_d8a92bafe3_03182007.nii.gz,/well/papiez/users/hri611/python/nnUnet_raw/Dataset219_PETCT/labelsTr/PETCT_d8a92bafe3_03182007.nii.gz,0.5873134328358209,1.2565431175231934,6.929648677825927
467,0.6893229863526893,13,1148,0.5259289505920784,92317551,1288,2436,1301,/well/papiez/users/hri611/python/nnUNet_results/Dataset219_PETCT/nnUNetTrainer_probabilisticOversampling_033__nnUNetPlans__3d_fullres/crossval_results_folds_0_1_2/PETCT_d8d9e52cd5_03132005.nii.gz,/well/papiez/users/hri611/python/nnUnet_raw/Dataset219_PETCT/labelsTr/PETCT_d8d9e52cd5_03132005.nii.gz,0.6893229863526893,4.61561877822876,0.012441020965576172
468,0.782511835143414,238,543,0.6427264409881062,92317814,1405,1948,1643,/well/papiez/users/hri611/python/nnUNet_results/Dataset219_PETCT/nnUNetTrainer_probabilisticOversampling_033__nnUNetPlans__3d_fullres/crossval_results_folds_0_1_2/PETCT_d8d9e52cd5_07042004.nii.gz,/well/papiez/users/hri611/python/nnUnet_raw/Dataset219_PETCT/labelsTr/PETCT_d8d9e52cd5_07042004.nii.gz,0.782511835143414,3.645219142913818,0.7837843208312988
469,0.2994304312449146,8025,1446,0.17607655502392344,94068505,2024,3470,10049,/well/papiez/users/hri611/python/nnUNet_results/Dataset219_PETCT/nnUNetTrainer_probabilisticOversampling_033__nnUNetPlans__3d_fullres/crossval_results_folds_0_1_2/PETCT_d8d9e52cd5_10072005.nii.gz,/well/papiez/users/hri611/python/nnUnet_raw/Dataset219_PETCT/labelsTr/PETCT_d8d9e52cd5_10072005.nii.gz,0.2994304312449146,9.343206745147706,98.17209643936157
470,0.0,0,722,0.0,52159278,0,722,0,/well/papiez/users/hri611/python/nnUNet_results/Dataset219_PETCT/nnUNetTrainer_probabilisticOversampling_033__nnUNetPlans__3d_fullres/crossval_results_folds_0_1_2/PETCT_d8e3aa97a0_05192005.nii.gz,/well/papiez/users/hri611/python/nnUnet_raw/Dataset219_PETCT/labelsTr/PETCT_d8e3aa97a0_05192005.nii.gz,0.0,8.982417137145996,0.0
471,0.7623513649304974,103,1316,0.6159675236806496,45436305,2276,3592,2379,/well/papiez/users/hri611/python/nnUNet_results/Dataset219_PETCT/nnUNetTrainer_probabilisticOversampling_033__nnUNetPlans__3d_fullres/crossval_results_folds_0_1_2/PETCT_da6161d7eb_06202003.nii.gz,/well/papiez/users/hri611/python/nnUnet_raw/Dataset219_PETCT/labelsTr/PETCT_da6161d7eb_06202003.nii.gz,0.7623513649304974,2.5628503189086915,0.7091381950378418
472,0.0,0,4806,0.0,52155194,0,4806,0,/well/papiez/users/hri611/python/nnUNet_results/Dataset219_PETCT/nnUNetTrainer_probabilisticOversampling_033__nnUNetPlans__3d_fullres/crossval_results_folds_0_1_2/PETCT_dae86b88e2_06212003.nii.gz,/well/papiez/users/hri611/python/nnUnet_raw/Dataset219_PETCT/labelsTr/PETCT_dae86b88e2_06212003.nii.gz,0.0,59.79154676055908,0.0
473,0.0,0,488,0.0,51039512,0,488,0,/well/papiez/users/hri611/python/nnUNet_results/Dataset219_PETCT/nnUNetTrainer_probabilisticOversampling_033__nnUNetPlans__3d_fullres/crossval_results_folds_0_1_2/PETCT_db3bac356a_08212005.nii.gz,/well/papiez/users/hri611/python/nnUnet_raw/Dataset219_PETCT/labelsTr/PETCT_db3bac356a_08212005.nii.gz,0.0,6.071218231201172,0.0
474,0.8778370686588403,1082,635,0.7822723814354552,52152114,6169,6804,7251,/well/papiez/users/hri611/python/nnUNet_results/Dataset219_PETCT/nnUNetTrainer_probabilisticOversampling_033__nnUNetPlans__3d_fullres/crossval_results_folds_0_1_2/PETCT_db3daf78d2_10302000.nii.gz,/well/papiez/users/hri611/python/nnUnet_raw/Dataset219_PETCT/labelsTr/PETCT_db3daf78d2_10302000.nii.gz,0.8778370686588403,0.7340202369689941,0.0
475,,0,0,,48000000,0,0,0,/well/papiez/users/hri611/python/nnUNet_results/Dataset219_PETCT/nnUNetTrainer_probabilisticOversampling_033__nnUNetPlans__3d_fullres/crossval_results_folds_0_1_2/PETCT_dc15c1d9bb_06032005.nii.gz,/well/papiez/users/hri611/python/nnUnet_raw/Dataset219_PETCT/labelsTr/PETCT_dc15c1d9bb_06032005.nii.gz,,0.0,0.0
476,0.8631095074512518,723,10355,0.7591843832876831,45393998,34924,45279,35647,/well/papiez/users/hri611/python/nnUNet_results/Dataset219_PETCT/nnUNetTrainer_probabilisticOversampling_033__nnUNetPlans__3d_fullres/crossval_results_folds_0_1_2/PETCT_dc6174cb5d_03292003.nii.gz,/well/papiez/users/hri611/python/nnUnet_raw/Dataset219_PETCT/labelsTr/PETCT_dc6174cb5d_03292003.nii.gz,0.8631095074512518,2.2145017318725584,7.0416178665161135
477,0.6919831223628692,337,28,0.5290322580645161,45439225,410,438,747,/well/papiez/users/hri611/python/nnUNet_results/Dataset219_PETCT/nnUNetTrainer_probabilisticOversampling_033__nnUNetPlans__3d_fullres/crossval_results_folds_0_1_2/PETCT_dd68a71e0a_11202004.nii.gz,/well/papiez/users/hri611/python/nnUnet_raw/Dataset219_PETCT/labelsTr/PETCT_dd68a71e0a_11202004.nii.gz,0.6919831223628692,0.3110255241394043,0.4105536918640137
478,0.0,0,384,0.0,47999616,0,384,0,/well/papiez/users/hri611/python/nnUNet_results/Dataset219_PETCT/nnUNetTrainer_probabilisticOversampling_033__nnUNetPlans__3d_fullres/crossval_results_folds_0_1_2/PETCT_dd887591a9_05062006.nii.gz,/well/papiez/users/hri611/python/nnUnet_raw/Dataset219_PETCT/labelsTr/PETCT_dd887591a9_05062006.nii.gz,0.0,4.77735205078125,0.0
479,0.8448922778988138,4273,853,0.7314402472887306,45420913,13961,14814,18234,/well/papiez/users/hri611/python/nnUNet_results/Dataset219_PETCT/nnUNetTrainer_probabilisticOversampling_033__nnUNetPlans__3d_fullres/crossval_results_folds_0_1_2/PETCT_dd975744e7_09232001.nii.gz,/well/papiez/users/hri611/python/nnUnet_raw/Dataset219_PETCT/labelsTr/PETCT_dd975744e7_09232001.nii.gz,0.8448922778988138,0.0,6.892325614929199
480,0.7669735594927983,3726,66586,0.6220252334388758,51973977,115711,182297,119437,/well/papiez/users/hri611/python/nnUNet_results/Dataset219_PETCT/nnUNetTrainer_probabilisticOversampling_033__nnUNetPlans__3d_fullres/crossval_results_folds_0_1_2/PETCT_ddbb3c69f0_08112003.nii.gz,/well/papiez/users/hri611/python/nnUnet_raw/Dataset219_PETCT/labelsTr/PETCT_ddbb3c69f0_08112003.nii.gz,0.7669735594927983,81.27718996810913,2.2145017318725584
481,0.15920915712799166,1616,0,0.08648954211418881,45438231,153,153,1769,/well/papiez/users/hri611/python/nnUNet_results/Dataset219_PETCT/nnUNetTrainer_probabilisticOversampling_033__nnUNetPlans__3d_fullres/crossval_results_folds_0_1_2/PETCT_de118d7ab9_06022001.nii.gz,/well/papiez/users/hri611/python/nnUnet_raw/Dataset219_PETCT/labelsTr/PETCT_de118d7ab9_06022001.nii.gz,0.15920915712799166,0.0,0.0
482,0.0,0,16,0.0,52159984,0,16,0,/well/papiez/users/hri611/python/nnUNet_results/Dataset219_PETCT/nnUNetTrainer_probabilisticOversampling_033__nnUNetPlans__3d_fullres/crossval_results_folds_0_1_2/PETCT_dec9ff6a91_03032003.nii.gz,/well/papiez/users/hri611/python/nnUnet_raw/Dataset219_PETCT/labelsTr/PETCT_dec9ff6a91_03032003.nii.gz,0.0,0.19905633544921875,0.0
483,0.0,0,4,0.0,52159996,0,4,0,/well/papiez/users/hri611/python/nnUNet_results/Dataset219_PETCT/nnUNetTrainer_probabilisticOversampling_033__nnUNetPlans__3d_fullres/crossval_results_folds_0_1_2/PETCT_df2e16771a_11142003.nii.gz,/well/papiez/users/hri611/python/nnUnet_raw/Dataset219_PETCT/labelsTr/PETCT_df2e16771a_11142003.nii.gz,0.0,0.04976408386230469,0.0
484,0.7456464142979029,27224,1097,0.5944467515358068,38650167,41512,42609,68736,/well/papiez/users/hri611/python/nnUNet_results/Dataset219_PETCT/nnUNetTrainer_probabilisticOversampling_033__nnUNetPlans__3d_fullres/crossval_results_folds_0_1_2/PETCT_e03b96666f_05172001.nii.gz,/well/papiez/users/hri611/python/nnUnet_raw/Dataset219_PETCT/labelsTr/PETCT_e03b96666f_05172001.nii.gz,0.7456464142979029,0.0,45.62122388076782
485,0.8051391862955032,556,172,0.6738351254480287,52157768,1504,1676,2060,/well/papiez/users/hri611/python/nnUNet_results/Dataset219_PETCT/nnUNetTrainer_probabilisticOversampling_033__nnUNetPlans__3d_fullres/crossval_results_folds_0_1_2/PETCT_e04b7fa860_06012002.nii.gz,/well/papiez/users/hri611/python/nnUnet_raw/Dataset219_PETCT/labelsTr/PETCT_e04b7fa860_06012002.nii.gz,0.8051391862955032,1.0574867820739746,4.988849407196045
486,,0,0,,47360000,0,0,0,/well/papiez/users/hri611/python/nnUNet_results/Dataset219_PETCT/nnUNetTrainer_probabilisticOversampling_033__nnUNetPlans__3d_fullres/crossval_results_folds_0_1_2/PETCT_e09a20d8fc_03162006.nii.gz,/well/papiez/users/hri611/python/nnUnet_raw/Dataset219_PETCT/labelsTr/PETCT_e09a20d8fc_03162006.nii.gz,,0.0,0.0
487,0.0,0,22,0.0,45439978,0,22,0,/well/papiez/users/hri611/python/nnUNet_results/Dataset219_PETCT/nnUNetTrainer_probabilisticOversampling_033__nnUNetPlans__3d_fullres/crossval_results_folds_0_1_2/PETCT_e0fdc6212a_05292003.nii.gz,/well/papiez/users/hri611/python/nnUnet_raw/Dataset219_PETCT/labelsTr/PETCT_e0fdc6212a_05292003.nii.gz,0.0,0.2737024612426758,0.0
488,0.8901432913590969,4,249,0.8020344287949922,51678722,1025,1274,1029,/well/papiez/users/hri611/python/nnUNet_results/Dataset219_PETCT/nnUNetTrainer_probabilisticOversampling_033__nnUNetPlans__3d_fullres/crossval_results_folds_0_1_2/PETCT_e1a4145b63_03052006.nii.gz,/well/papiez/users/hri611/python/nnUnet_raw/Dataset219_PETCT/labelsTr/PETCT_e1a4145b63_03052006.nii.gz,0.8901432913590969,2.537968276977539,0.0
489,0.0,0,9349,0.0,45430651,0,9349,0,/well/papiez/users/hri611/python/nnUNet_results/Dataset219_PETCT/nnUNetTrainer_probabilisticOversampling_033__nnUNetPlans__3d_fullres/crossval_results_folds_0_1_2/PETCT_e1a5b05186_02272005.nii.gz,/well/papiez/users/hri611/python/nnUnet_raw/Dataset219_PETCT/labelsTr/PETCT_e1a5b05186_02272005.nii.gz,0.0,116.31110500717163,0.0
490,,0,0,,38720000,0,0,0,/well/papiez/users/hri611/python/nnUNet_results/Dataset219_PETCT/nnUNetTrainer_probabilisticOversampling_033__nnUNetPlans__3d_fullres/crossval_results_folds_0_1_2/PETCT_e207c7a1a4_12232005.nii.gz,/well/papiez/users/hri611/python/nnUnet_raw/Dataset219_PETCT/labelsTr/PETCT_e207c7a1a4_12232005.nii.gz,,0.0,0.0
491,0.6057931658746323,41325,10935,0.43450738516474596,52067585,40155,51090,81480,/well/papiez/users/hri611/python/nnUNet_results/Dataset219_PETCT/nnUNetTrainer_probabilisticOversampling_033__nnUNetPlans__3d_fullres/crossval_results_folds_0_1_2/PETCT_e252be4334_07092004.nii.gz,/well/papiez/users/hri611/python/nnUnet_raw/Dataset219_PETCT/labelsTr/PETCT_e252be4334_07092004.nii.gz,0.6057931658746323,2.8116707382202146,6.631064174652099
492,0.0,0,4743,0.0,49915257,0,4743,0,/well/papiez/users/hri611/python/nnUNet_results/Dataset219_PETCT/nnUNetTrainer_probabilisticOversampling_033__nnUNetPlans__3d_fullres/crossval_results_folds_0_1_2/PETCT_e344879c2e_11172006.nii.gz,/well/papiez/users/hri611/python/nnUnet_raw/Dataset219_PETCT/labelsTr/PETCT_e344879c2e_11172006.nii.gz,0.0,59.007762439727784,0.0
493,0.802962962962963,1692,303,0.6707920792079208,52153940,4065,4368,5757,/well/papiez/users/hri611/python/nnUNet_results/Dataset219_PETCT/nnUNetTrainer_probabilisticOversampling_033__nnUNetPlans__3d_fullres/crossval_results_folds_0_1_2/PETCT_e4712dc58c_02121999.nii.gz,/well/papiez/users/hri611/python/nnUnet_raw/Dataset219_PETCT/labelsTr/PETCT_e4712dc58c_02121999.nii.gz,0.802962962962963,0.4727587966918945,3.421280765533447
494,0.0,0,34,0.0,52159966,0,34,0,/well/papiez/users/hri611/python/nnUNet_results/Dataset219_PETCT/nnUNetTrainer_probabilisticOversampling_033__nnUNetPlans__3d_fullres/crossval_results_folds_0_1_2/PETCT_e4e5baf901_02142005.nii.gz,/well/papiez/users/hri611/python/nnUnet_raw/Dataset219_PETCT/labelsTr/PETCT_e4e5baf901_02142005.nii.gz,0.0,0.42299471282958984,0.0
495,0.0,0,1305,0.0,47358695,0,1305,0,/well/papiez/users/hri611/python/nnUNet_results/Dataset219_PETCT/nnUNetTrainer_probabilisticOversampling_033__nnUNetPlans__3d_fullres/crossval_results_folds_0_1_2/PETCT_e52eca67d7_03132006.nii.gz,/well/papiez/users/hri611/python/nnUnet_raw/Dataset219_PETCT/labelsTr/PETCT_e52eca67d7_03132006.nii.gz,0.0,16.235532360076903,0.0
496,0.0,0,58,0.0,45439942,0,58,0,/well/papiez/users/hri611/python/nnUNet_results/Dataset219_PETCT/nnUNetTrainer_probabilisticOversampling_033__nnUNetPlans__3d_fullres/crossval_results_folds_0_1_2/PETCT_e5b1d6b4bd_10232004.nii.gz,/well/papiez/users/hri611/python/nnUnet_raw/Dataset219_PETCT/labelsTr/PETCT_e5b1d6b4bd_10232004.nii.gz,0.0,0.721579216003418,0.0
497,0.0,0,12,0.0,92319988,0,12,0,/well/papiez/users/hri611/python/nnUNet_results/Dataset219_PETCT/nnUNetTrainer_probabilisticOversampling_033__nnUNetPlans__3d_fullres/crossval_results_folds_0_1_2/PETCT_e5c7be07a8_04082005.nii.gz,/well/papiez/users/hri611/python/nnUnet_raw/Dataset219_PETCT/labelsTr/PETCT_e5c7be07a8_04082005.nii.gz,0.0,0.14929225158691406,0.0
498,,0,0,,45440000,0,0,0,/well/papiez/users/hri611/python/nnUNet_results/Dataset219_PETCT/nnUNetTrainer_probabilisticOversampling_033__nnUNetPlans__3d_fullres/crossval_results_folds_0_1_2/PETCT_e5e1918765_07242003.nii.gz,/well/papiez/users/hri611/python/nnUnet_raw/Dataset219_PETCT/labelsTr/PETCT_e5e1918765_07242003.nii.gz,,0.0,0.0
499,0.9544439851178173,737,365,0.9128578206547525,52147354,11544,11909,12281,/well/papiez/users/hri611/python/nnUNet_results/Dataset219_PETCT/nnUNetTrainer_probabilisticOversampling_033__nnUNetPlans__3d_fullres/crossval_results_folds_0_1_2/PETCT_e61c9da258_12132002.nii.gz,/well/papiez/users/hri611/python/nnUnet_raw/Dataset219_PETCT/labelsTr/PETCT_e61c9da258_12132002.nii.gz,0.9544439851178173,0.16173327255249023,0.024882041931152343
500,0.0,0,187,0.0,51839813,0,187,0,/well/papiez/users/hri611/python/nnUNet_results/Dataset219_PETCT/nnUNetTrainer_probabilisticOversampling_033__nnUNetPlans__3d_fullres/crossval_results_folds_0_1_2/PETCT_e664932bbc_06092007.nii.gz,/well/papiez/users/hri611/python/nnUnet_raw/Dataset219_PETCT/labelsTr/PETCT_e664932bbc_06092007.nii.gz,0.0,2.3264709205627443,0.0
501,0.0,0,109,0.0,51199891,0,109,0,/well/papiez/users/hri611/python/nnUNet_results/Dataset219_PETCT/nnUNetTrainer_probabilisticOversampling_033__nnUNetPlans__3d_fullres/crossval_results_folds_0_1_2/PETCT_e68c4577d8_05252007.nii.gz,/well/papiez/users/hri611/python/nnUnet_raw/Dataset219_PETCT/labelsTr/PETCT_e68c4577d8_05252007.nii.gz,0.0,1.3560712852478027,0.0
502,0.0,0,315,0.0,48159685,0,315,0,/well/papiez/users/hri611/python/nnUNet_results/Dataset219_PETCT/nnUNetTrainer_probabilisticOversampling_033__nnUNetPlans__3d_fullres/crossval_results_folds_0_1_2/PETCT_e6a91fef70_03022006.nii.gz,/well/papiez/users/hri611/python/nnUnet_raw/Dataset219_PETCT/labelsTr/PETCT_e6a91fef70_03022006.nii.gz,0.0,3.9189216041564943,0.0
503,0.46601941747572817,108,57,0.3037974683544304,89759763,72,129,180,/well/papiez/users/hri611/python/nnUNet_results/Dataset219_PETCT/nnUNetTrainer_probabilisticOversampling_033__nnUNetPlans__3d_fullres/crossval_results_folds_0_1_2/PETCT_e79291780d_05142007.nii.gz,/well/papiez/users/hri611/python/nnUnet_raw/Dataset219_PETCT/labelsTr/PETCT_e79291780d_05142007.nii.gz,0.46601941747572817,0.7091381950378418,0.0
504,0.0,0,370,0.0,92319630,0,370,0,/well/papiez/users/hri611/python/nnUNet_results/Dataset219_PETCT/nnUNetTrainer_probabilisticOversampling_033__nnUNetPlans__3d_fullres/crossval_results_folds_0_1_2/PETCT_e90a287d09_08222002.nii.gz,/well/papiez/users/hri611/python/nnUnet_raw/Dataset219_PETCT/labelsTr/PETCT_e90a287d09_08222002.nii.gz,0.0,4.603177757263183,0.0
505,0.7879184385563188,1715,230,0.6500539762504498,45434442,3613,3843,5328,/well/papiez/users/hri611/python/nnUNet_results/Dataset219_PETCT/nnUNetTrainer_probabilisticOversampling_033__nnUNetPlans__3d_fullres/crossval_results_folds_0_1_2/PETCT_e9e1a391b5_10112001.nii.gz,/well/papiez/users/hri611/python/nnUnet_raw/Dataset219_PETCT/labelsTr/PETCT_e9e1a391b5_10112001.nii.gz,0.7879184385563188,0.0,0.0
506,0.8847097928918435,7803,1215,0.7932552328113895,52116381,34601,35816,42404,/well/papiez/users/hri611/python/nnUNet_results/Dataset219_PETCT/nnUNetTrainer_probabilisticOversampling_033__nnUNetPlans__3d_fullres/crossval_results_folds_0_1_2/PETCT_ea0fd89f0f_10252003.nii.gz,/well/papiez/users/hri611/python/nnUnet_raw/Dataset219_PETCT/labelsTr/PETCT_ea0fd89f0f_10252003.nii.gz,0.8847097928918435,2.0652094802856444,3.5954550590515137
507,0.882175046109962,13300,2479,0.7891889003193095,47125151,59070,61549,72370,/well/papiez/users/hri611/python/nnUNet_results/Dataset219_PETCT/nnUNetTrainer_probabilisticOversampling_033__nnUNetPlans__3d_fullres/crossval_results_folds_0_1_2/PETCT_ea42c88cc7_02262006.nii.gz,/well/papiez/users/hri611/python/nnUnet_raw/Dataset219_PETCT/labelsTr/PETCT_ea42c88cc7_02262006.nii.gz,0.882175046109962,5.872161895751953,2.5752913398742674
508,0.6737507179781734,11,2261,0.5080121264616717,51515382,2346,4607,2357,/well/papiez/users/hri611/python/nnUNet_results/Dataset219_PETCT/nnUNetTrainer_probabilisticOversampling_033__nnUNetPlans__3d_fullres/crossval_results_folds_0_1_2/PETCT_ea6c621616_08082005.nii.gz,/well/papiez/users/hri611/python/nnUnet_raw/Dataset219_PETCT/labelsTr/PETCT_ea6c621616_08082005.nii.gz,0.6737507179781734,0.9579586143493652,0.0
509,0.9172277766442223,1089,128,0.8471105527638191,45432040,6743,6871,7832,/well/papiez/users/hri611/python/nnUNet_results/Dataset219_PETCT/nnUNetTrainer_probabilisticOversampling_033__nnUNetPlans__3d_fullres/crossval_results_folds_0_1_2/PETCT_ec6b934720_10252002.nii.gz,/well/papiez/users/hri611/python/nnUnet_raw/Dataset219_PETCT/labelsTr/PETCT_ec6b934720_10252002.nii.gz,0.9172277766442223,0.0,0.0
510,,0,0,,56480000,0,0,0,/well/papiez/users/hri611/python/nnUNet_results/Dataset219_PETCT/nnUNetTrainer_probabilisticOversampling_033__nnUNetPlans__3d_fullres/crossval_results_folds_0_1_2/PETCT_eda00de6b0_06242006.nii.gz,/well/papiez/users/hri611/python/nnUnet_raw/Dataset219_PETCT/labelsTr/PETCT_eda00de6b0_06242006.nii.gz,,0.0,0.0
511,0.6086516057137068,3757,106,0.43745449250036406,52153133,3004,3110,6761,/well/papiez/users/hri611/python/nnUNet_results/Dataset219_PETCT/nnUNetTrainer_probabilisticOversampling_033__nnUNetPlans__3d_fullres/crossval_results_folds_0_1_2/PETCT_ee97822c60_03032003.nii.gz,/well/papiez/users/hri611/python/nnUnet_raw/Dataset219_PETCT/labelsTr/PETCT_ee97822c60_03032003.nii.gz,0.6086516057137068,0.9579586143493652,5.586018413543701
512,,0,0,,48160000,0,0,0,/well/papiez/users/hri611/python/nnUNet_results/Dataset219_PETCT/nnUNetTrainer_probabilisticOversampling_033__nnUNetPlans__3d_fullres/crossval_results_folds_0_1_2/PETCT_eee2ede9ad_11242006.nii.gz,/well/papiez/users/hri611/python/nnUnet_raw/Dataset219_PETCT/labelsTr/PETCT_eee2ede9ad_11242006.nii.gz,,0.0,0.0
513,0.8707648919547238,3005,386,0.771110361120486,45425185,11424,11810,14429,/well/papiez/users/hri611/python/nnUNet_results/Dataset219_PETCT/nnUNetTrainer_probabilisticOversampling_033__nnUNetPlans__3d_fullres/crossval_results_folds_0_1_2/PETCT_eeeda112bb_06072003.nii.gz,/well/papiez/users/hri611/python/nnUnet_raw/Dataset219_PETCT/labelsTr/PETCT_eeeda112bb_06072003.nii.gz,0.8707648919547238,0.26126144027709963,0.0
514,0.0,0,6142,0.0,92473858,0,6142,0,/well/papiez/users/hri611/python/nnUNet_results/Dataset219_PETCT/nnUNetTrainer_probabilisticOversampling_033__nnUNetPlans__3d_fullres/crossval_results_folds_0_1_2/PETCT_f068e22258_05142007.nii.gz,/well/papiez/users/hri611/python/nnUnet_raw/Dataset219_PETCT/labelsTr/PETCT_f068e22258_05142007.nii.gz,0.0,76.41275077056885,0.0
515,0.7180113194983908,2316,2766,0.5600761772853186,52148448,6470,9236,8786,/well/papiez/users/hri611/python/nnUNet_results/Dataset219_PETCT/nnUNetTrainer_probabilisticOversampling_033__nnUNetPlans__3d_fullres/crossval_results_folds_0_1_2/PETCT_f11f3d3692_10242003.nii.gz,/well/papiez/users/hri611/python/nnUnet_raw/Dataset219_PETCT/labelsTr/PETCT_f11f3d3692_10242003.nii.gz,0.7180113194983908,2.0403274383544923,16.708291156768798
516,0.9285837601427174,312,2170,0.866688151251477,45421382,16136,18306,16448,/well/papiez/users/hri611/python/nnUNet_results/Dataset219_PETCT/nnUNetTrainer_probabilisticOversampling_033__nnUNetPlans__3d_fullres/crossval_results_folds_0_1_2/PETCT_f1501b1f45_03202005.nii.gz,/well/papiez/users/hri611/python/nnUnet_raw/Dataset219_PETCT/labelsTr/PETCT_f1501b1f45_03202005.nii.gz,0.9285837601427174,2.0154453964233396,1.0450457611083985
517,0.0,0,596,0.0,72159404,0,596,0,/well/papiez/users/hri611/python/nnUNet_results/Dataset219_PETCT/nnUNetTrainer_probabilisticOversampling_033__nnUNetPlans__3d_fullres/crossval_results_folds_0_1_2/PETCT_f1594a7d8a_04252003.nii.gz,/well/papiez/users/hri611/python/nnUnet_raw/Dataset219_PETCT/labelsTr/PETCT_f1594a7d8a_04252003.nii.gz,0.0,7.414848495483398,0.0
518,0.0,0,5,0.0,47519995,0,5,0,/well/papiez/users/hri611/python/nnUNet_results/Dataset219_PETCT/nnUNetTrainer_probabilisticOversampling_033__nnUNetPlans__3d_fullres/crossval_results_folds_0_1_2/PETCT_f15b868db6_02032006.nii.gz,/well/papiez/users/hri611/python/nnUnet_raw/Dataset219_PETCT/labelsTr/PETCT_f15b868db6_02032006.nii.gz,0.0,0.06220510482788086,0.0
519,0.6800155520995335,437,1209,0.5151693667157584,99036605,1749,2958,2186,/well/papiez/users/hri611/python/nnUNet_results/Dataset219_PETCT/nnUNetTrainer_probabilisticOversampling_033__nnUNetPlans__3d_fullres/crossval_results_folds_0_1_2/PETCT_f1ca0f7c4c_12222001.nii.gz,/well/papiez/users/hri611/python/nnUnet_raw/Dataset219_PETCT/labelsTr/PETCT_f1ca0f7c4c_12222001.nii.gz,0.6800155520995335,9.517381038665771,1.0077226982116698
520,0.9043926649263592,7156,7677,0.8254715316099731,45355011,70156,77833,77312,/well/papiez/users/hri611/python/nnUNet_results/Dataset219_PETCT/nnUNetTrainer_probabilisticOversampling_033__nnUNetPlans__3d_fullres/crossval_results_folds_0_1_2/PETCT_f21755a99b_05052005.nii.gz,/well/papiez/users/hri611/python/nnUnet_raw/Dataset219_PETCT/labelsTr/PETCT_f21755a99b_05052005.nii.gz,0.9043926649263592,4.77735205078125,0.435435733795166
521,0.6038485033598046,2419,175,0.43250929774666375,52155429,1977,2152,4396,/well/papiez/users/hri611/python/nnUNet_results/Dataset219_PETCT/nnUNetTrainer_probabilisticOversampling_033__nnUNetPlans__3d_fullres/crossval_results_folds_0_1_2/PETCT_f2f28337ba_05032001.nii.gz,/well/papiez/users/hri611/python/nnUnet_raw/Dataset219_PETCT/labelsTr/PETCT_f2f28337ba_05032001.nii.gz,0.6038485033598046,1.7293019142150878,0.0
522,0.0,0,360,0.0,99039640,0,360,0,/well/papiez/users/hri611/python/nnUNet_results/Dataset219_PETCT/nnUNetTrainer_probabilisticOversampling_033__nnUNetPlans__3d_fullres/crossval_results_folds_0_1_2/PETCT_f4a5ebd915_10032003.nii.gz,/well/papiez/users/hri611/python/nnUnet_raw/Dataset219_PETCT/labelsTr/PETCT_f4a5ebd915_10032003.nii.gz,0.0,4.478767547607422,0.0
523,0.9001453911020646,2203,1231,0.818422165820643,52141088,15478,16709,17681,/well/papiez/users/hri611/python/nnUNet_results/Dataset219_PETCT/nnUNetTrainer_probabilisticOversampling_033__nnUNetPlans__3d_fullres/crossval_results_folds_0_1_2/PETCT_f5c2c09846_10282002.nii.gz,/well/papiez/users/hri611/python/nnUnet_raw/Dataset219_PETCT/labelsTr/PETCT_f5c2c09846_10282002.nii.gz,0.9001453911020646,0.24882041931152343,7.4024074745178225
524,0.7842140086402616,8367,8266,0.6450263567876732,92273143,30224,38490,38591,/well/papiez/users/hri611/python/nnUNet_results/Dataset219_PETCT/nnUNetTrainer_probabilisticOversampling_033__nnUNetPlans__3d_fullres/crossval_results_folds_0_1_2/PETCT_f5c9b0de6c_04022004.nii.gz,/well/papiez/users/hri611/python/nnUnet_raw/Dataset219_PETCT/labelsTr/PETCT_f5c9b0de6c_04022004.nii.gz,0.7842140086402616,27.942533088684083,13.398979579925538
525,0.0,0,151,0.0,65279849,0,151,0,/well/papiez/users/hri611/python/nnUNet_results/Dataset219_PETCT/nnUNetTrainer_probabilisticOversampling_033__nnUNetPlans__3d_fullres/crossval_results_folds_0_1_2/PETCT_f5cff2e59d_05102007.nii.gz,/well/papiez/users/hri611/python/nnUnet_raw/Dataset219_PETCT/labelsTr/PETCT_f5cff2e59d_05102007.nii.gz,0.0,1.878594165802002,0.0
526,0.0,0,1224,0.0,52158776,0,1224,0,/well/papiez/users/hri611/python/nnUNet_results/Dataset219_PETCT/nnUNetTrainer_probabilisticOversampling_033__nnUNetPlans__3d_fullres/crossval_results_folds_0_1_2/PETCT_f603eeceba_03172003.nii.gz,/well/papiez/users/hri611/python/nnUnet_raw/Dataset219_PETCT/labelsTr/PETCT_f603eeceba_03172003.nii.gz,0.0,15.227809661865233,0.0
527,0.8190179424033774,13900,504,0.6935058302834284,52113004,32592,33096,46492,/well/papiez/users/hri611/python/nnUNet_results/Dataset219_PETCT/nnUNetTrainer_probabilisticOversampling_033__nnUNetPlans__3d_fullres/crossval_results_folds_0_1_2/PETCT_f60ea3abc5_05032003.nii.gz,/well/papiez/users/hri611/python/nnUnet_raw/Dataset219_PETCT/labelsTr/PETCT_f60ea3abc5_05032003.nii.gz,0.8190179424033774,0.0,1.6297737464904785
528,0.0,0,6394,0.0,47193606,0,6394,0,/well/papiez/users/hri611/python/nnUNet_results/Dataset219_PETCT/nnUNetTrainer_probabilisticOversampling_033__nnUNetPlans__3d_fullres/crossval_results_folds_0_1_2/PETCT_f6295a93a6_10092006.nii.gz,/well/papiez/users/hri611/python/nnUnet_raw/Dataset219_PETCT/labelsTr/PETCT_f6295a93a6_10092006.nii.gz,0.0,79.54788805389404,0.0
529,0.0,0,512,0.0,47519488,0,512,0,/well/papiez/users/hri611/python/nnUNet_results/Dataset219_PETCT/nnUNetTrainer_probabilisticOversampling_033__nnUNetPlans__3d_fullres/crossval_results_folds_0_1_2/PETCT_f650c87621_12082005.nii.gz,/well/papiez/users/hri611/python/nnUnet_raw/Dataset219_PETCT/labelsTr/PETCT_f650c87621_12082005.nii.gz,0.0,6.369802734375,0.0
530,0.8492357200321802,592,1282,0.7379753914988815,52312848,5278,6560,5870,/well/papiez/users/hri611/python/nnUNet_results/Dataset219_PETCT/nnUNetTrainer_probabilisticOversampling_033__nnUNetPlans__3d_fullres/crossval_results_folds_0_1_2/PETCT_f65602d938_03252007.nii.gz,/well/papiez/users/hri611/python/nnUnet_raw/Dataset219_PETCT/labelsTr/PETCT_f65602d938_03252007.nii.gz,0.8492357200321802,3.1600193252563478,0.012441020965576172
531,0.7542376183610646,5412,895,0.6054426024397873,52144015,9678,10573,15090,/well/papiez/users/hri611/python/nnUNet_results/Dataset219_PETCT/nnUNetTrainer_probabilisticOversampling_033__nnUNetPlans__3d_fullres/crossval_results_folds_0_1_2/PETCT_f7067b7bbb_05262001.nii.gz,/well/papiez/users/hri611/python/nnUnet_raw/Dataset219_PETCT/labelsTr/PETCT_f7067b7bbb_05262001.nii.gz,0.7542376183610646,0.04976408386230469,21.099971557617188
532,0.0,0,1192,0.0,52158808,0,1192,0,/well/papiez/users/hri611/python/nnUNet_results/Dataset219_PETCT/nnUNetTrainer_probabilisticOversampling_033__nnUNetPlans__3d_fullres/crossval_results_folds_0_1_2/PETCT_f7a9267a69_02012003.nii.gz,/well/papiez/users/hri611/python/nnUnet_raw/Dataset219_PETCT/labelsTr/PETCT_f7a9267a69_02012003.nii.gz,0.0,14.829696990966797,0.0
533,0.0,0,433,0.0,52159567,0,433,0,/well/papiez/users/hri611/python/nnUNet_results/Dataset219_PETCT/nnUNetTrainer_probabilisticOversampling_033__nnUNetPlans__3d_fullres/crossval_results_folds_0_1_2/PETCT_f7a9267a69_11012002.nii.gz,/well/papiez/users/hri611/python/nnUnet_raw/Dataset219_PETCT/labelsTr/PETCT_f7a9267a69_11012002.nii.gz,0.0,5.3869620780944825,0.0
534,0.0,0,66,0.0,45439934,0,66,0,/well/papiez/users/hri611/python/nnUNet_results/Dataset219_PETCT/nnUNetTrainer_probabilisticOversampling_033__nnUNetPlans__3d_fullres/crossval_results_folds_0_1_2/PETCT_f8314eb3f7_03142003.nii.gz,/well/papiez/users/hri611/python/nnUnet_raw/Dataset219_PETCT/labelsTr/PETCT_f8314eb3f7_03142003.nii.gz,0.0,0.8211073837280274,0.0
535,0.0,0,3683,0.0,45436317,0,3683,0,/well/papiez/users/hri611/python/nnUNet_results/Dataset219_PETCT/nnUNetTrainer_probabilisticOversampling_033__nnUNetPlans__3d_fullres/crossval_results_folds_0_1_2/PETCT_f8314eb3f7_09202003.nii.gz,/well/papiez/users/hri611/python/nnUnet_raw/Dataset219_PETCT/labelsTr/PETCT_f8314eb3f7_09202003.nii.gz,0.0,45.82028021621704,0.0
536,0.0,0,110,0.0,52319890,0,110,0,/well/papiez/users/hri611/python/nnUNet_results/Dataset219_PETCT/nnUNetTrainer_probabilisticOversampling_033__nnUNetPlans__3d_fullres/crossval_results_folds_0_1_2/PETCT_f8aac0e202_02262006.nii.gz,/well/papiez/users/hri611/python/nnUnet_raw/Dataset219_PETCT/labelsTr/PETCT_f8aac0e202_02262006.nii.gz,0.0,1.3685123062133788,0.0
537,,0,0,,50880000,0,0,0,/well/papiez/users/hri611/python/nnUNet_results/Dataset219_PETCT/nnUNetTrainer_probabilisticOversampling_033__nnUNetPlans__3d_fullres/crossval_results_folds_0_1_2/PETCT_f8aac0e202_07302006.nii.gz,/well/papiez/users/hri611/python/nnUnet_raw/Dataset219_PETCT/labelsTr/PETCT_f8aac0e202_07302006.nii.gz,,0.0,0.0
538,,0,0,,53440000,0,0,0,/well/papiez/users/hri611/python/nnUNet_results/Dataset219_PETCT/nnUNetTrainer_probabilisticOversampling_033__nnUNetPlans__3d_fullres/crossval_results_folds_0_1_2/PETCT_f8de0cde56_12052005.nii.gz,/well/papiez/users/hri611/python/nnUnet_raw/Dataset219_PETCT/labelsTr/PETCT_f8de0cde56_12052005.nii.gz,,0.0,0.0
539,0.7260988524299746,422,13493,0.5699805309187552,63487641,18444,31937,18866,/well/papiez/users/hri611/python/nnUNet_results/Dataset219_PETCT/nnUNetTrainer_probabilisticOversampling_033__nnUNetPlans__3d_fullres/crossval_results_folds_0_1_2/PETCT_f9c4d4f9ab_03222007.nii.gz,/well/papiez/users/hri611/python/nnUnet_raw/Dataset219_PETCT/labelsTr/PETCT_f9c4d4f9ab_03222007.nii.gz,0.7260988524299746,5.013731449127198,0.0
540,0.9081947011706716,112,186,0.8318284424379232,52158228,1474,1660,1586,/well/papiez/users/hri611/python/nnUNet_results/Dataset219_PETCT/nnUNetTrainer_probabilisticOversampling_033__nnUNetPlans__3d_fullres/crossval_results_folds_0_1_2/PETCT_f9e0c504af_06292003.nii.gz,/well/papiez/users/hri611/python/nnUnet_raw/Dataset219_PETCT/labelsTr/PETCT_f9e0c504af_06292003.nii.gz,0.9081947011706716,1.59245068359375,0.012441020965576172
541,0.0,0,20,0.0,45439980,0,20,0,/well/papiez/users/hri611/python/nnUNet_results/Dataset219_PETCT/nnUNetTrainer_probabilisticOversampling_033__nnUNetPlans__3d_fullres/crossval_results_folds_0_1_2/PETCT_fa45f610c4_10072004.nii.gz,/well/papiez/users/hri611/python/nnUnet_raw/Dataset219_PETCT/labelsTr/PETCT_fa45f610c4_10072004.nii.gz,0.0,0.24882041931152343,0.0
542,0.6434216643421664,2822,246,0.4742974640164496,52154164,2768,3014,5590,/well/papiez/users/hri611/python/nnUNet_results/Dataset219_PETCT/nnUNetTrainer_probabilisticOversampling_033__nnUNetPlans__3d_fullres/crossval_results_folds_0_1_2/PETCT_faf4a6dbaa_01102003.nii.gz,/well/papiez/users/hri611/python/nnUnet_raw/Dataset219_PETCT/labelsTr/PETCT_faf4a6dbaa_01102003.nii.gz,0.6434216643421664,2.625055423736572,8.609186508178711
543,0.40889437924644845,0,1914,0.25698757763975155,47997424,662,2576,662,/well/papiez/users/hri611/python/nnUNet_results/Dataset219_PETCT/nnUNetTrainer_probabilisticOversampling_033__nnUNetPlans__3d_fullres/crossval_results_folds_0_1_2/PETCT_fb014a1ea0_12012005.nii.gz,/well/papiez/users/hri611/python/nnUnet_raw/Dataset219_PETCT/labelsTr/PETCT_fb014a1ea0_12012005.nii.gz,0.40889437924644845,0.0,0.0
544,0.0,0,77,0.0,95519923,0,77,0,/well/papiez/users/hri611/python/nnUNet_results/Dataset219_PETCT/nnUNetTrainer_probabilisticOversampling_033__nnUNetPlans__3d_fullres/crossval_results_folds_0_1_2/PETCT_fc0389a486_05302005.nii.gz,/well/papiez/users/hri611/python/nnUnet_raw/Dataset219_PETCT/labelsTr/PETCT_fc0389a486_05302005.nii.gz,0.0,0.9579586143493652,0.0
545,0.8552246514029953,1280,402,0.7470676691729323,99033350,4968,5370,6248,/well/papiez/users/hri611/python/nnUNet_results/Dataset219_PETCT/nnUNetTrainer_probabilisticOversampling_033__nnUNetPlans__3d_fullres/crossval_results_folds_0_1_2/PETCT_fcdbe15200_12142003.nii.gz,/well/papiez/users/hri611/python/nnUnet_raw/Dataset219_PETCT/labelsTr/PETCT_fcdbe15200_12142003.nii.gz,0.8552246514029953,0.37323062896728515,0.06220510482788086
546,0.40468227424749165,249,463,0.25366876310272535,47839046,242,705,491,/well/papiez/users/hri611/python/nnUNet_results/Dataset219_PETCT/nnUNetTrainer_probabilisticOversampling_033__nnUNetPlans__3d_fullres/crossval_results_folds_0_1_2/PETCT_fde66dd53a_12222005.nii.gz,/well/papiez/users/hri611/python/nnUnet_raw/Dataset219_PETCT/labelsTr/PETCT_fde66dd53a_12222005.nii.gz,0.40468227424749165,4.603177757263183,3.0107270736694334
547,0.0,0,93,0.0,92319907,0,93,0,/well/papiez/users/hri611/python/nnUNet_results/Dataset219_PETCT/nnUNetTrainer_probabilisticOversampling_033__nnUNetPlans__3d_fullres/crossval_results_folds_0_1_2/PETCT_fde79b6aa9_02232003.nii.gz,/well/papiez/users/hri611/python/nnUnet_raw/Dataset219_PETCT/labelsTr/PETCT_fde79b6aa9_02232003.nii.gz,0.0,1.157014949798584,0.0
548,,0,0,,92320000,0,0,0,/well/papiez/users/hri611/python/nnUNet_results/Dataset219_PETCT/nnUNetTrainer_probabilisticOversampling_033__nnUNetPlans__3d_fullres/crossval_results_folds_0_1_2/PETCT_fde79b6aa9_08162003.nii.gz,/well/papiez/users/hri611/python/nnUnet_raw/Dataset219_PETCT/labelsTr/PETCT_fde79b6aa9_08162003.nii.gz,,0.0,0.0
549,0.0,0,334,0.0,45439666,0,334,0,/well/papiez/users/hri611/python/nnUNet_results/Dataset219_PETCT/nnUNetTrainer_probabilisticOversampling_033__nnUNetPlans__3d_fullres/crossval_results_folds_0_1_2/PETCT_fe705ea1cc_04272003.nii.gz,/well/papiez/users/hri611/python/nnUnet_raw/Dataset219_PETCT/labelsTr/PETCT_fe705ea1cc_04272003.nii.gz,0.0,4.1553010025024415,0.0
550,0.767626925960864,5198,4409,0.6228851815505397,45414525,15868,20277,21066,/well/papiez/users/hri611/python/nnUNet_results/Dataset219_PETCT/nnUNetTrainer_probabilisticOversampling_033__nnUNetPlans__3d_fullres/crossval_results_folds_0_1_2/PETCT_fe705ea1cc_12292002.nii.gz,/well/papiez/users/hri611/python/nnUnet_raw/Dataset219_PETCT/labelsTr/PETCT_fe705ea1cc_12292002.nii.gz,0.767626925960864,5.722869644165039,14.369379215240478
551,0.0,0,62,0.0,52159938,0,62,0,/well/papiez/users/hri611/python/nnUNet_results/Dataset219_PETCT/nnUNetTrainer_probabilisticOversampling_033__nnUNetPlans__3d_fullres/crossval_results_folds_0_1_2/PETCT_ff1451316e_03312003.nii.gz,/well/papiez/users/hri611/python/nnUnet_raw/Dataset219_PETCT/labelsTr/PETCT_ff1451316e_03312003.nii.gz,0.0,0.7713432998657226,0.0
