,DICE,FN,FP,IoU,TN,TP,n_pred,n_ref,prediction_file,reference_file,challenge_DICE,challenge_FP,challenge_FN
0,0.8956587966488957,123,151,0.8110344827586207,52158550,1176,1327,1299,/well/papiez/users/hri611/python/nnUNet_results/Dataset219_PETCT/nnUNetTrainer_1500epochs__nnUNetPlans__3d_fullres/crossval_results_folds_0_1_2_3_4/PETCT_0011f3deaf_03232003.nii.gz,/well/papiez/users/hri611/python/nnUnet_raw/Dataset219_PETCT/labelsTr/PETCT_0011f3deaf_03232003.nii.gz,0.8956587966488957,0.8335484046936035,0.0
1,0.7152648265572548,42,12172,0.5567410633278896,48772445,15341,27513,15383,/well/papiez/users/hri611/python/nnUNet_results/Dataset219_PETCT/nnUNetTrainer_1500epochs__nnUNetPlans__3d_fullres/crossval_results_folds_0_1_2_3_4/PETCT_01140d52d8_08132005.nii.gz,/well/papiez/users/hri611/python/nnUnet_raw/Dataset219_PETCT/labelsTr/PETCT_01140d52d8_08132005.nii.gz,0.7152648265572548,138.4187992630005,0.12441020965576172
2,0.7576074672470805,5403,388,0.6097971834782023,45425159,9050,9438,14453,/well/papiez/users/hri611/python/nnUNet_results/Dataset219_PETCT/nnUNetTrainer_1500epochs__nnUNetPlans__3d_fullres/crossval_results_folds_0_1_2_3_4/PETCT_0117d7f11f_09132001.nii.gz,/well/papiez/users/hri611/python/nnUnet_raw/Dataset219_PETCT/labelsTr/PETCT_0117d7f11f_09132001.nii.gz,0.7576074672470805,0.0,0.09952816772460937
3,0.0,0,551,0.0,46079449,0,551,0,/well/papiez/users/hri611/python/nnUNet_results/Dataset219_PETCT/nnUNetTrainer_1500epochs__nnUNetPlans__3d_fullres/crossval_results_folds_0_1_2_3_4/PETCT_0143bab87a_07172005.nii.gz,/well/papiez/users/hri611/python/nnUnet_raw/Dataset219_PETCT/labelsTr/PETCT_0143bab87a_07172005.nii.gz,0.0,6.85500255203247,0.0
4,0.6518734902533565,5991,206,0.4835402950245854,52148001,5802,6008,11793,/well/papiez/users/hri611/python/nnUNet_results/Dataset219_PETCT/nnUNetTrainer_1500epochs__nnUNetPlans__3d_fullres/crossval_results_folds_0_1_2_3_4/PETCT_01682f60c3_03112002.nii.gz,/well/papiez/users/hri611/python/nnUnet_raw/Dataset219_PETCT/labelsTr/PETCT_01682f60c3_03112002.nii.gz,0.6518734902533565,0.037323062896728515,13.448743663787841
5,0.485321289262985,1860,3154,0.32041203578205474,52152622,2364,5518,4224,/well/papiez/users/hri611/python/nnUNet_results/Dataset219_PETCT/nnUNetTrainer_1500epochs__nnUNetPlans__3d_fullres/crossval_results_folds_0_1_2_3_4/PETCT_0168f65af8_04042003.nii.gz,/well/papiez/users/hri611/python/nnUnet_raw/Dataset219_PETCT/labelsTr/PETCT_0168f65af8_04042003.nii.gz,0.485321289262985,0.037323062896728515,11.79408787536621
6,0.7,1,5,0.5384615384615384,99039987,7,12,8,/well/papiez/users/hri611/python/nnUNet_results/Dataset219_PETCT/nnUNetTrainer_1500epochs__nnUNetPlans__3d_fullres/crossval_results_folds_0_1_2_3_4/PETCT_0223010e46_09042003.nii.gz,/well/papiez/users/hri611/python/nnUnet_raw/Dataset219_PETCT/labelsTr/PETCT_0223010e46_09042003.nii.gz,0.7,0.0,0.012441020965576172
7,,0,0,,37120000,0,0,0,/well/papiez/users/hri611/python/nnUNet_results/Dataset219_PETCT/nnUNetTrainer_1500epochs__nnUNetPlans__3d_fullres/crossval_results_folds_0_1_2_3_4/PETCT_0225325b91_08222005.nii.gz,/well/papiez/users/hri611/python/nnUnet_raw/Dataset219_PETCT/labelsTr/PETCT_0225325b91_08222005.nii.gz,,0.0,0.0
8,0.0,0,2515,0.0,45437485,0,2515,0,/well/papiez/users/hri611/python/nnUNet_results/Dataset219_PETCT/nnUNetTrainer_1500epochs__nnUNetPlans__3d_fullres/crossval_results_folds_0_1_2_3_4/PETCT_0410759456_08222003.nii.gz,/well/papiez/users/hri611/python/nnUnet_raw/Dataset219_PETCT/labelsTr/PETCT_0410759456_08222003.nii.gz,0.0,31.289167728424072,0.0
9,,0,0,,45440000,0,0,0,/well/papiez/users/hri611/python/nnUNet_results/Dataset219_PETCT/nnUNetTrainer_1500epochs__nnUNetPlans__3d_fullres/crossval_results_folds_0_1_2_3_4/PETCT_0410759456_11072002.nii.gz,/well/papiez/users/hri611/python/nnUnet_raw/Dataset219_PETCT/labelsTr/PETCT_0410759456_11072002.nii.gz,,0.0,0.0
10,0.8130369562252829,575,3538,0.6849724264705882,45426944,8943,12481,9518,/well/papiez/users/hri611/python/nnUNet_results/Dataset219_PETCT/nnUNetTrainer_1500epochs__nnUNetPlans__3d_fullres/crossval_results_folds_0_1_2_3_4/PETCT_04606080a0_02202003.nii.gz,/well/papiez/users/hri611/python/nnUnet_raw/Dataset219_PETCT/labelsTr/PETCT_04606080a0_02202003.nii.gz,0.8130369562252829,5.94680802154541,0.0
11,0.8947092718700891,574,1637,0.809478672985782,45428395,9394,11031,9968,/well/papiez/users/hri611/python/nnUNet_results/Dataset219_PETCT/nnUNetTrainer_1500epochs__nnUNetPlans__3d_fullres/crossval_results_folds_0_1_2_3_4/PETCT_04a4e1c874_11182001.nii.gz,/well/papiez/users/hri611/python/nnUnet_raw/Dataset219_PETCT/labelsTr/PETCT_04a4e1c874_11182001.nii.gz,0.8947092718700891,13.697564083099365,0.0
12,0.8399386346203017,453,799,0.7240467269120564,45435463,3285,4084,3738,/well/papiez/users/hri611/python/nnUNet_results/Dataset219_PETCT/nnUNetTrainer_1500epochs__nnUNetPlans__3d_fullres/crossval_results_folds_0_1_2_3_4/PETCT_04ab5c61c9_11222002.nii.gz,/well/papiez/users/hri611/python/nnUnet_raw/Dataset219_PETCT/labelsTr/PETCT_04ab5c61c9_11222002.nii.gz,0.8399386346203017,4.329475296020508,0.0
13,0.0,0,117,0.0,51839883,0,117,0,/well/papiez/users/hri611/python/nnUNet_results/Dataset219_PETCT/nnUNetTrainer_1500epochs__nnUNetPlans__3d_fullres/crossval_results_folds_0_1_2_3_4/PETCT_05808cf24e_03182006.nii.gz,/well/papiez/users/hri611/python/nnUnet_raw/Dataset219_PETCT/labelsTr/PETCT_05808cf24e_03182006.nii.gz,0.0,1.4555994529724121,0.0
14,0.4941910277939614,11837,2922,0.32818972188083206,65578031,7210,10132,19047,/well/papiez/users/hri611/python/nnUNet_results/Dataset219_PETCT/nnUNetTrainer_1500epochs__nnUNetPlans__3d_fullres/crossval_results_folds_0_1_2_3_4/PETCT_05808cf24e_07291999.nii.gz,/well/papiez/users/hri611/python/nnUnet_raw/Dataset219_PETCT/labelsTr/PETCT_05808cf24e_07291999.nii.gz,0.4941910277939614,35.245412395477295,121.73539014816284
15,,0,0,,52160000,0,0,0,/well/papiez/users/hri611/python/nnUNet_results/Dataset219_PETCT/nnUNetTrainer_1500epochs__nnUNetPlans__3d_fullres/crossval_results_folds_0_1_2_3_4/PETCT_05bed31780_11242003.nii.gz,/well/papiez/users/hri611/python/nnUnet_raw/Dataset219_PETCT/labelsTr/PETCT_05bed31780_11242003.nii.gz,,0.0,0.0
16,0.0,0,175,0.0,92319825,0,175,0,/well/papiez/users/hri611/python/nnUNet_results/Dataset219_PETCT/nnUNetTrainer_1500epochs__nnUNetPlans__3d_fullres/crossval_results_folds_0_1_2_3_4/PETCT_05d8640f52_02242005.nii.gz,/well/papiez/users/hri611/python/nnUnet_raw/Dataset219_PETCT/labelsTr/PETCT_05d8640f52_02242005.nii.gz,0.0,2.17717866897583,0.0
17,0.8670411985018727,0,142,0.7652892561983471,40639395,463,605,463,/well/papiez/users/hri611/python/nnUNet_results/Dataset219_PETCT/nnUNetTrainer_1500epochs__nnUNetPlans__3d_fullres/crossval_results_folds_0_1_2_3_4/PETCT_06a46414eb_03122006.nii.gz,/well/papiez/users/hri611/python/nnUnet_raw/Dataset219_PETCT/labelsTr/PETCT_06a46414eb_03122006.nii.gz,0.8670411985018727,0.4603177757263184,0.0
18,,0,0,,38720000,0,0,0,/well/papiez/users/hri611/python/nnUNet_results/Dataset219_PETCT/nnUNetTrainer_1500epochs__nnUNetPlans__3d_fullres/crossval_results_folds_0_1_2_3_4/PETCT_06d55e8295_04172003.nii.gz,/well/papiez/users/hri611/python/nnUnet_raw/Dataset219_PETCT/labelsTr/PETCT_06d55e8295_04172003.nii.gz,,0.0,0.0
19,0.5715309825709037,7512,2051,0.4001003701147983,45424059,6378,8429,13890,/well/papiez/users/hri611/python/nnUNet_results/Dataset219_PETCT/nnUNetTrainer_1500epochs__nnUNetPlans__3d_fullres/crossval_results_folds_0_1_2_3_4/PETCT_06e7c24059_04222005.nii.gz,/well/papiez/users/hri611/python/nnUnet_raw/Dataset219_PETCT/labelsTr/PETCT_06e7c24059_04222005.nii.gz,0.5715309825709037,8.87044794845581,41.88891759109497
20,0.0,0,2774,0.0,38877226,0,2774,0,/well/papiez/users/hri611/python/nnUNet_results/Dataset219_PETCT/nnUNetTrainer_1500epochs__nnUNetPlans__3d_fullres/crossval_results_folds_0_1_2_3_4/PETCT_072833774e_07232006.nii.gz,/well/papiez/users/hri611/python/nnUnet_raw/Dataset219_PETCT/labelsTr/PETCT_072833774e_07232006.nii.gz,0.0,34.5113921585083,0.0
21,0.8704625470438266,7609,5195,0.7706362854686156,45384176,43020,48215,50629,/well/papiez/users/hri611/python/nnUNet_results/Dataset219_PETCT/nnUNetTrainer_1500epochs__nnUNetPlans__3d_fullres/crossval_results_folds_0_1_2_3_4/PETCT_07574bfa00_04202003.nii.gz,/well/papiez/users/hri611/python/nnUnet_raw/Dataset219_PETCT/labelsTr/PETCT_07574bfa00_04202003.nii.gz,0.8704625470438266,35.17076626968384,0.3359075660705566
22,0.0,0,236,0.0,45439764,0,236,0,/well/papiez/users/hri611/python/nnUNet_results/Dataset219_PETCT/nnUNetTrainer_1500epochs__nnUNetPlans__3d_fullres/crossval_results_folds_0_1_2_3_4/PETCT_07b7e9abfc_02102003.nii.gz,/well/papiez/users/hri611/python/nnUnet_raw/Dataset219_PETCT/labelsTr/PETCT_07b7e9abfc_02102003.nii.gz,0.0,2.9360809478759764,0.0
23,0.0,0,125,0.0,94079875,0,125,0,/well/papiez/users/hri611/python/nnUNet_results/Dataset219_PETCT/nnUNetTrainer_1500epochs__nnUNetPlans__3d_fullres/crossval_results_folds_0_1_2_3_4/PETCT_07fec0d985_05042006.nii.gz,/well/papiez/users/hri611/python/nnUnet_raw/Dataset219_PETCT/labelsTr/PETCT_07fec0d985_05042006.nii.gz,0.0,1.5551276206970215,0.0
24,0.0,0,105,0.0,41439895,0,105,0,/well/papiez/users/hri611/python/nnUNet_results/Dataset219_PETCT/nnUNetTrainer_1500epochs__nnUNetPlans__3d_fullres/crossval_results_folds_0_1_2_3_4/PETCT_080922db5a_01282006.nii.gz,/well/papiez/users/hri611/python/nnUnet_raw/Dataset219_PETCT/labelsTr/PETCT_080922db5a_01282006.nii.gz,0.0,1.306307201385498,0.0
25,,0,0,,49440000,0,0,0,/well/papiez/users/hri611/python/nnUNet_results/Dataset219_PETCT/nnUNetTrainer_1500epochs__nnUNetPlans__3d_fullres/crossval_results_folds_0_1_2_3_4/PETCT_08198c4f0c_11102005.nii.gz,/well/papiez/users/hri611/python/nnUnet_raw/Dataset219_PETCT/labelsTr/PETCT_08198c4f0c_11102005.nii.gz,,0.0,0.0
26,0.870392080239677,1192,1793,0.7705258302583026,52146992,10023,11816,11215,/well/papiez/users/hri611/python/nnUNet_results/Dataset219_PETCT/nnUNetTrainer_1500epochs__nnUNetPlans__3d_fullres/crossval_results_folds_0_1_2_3_4/PETCT_08212d7f6c_09112003.nii.gz,/well/papiez/users/hri611/python/nnUnet_raw/Dataset219_PETCT/labelsTr/PETCT_08212d7f6c_09112003.nii.gz,0.870392080239677,0.0,0.0
27,0.0,0,1605,0.0,52158395,0,1605,0,/well/papiez/users/hri611/python/nnUNet_results/Dataset219_PETCT/nnUNetTrainer_1500epochs__nnUNetPlans__3d_fullres/crossval_results_folds_0_1_2_3_4/PETCT_098c4b7b87_08312003.nii.gz,/well/papiez/users/hri611/python/nnUnet_raw/Dataset219_PETCT/labelsTr/PETCT_098c4b7b87_08312003.nii.gz,0.0,19.967838649749755,0.0
28,0.696211358177733,1697,2224,0.533990967435227,94871586,4493,6717,6190,/well/papiez/users/hri611/python/nnUNet_results/Dataset219_PETCT/nnUNetTrainer_1500epochs__nnUNetPlans__3d_fullres/crossval_results_folds_0_1_2_3_4/PETCT_09ee00bdc6_09302005.nii.gz,/well/papiez/users/hri611/python/nnUnet_raw/Dataset219_PETCT/labelsTr/PETCT_09ee00bdc6_09302005.nii.gz,0.696211358177733,6.071218231201172,20.639653781890868
29,,0,0,,48640000,0,0,0,/well/papiez/users/hri611/python/nnUNet_results/Dataset219_PETCT/nnUNetTrainer_1500epochs__nnUNetPlans__3d_fullres/crossval_results_folds_0_1_2_3_4/PETCT_0af7ffe12a_08122005.nii.gz,/well/papiez/users/hri611/python/nnUnet_raw/Dataset219_PETCT/labelsTr/PETCT_0af7ffe12a_08122005.nii.gz,,0.0,0.0
30,0.8182556000432853,2518,4200,0.6924133510370404,52138159,15123,19323,17641,/well/papiez/users/hri611/python/nnUNet_results/Dataset219_PETCT/nnUNetTrainer_1500epochs__nnUNetPlans__3d_fullres/crossval_results_folds_0_1_2_3_4/PETCT_0b57b247b6_05022002.nii.gz,/well/papiez/users/hri611/python/nnUnet_raw/Dataset219_PETCT/labelsTr/PETCT_0b57b247b6_05022002.nii.gz,0.8182556000432853,4.565854694366455,0.0
31,0.8593225083986562,6883,1157,0.7533439685851024,52127404,24556,25713,31439,/well/papiez/users/hri611/python/nnUNet_results/Dataset219_PETCT/nnUNetTrainer_1500epochs__nnUNetPlans__3d_fullres/crossval_results_folds_0_1_2_3_4/PETCT_0b98dbe00d_08112002.nii.gz,/well/papiez/users/hri611/python/nnUnet_raw/Dataset219_PETCT/labelsTr/PETCT_0b98dbe00d_08112002.nii.gz,0.8593225083986562,0.0,3.570573017120361
32,0.9143195767195768,3383,6738,0.8421627185253341,52095877,54002,60740,57385,/well/papiez/users/hri611/python/nnUNet_results/Dataset219_PETCT/nnUNetTrainer_1500epochs__nnUNetPlans__3d_fullres/crossval_results_folds_0_1_2_3_4/PETCT_0beb67c923_07251999.nii.gz,/well/papiez/users/hri611/python/nnUnet_raw/Dataset219_PETCT/labelsTr/PETCT_0beb67c923_07251999.nii.gz,0.9143195767195768,2.0030043754577638,0.14929225158691406
33,0.0,0,7,0.0,52159993,0,7,0,/well/papiez/users/hri611/python/nnUNet_results/Dataset219_PETCT/nnUNetTrainer_1500epochs__nnUNetPlans__3d_fullres/crossval_results_folds_0_1_2_3_4/PETCT_0c13e4df10_10112003.nii.gz,/well/papiez/users/hri611/python/nnUnet_raw/Dataset219_PETCT/labelsTr/PETCT_0c13e4df10_10112003.nii.gz,0.0,0.0870871467590332,0.0
34,0.4416228186010605,7301,20184,0.2833863482296501,52121646,10869,31053,18170,/well/papiez/users/hri611/python/nnUNet_results/Dataset219_PETCT/nnUNetTrainer_1500epochs__nnUNetPlans__3d_fullres/crossval_results_folds_0_1_2_3_4/PETCT_0cda25453b_10122003.nii.gz,/well/papiez/users/hri611/python/nnUnet_raw/Dataset219_PETCT/labelsTr/PETCT_0cda25453b_10122003.nii.gz,0.4416228186010605,19.146731266021728,11.619913581848145
35,0.8332695252679939,3114,370,0.7141919606234619,45427810,8706,9076,11820,/well/papiez/users/hri611/python/nnUNet_results/Dataset219_PETCT/nnUNetTrainer_1500epochs__nnUNetPlans__3d_fullres/crossval_results_folds_0_1_2_3_4/PETCT_0e2034240b_01312003.nii.gz,/well/papiez/users/hri611/python/nnUnet_raw/Dataset219_PETCT/labelsTr/PETCT_0e2034240b_01312003.nii.gz,0.8332695252679939,0.04976408386230469,1.1072508659362792
36,,0,0,,52160000,0,0,0,/well/papiez/users/hri611/python/nnUNet_results/Dataset219_PETCT/nnUNetTrainer_1500epochs__nnUNetPlans__3d_fullres/crossval_results_folds_0_1_2_3_4/PETCT_0e9a98ecda_02202003.nii.gz,/well/papiez/users/hri611/python/nnUnet_raw/Dataset219_PETCT/labelsTr/PETCT_0e9a98ecda_02202003.nii.gz,,0.0,0.0
37,0.874893913852235,9065,1696,0.7776101512771761,52111612,37627,39323,46692,/well/papiez/users/hri611/python/nnUNet_results/Dataset219_PETCT/nnUNetTrainer_1500epochs__nnUNetPlans__3d_fullres/crossval_results_folds_0_1_2_3_4/PETCT_0ea07b421b_10272001.nii.gz,/well/papiez/users/hri611/python/nnUnet_raw/Dataset219_PETCT/labelsTr/PETCT_0ea07b421b_10272001.nii.gz,0.874893913852235,0.1741742935180664,31.97342388153076
38,0.5760517799352751,126,136,0.40454545454545454,45439560,178,314,304,/well/papiez/users/hri611/python/nnUNet_results/Dataset219_PETCT/nnUNetTrainer_1500epochs__nnUNetPlans__3d_fullres/crossval_results_folds_0_1_2_3_4/PETCT_0f4ee9e078_02102005.nii.gz,/well/papiez/users/hri611/python/nnUnet_raw/Dataset219_PETCT/labelsTr/PETCT_0f4ee9e078_02102005.nii.gz,0.5760517799352751,1.3685123062133788,1.530245578765869
39,0.6862745098039216,198,26,0.5223880597014925,45439531,245,271,443,/well/papiez/users/hri611/python/nnUNet_results/Dataset219_PETCT/nnUNetTrainer_1500epochs__nnUNetPlans__3d_fullres/crossval_results_folds_0_1_2_3_4/PETCT_0fa313309d_04232005.nii.gz,/well/papiez/users/hri611/python/nnUnet_raw/Dataset219_PETCT/labelsTr/PETCT_0fa313309d_04232005.nii.gz,0.6862745098039216,0.0,1.1196918869018555
40,,0,0,,46080000,0,0,0,/well/papiez/users/hri611/python/nnUNet_results/Dataset219_PETCT/nnUNetTrainer_1500epochs__nnUNetPlans__3d_fullres/crossval_results_folds_0_1_2_3_4/PETCT_0fa313309d_10032005.nii.gz,/well/papiez/users/hri611/python/nnUnet_raw/Dataset219_PETCT/labelsTr/PETCT_0fa313309d_10032005.nii.gz,,0.0,0.0
41,0.6735751295336787,27,162,0.5078125,54079616,195,357,222,/well/papiez/users/hri611/python/nnUNet_results/Dataset219_PETCT/nnUNetTrainer_1500epochs__nnUNetPlans__3d_fullres/crossval_results_folds_0_1_2_3_4/PETCT_1019ae8551_04062007.nii.gz,/well/papiez/users/hri611/python/nnUnet_raw/Dataset219_PETCT/labelsTr/PETCT_1019ae8551_04062007.nii.gz,0.6735751295336787,1.6297737464904785,0.0
42,0.3400850719060158,5619,897,0.2048810250152532,45431805,1679,2576,7298,/well/papiez/users/hri611/python/nnUNet_results/Dataset219_PETCT/nnUNetTrainer_1500epochs__nnUNetPlans__3d_fullres/crossval_results_folds_0_1_2_3_4/PETCT_108c1763d4_09302004.nii.gz,/well/papiez/users/hri611/python/nnUnet_raw/Dataset219_PETCT/labelsTr/PETCT_108c1763d4_09302004.nii.gz,0.3400850719060158,10.761483135223388,0.012441020965576172
43,0.7612933903946743,343,661,0.6145873320537428,45437395,1601,2262,1944,/well/papiez/users/hri611/python/nnUNet_results/Dataset219_PETCT/nnUNetTrainer_1500epochs__nnUNetPlans__3d_fullres/crossval_results_folds_0_1_2_3_4/PETCT_119165872d_02122005.nii.gz,/well/papiez/users/hri611/python/nnUnet_raw/Dataset219_PETCT/labelsTr/PETCT_119165872d_02122005.nii.gz,0.7612933903946743,4.540972652435302,2.1274145851135255
44,0.5733788395904437,123,2,0.4019138755980861,45439791,84,86,207,/well/papiez/users/hri611/python/nnUNet_results/Dataset219_PETCT/nnUNetTrainer_1500epochs__nnUNetPlans__3d_fullres/crossval_results_folds_0_1_2_3_4/PETCT_11afab3485_05252003.nii.gz,/well/papiez/users/hri611/python/nnUnet_raw/Dataset219_PETCT/labelsTr/PETCT_11afab3485_05252003.nii.gz,0.5733788395904437,0.0,0.0
45,0.8299700378990813,2552,6017,0.7093579350812332,45410517,20914,26931,23466,/well/papiez/users/hri611/python/nnUNet_results/Dataset219_PETCT/nnUNetTrainer_1500epochs__nnUNetPlans__3d_fullres/crossval_results_folds_0_1_2_3_4/PETCT_11e258cc1f_03062003.nii.gz,/well/papiez/users/hri611/python/nnUnet_raw/Dataset219_PETCT/labelsTr/PETCT_11e258cc1f_03062003.nii.gz,0.8299700378990813,22.306750591278075,0.012441020965576172
46,0.8036437246963563,190,4,0.6717428087986463,52159409,397,401,587,/well/papiez/users/hri611/python/nnUNet_results/Dataset219_PETCT/nnUNetTrainer_1500epochs__nnUNetPlans__3d_fullres/crossval_results_folds_0_1_2_3_4/PETCT_12025abab5_11012004.nii.gz,/well/papiez/users/hri611/python/nnUnet_raw/Dataset219_PETCT/labelsTr/PETCT_12025abab5_11012004.nii.gz,0.8036437246963563,0.04976408386230469,0.2737024612426758
47,0.8835405802914829,163,708,0.791377245508982,104475825,3304,4012,3467,/well/papiez/users/hri611/python/nnUNet_results/Dataset219_PETCT/nnUNetTrainer_1500epochs__nnUNetPlans__3d_fullres/crossval_results_folds_0_1_2_3_4/PETCT_1253499c80_10072005.nii.gz,/well/papiez/users/hri611/python/nnUnet_raw/Dataset219_PETCT/labelsTr/PETCT_1253499c80_10072005.nii.gz,0.8835405802914829,7.253115222930908,0.0
48,0.7233585067938165,67332,6004,0.5666105250716544,47830785,95879,101883,163211,/well/papiez/users/hri611/python/nnUNet_results/Dataset219_PETCT/nnUNetTrainer_1500epochs__nnUNetPlans__3d_fullres/crossval_results_folds_0_1_2_3_4/PETCT_1285b86bea_02242006.nii.gz,/well/papiez/users/hri611/python/nnUnet_raw/Dataset219_PETCT/labelsTr/PETCT_1285b86bea_02242006.nii.gz,0.7233585067938165,0.0,187.72256534957884
49,0.8437988415923509,1069,630,0.7298027989821882,58873712,4589,5219,5658,/well/papiez/users/hri611/python/nnUNet_results/Dataset219_PETCT/nnUNetTrainer_1500epochs__nnUNetPlans__3d_fullres/crossval_results_folds_0_1_2_3_4/PETCT_1291700093_07132003.nii.gz,/well/papiez/users/hri611/python/nnUnet_raw/Dataset219_PETCT/labelsTr/PETCT_1291700093_07132003.nii.gz,0.8437988415923509,0.0,0.6469330902099609
50,0.5847966990308201,93918,1274,0.4132245159620043,51997771,67037,68311,160955,/well/papiez/users/hri611/python/nnUNet_results/Dataset219_PETCT/nnUNetTrainer_1500epochs__nnUNetPlans__3d_fullres/crossval_results_folds_0_1_2_3_4/PETCT_13b40a817b_02182001.nii.gz,/well/papiez/users/hri611/python/nnUnet_raw/Dataset219_PETCT/labelsTr/PETCT_13b40a817b_02182001.nii.gz,0.5847966990308201,4.3045932540893554,62.14289972305298
51,0.8929364726788094,175,1512,0.8065810593900482,85591278,7035,8547,7210,/well/papiez/users/hri611/python/nnUNet_results/Dataset219_PETCT/nnUNetTrainer_1500epochs__nnUNetPlans__3d_fullres/crossval_results_folds_0_1_2_3_4/PETCT_13f476b02b_11192001.nii.gz,/well/papiez/users/hri611/python/nnUnet_raw/Dataset219_PETCT/labelsTr/PETCT_13f476b02b_11192001.nii.gz,0.8929364726788094,2.550409297943115,0.0
52,,0,0,,105760000,0,0,0,/well/papiez/users/hri611/python/nnUNet_results/Dataset219_PETCT/nnUNetTrainer_1500epochs__nnUNetPlans__3d_fullres/crossval_results_folds_0_1_2_3_4/PETCT_141fffa2a9_03012003.nii.gz,/well/papiez/users/hri611/python/nnUnet_raw/Dataset219_PETCT/labelsTr/PETCT_141fffa2a9_03012003.nii.gz,,0.0,0.0
53,0.8256218787907431,9168,1901,0.703029002226813,52122727,26204,28105,35372,/well/papiez/users/hri611/python/nnUNet_results/Dataset219_PETCT/nnUNetTrainer_1500epochs__nnUNetPlans__3d_fullres/crossval_results_folds_0_1_2_3_4/PETCT_1472967bef_12212002.nii.gz,/well/papiez/users/hri611/python/nnUnet_raw/Dataset219_PETCT/labelsTr/PETCT_1472967bef_12212002.nii.gz,0.8256218787907431,0.0,0.0
54,0.8998132607375076,3421,1032,0.8178732106339468,52135550,19997,21029,23418,/well/papiez/users/hri611/python/nnUNet_results/Dataset219_PETCT/nnUNetTrainer_1500epochs__nnUNetPlans__3d_fullres/crossval_results_folds_0_1_2_3_4/PETCT_147a9fcff3_08162001.nii.gz,/well/papiez/users/hri611/python/nnUnet_raw/Dataset219_PETCT/labelsTr/PETCT_147a9fcff3_08162001.nii.gz,0.8998132607375076,0.0,3.9935677299499512
55,0.0,0,345,0.0,45439655,0,345,0,/well/papiez/users/hri611/python/nnUNet_results/Dataset219_PETCT/nnUNetTrainer_1500epochs__nnUNetPlans__3d_fullres/crossval_results_folds_0_1_2_3_4/PETCT_14929994cf_04302005.nii.gz,/well/papiez/users/hri611/python/nnUnet_raw/Dataset219_PETCT/labelsTr/PETCT_14929994cf_04302005.nii.gz,0.0,4.29215223312378,0.0
56,0.7996490201813395,675,10,0.6661793372319688,52157948,1367,1377,2042,/well/papiez/users/hri611/python/nnUNet_results/Dataset219_PETCT/nnUNetTrainer_1500epochs__nnUNetPlans__3d_fullres/crossval_results_folds_0_1_2_3_4/PETCT_14c4d2c208_09222002.nii.gz,/well/papiez/users/hri611/python/nnUnet_raw/Dataset219_PETCT/labelsTr/PETCT_14c4d2c208_09222002.nii.gz,0.7996490201813395,0.0,1.157014949798584
57,0.8363417569193743,2969,295,0.718717683557394,52148396,8340,8635,11309,/well/papiez/users/hri611/python/nnUNet_results/Dataset219_PETCT/nnUNetTrainer_1500epochs__nnUNetPlans__3d_fullres/crossval_results_folds_0_1_2_3_4/PETCT_154e94256c_11252000.nii.gz,/well/papiez/users/hri611/python/nnUnet_raw/Dataset219_PETCT/labelsTr/PETCT_154e94256c_11252000.nii.gz,0.8363417569193743,1.9905633544921875,1.7790659980773926
58,,0,0,,50400000,0,0,0,/well/papiez/users/hri611/python/nnUNet_results/Dataset219_PETCT/nnUNetTrainer_1500epochs__nnUNetPlans__3d_fullres/crossval_results_folds_0_1_2_3_4/PETCT_1553bd8c8f_06142007.nii.gz,/well/papiez/users/hri611/python/nnUnet_raw/Dataset219_PETCT/labelsTr/PETCT_1553bd8c8f_06142007.nii.gz,,0.0,0.0
59,0.6322117705649485,66717,5656,0.46221465937462847,52185424,62203,67859,128920,/well/papiez/users/hri611/python/nnUNet_results/Dataset219_PETCT/nnUNetTrainer_1500epochs__nnUNetPlans__3d_fullres/crossval_results_folds_0_1_2_3_4/PETCT_15a205ffcc_08192005.nii.gz,/well/papiez/users/hri611/python/nnUnet_raw/Dataset219_PETCT/labelsTr/PETCT_15a205ffcc_08192005.nii.gz,0.6322117705649485,3.8069524154663084,46.516977390289306
60,0.9027354778986346,5954,4553,0.8227145412209361,45380734,48759,53312,54713,/well/papiez/users/hri611/python/nnUNet_results/Dataset219_PETCT/nnUNetTrainer_1500epochs__nnUNetPlans__3d_fullres/crossval_results_folds_0_1_2_3_4/PETCT_15cfa01130_02242001.nii.gz,/well/papiez/users/hri611/python/nnUnet_raw/Dataset219_PETCT/labelsTr/PETCT_15cfa01130_02242001.nii.gz,0.9027354778986346,0.6220510482788086,0.0
61,0.9109627603957211,1952,262,0.8364844903988183,45426460,11326,11588,13278,/well/papiez/users/hri611/python/nnUNet_results/Dataset219_PETCT/nnUNetTrainer_1500epochs__nnUNetPlans__3d_fullres/crossval_results_folds_0_1_2_3_4/PETCT_15f4b7254f_07182003.nii.gz,/well/papiez/users/hri611/python/nnUnet_raw/Dataset219_PETCT/labelsTr/PETCT_15f4b7254f_07182003.nii.gz,0.9109627603957211,2.525527256011963,2.4882041931152346
62,0.8099173553719008,0,23,0.6805555555555556,45439928,49,72,49,/well/papiez/users/hri611/python/nnUNet_results/Dataset219_PETCT/nnUNetTrainer_1500epochs__nnUNetPlans__3d_fullres/crossval_results_folds_0_1_2_3_4/PETCT_15f4b7254f_10112003.nii.gz,/well/papiez/users/hri611/python/nnUnet_raw/Dataset219_PETCT/labelsTr/PETCT_15f4b7254f_10112003.nii.gz,0.8099173553719008,0.07464612579345703,0.0
63,0.9182487720328686,13693,504,0.848853921579065,45506071,79732,80236,93425,/well/papiez/users/hri611/python/nnUNet_results/Dataset219_PETCT/nnUNetTrainer_1500epochs__nnUNetPlans__3d_fullres/crossval_results_folds_0_1_2_3_4/PETCT_16cdbc8689_07152005.nii.gz,/well/papiez/users/hri611/python/nnUnet_raw/Dataset219_PETCT/labelsTr/PETCT_16cdbc8689_07152005.nii.gz,0.9182487720328686,2.4384401092529298,2.674819507598877
64,0.0,0,107,0.0,92319893,0,107,0,/well/papiez/users/hri611/python/nnUNet_results/Dataset219_PETCT/nnUNetTrainer_1500epochs__nnUNetPlans__3d_fullres/crossval_results_folds_0_1_2_3_4/PETCT_173b804eda_10112004.nii.gz,/well/papiez/users/hri611/python/nnUnet_raw/Dataset219_PETCT/labelsTr/PETCT_173b804eda_10112004.nii.gz,0.0,1.3311892433166503,0.0
65,,0,0,,43840000,0,0,0,/well/papiez/users/hri611/python/nnUNet_results/Dataset219_PETCT/nnUNetTrainer_1500epochs__nnUNetPlans__3d_fullres/crossval_results_folds_0_1_2_3_4/PETCT_176bdc5388_06222006.nii.gz,/well/papiez/users/hri611/python/nnUnet_raw/Dataset219_PETCT/labelsTr/PETCT_176bdc5388_06222006.nii.gz,,0.0,0.0
66,0.0,0,685,0.0,49119315,0,685,0,/well/papiez/users/hri611/python/nnUNet_results/Dataset219_PETCT/nnUNetTrainer_1500epochs__nnUNetPlans__3d_fullres/crossval_results_folds_0_1_2_3_4/PETCT_1774857f8e_11232006.nii.gz,/well/papiez/users/hri611/python/nnUnet_raw/Dataset219_PETCT/labelsTr/PETCT_1774857f8e_11232006.nii.gz,0.0,8.522099361419677,0.0
67,0.0,0,460,0.0,45439540,0,460,0,/well/papiez/users/hri611/python/nnUNet_results/Dataset219_PETCT/nnUNetTrainer_1500epochs__nnUNetPlans__3d_fullres/crossval_results_folds_0_1_2_3_4/PETCT_1781ba966c_08082002.nii.gz,/well/papiez/users/hri611/python/nnUnet_raw/Dataset219_PETCT/labelsTr/PETCT_1781ba966c_08082002.nii.gz,0.0,5.722869644165039,0.0
68,0.0,0,206,0.0,38719794,0,206,0,/well/papiez/users/hri611/python/nnUNet_results/Dataset219_PETCT/nnUNetTrainer_1500epochs__nnUNetPlans__3d_fullres/crossval_results_folds_0_1_2_3_4/PETCT_17b46d7275_11132003.nii.gz,/well/papiez/users/hri611/python/nnUnet_raw/Dataset219_PETCT/labelsTr/PETCT_17b46d7275_11132003.nii.gz,0.0,2.5628503189086915,0.0
69,0.8875943739700303,870,4996,0.7979053262592158,52130974,23160,28156,24030,/well/papiez/users/hri611/python/nnUNet_results/Dataset219_PETCT/nnUNetTrainer_1500epochs__nnUNetPlans__3d_fullres/crossval_results_folds_0_1_2_3_4/PETCT_17d334cb6c_08282000.nii.gz,/well/papiez/users/hri611/python/nnUnet_raw/Dataset219_PETCT/labelsTr/PETCT_17d334cb6c_08282000.nii.gz,0.8875943739700303,20.851151138305664,0.0
70,0.0,0,837,0.0,49439163,0,837,0,/well/papiez/users/hri611/python/nnUNet_results/Dataset219_PETCT/nnUNetTrainer_1500epochs__nnUNetPlans__3d_fullres/crossval_results_folds_0_1_2_3_4/PETCT_182bdeba22_05102007.nii.gz,/well/papiez/users/hri611/python/nnUnet_raw/Dataset219_PETCT/labelsTr/PETCT_182bdeba22_05102007.nii.gz,0.0,10.413134548187255,0.0
71,0.0,0,60,0.0,52159940,0,60,0,/well/papiez/users/hri611/python/nnUNet_results/Dataset219_PETCT/nnUNetTrainer_1500epochs__nnUNetPlans__3d_fullres/crossval_results_folds_0_1_2_3_4/PETCT_185bac7954_01222005.nii.gz,/well/papiez/users/hri611/python/nnUnet_raw/Dataset219_PETCT/labelsTr/PETCT_185bac7954_01222005.nii.gz,0.0,0.7464612579345703,0.0
72,0.7500256647161483,88,2347,0.6000328515111695,52153912,3653,6000,3741,/well/papiez/users/hri611/python/nnUNet_results/Dataset219_PETCT/nnUNetTrainer_1500epochs__nnUNetPlans__3d_fullres/crossval_results_folds_0_1_2_3_4/PETCT_185da4c8b6_04182003.nii.gz,/well/papiez/users/hri611/python/nnUnet_raw/Dataset219_PETCT/labelsTr/PETCT_185da4c8b6_04182003.nii.gz,0.7500256647161483,0.024882041931152343,0.037323062896728515
73,0.5211764705882352,10,804,0.3524264120922832,52318743,443,1247,453,/well/papiez/users/hri611/python/nnUNet_results/Dataset219_PETCT/nnUNetTrainer_1500epochs__nnUNetPlans__3d_fullres/crossval_results_folds_0_1_2_3_4/PETCT_18e8b02af3_08142005.nii.gz,/well/papiez/users/hri611/python/nnUnet_raw/Dataset219_PETCT/labelsTr/PETCT_18e8b02af3_08142005.nii.gz,0.5211764705882352,9.8159655418396,0.0
74,0.0,0,404,0.0,99039596,0,404,0,/well/papiez/users/hri611/python/nnUNet_results/Dataset219_PETCT/nnUNetTrainer_1500epochs__nnUNetPlans__3d_fullres/crossval_results_folds_0_1_2_3_4/PETCT_1928952a0f_06202003.nii.gz,/well/papiez/users/hri611/python/nnUnet_raw/Dataset219_PETCT/labelsTr/PETCT_1928952a0f_06202003.nii.gz,0.0,5.0261724700927735,0.0
75,0.0,0,223,0.0,38719777,0,223,0,/well/papiez/users/hri611/python/nnUNet_results/Dataset219_PETCT/nnUNetTrainer_1500epochs__nnUNetPlans__3d_fullres/crossval_results_folds_0_1_2_3_4/PETCT_193dea6ac7_04102003.nii.gz,/well/papiez/users/hri611/python/nnUnet_raw/Dataset219_PETCT/labelsTr/PETCT_193dea6ac7_04102003.nii.gz,0.0,2.774347675323486,0.0
76,0.0,0,33,0.0,45119967,0,33,0,/well/papiez/users/hri611/python/nnUNet_results/Dataset219_PETCT/nnUNetTrainer_1500epochs__nnUNetPlans__3d_fullres/crossval_results_folds_0_1_2_3_4/PETCT_1956667fce_02102006.nii.gz,/well/papiez/users/hri611/python/nnUnet_raw/Dataset219_PETCT/labelsTr/PETCT_1956667fce_02102006.nii.gz,0.0,0.4105536918640137,0.0
77,0.9168906016734368,1817,10152,0.8465355421068828,47442008,66023,76175,67840,/well/papiez/users/hri611/python/nnUNet_results/Dataset219_PETCT/nnUNetTrainer_1500epochs__nnUNetPlans__3d_fullres/crossval_results_folds_0_1_2_3_4/PETCT_1956667fce_07282005.nii.gz,/well/papiez/users/hri611/python/nnUnet_raw/Dataset219_PETCT/labelsTr/PETCT_1956667fce_07282005.nii.gz,0.9168906016734368,1.0699278030395507,3.135137283325195
78,0.20578071002199183,14706,462,0.11469094729469445,52142867,1965,2427,16671,/well/papiez/users/hri611/python/nnUNet_results/Dataset219_PETCT/nnUNetTrainer_1500epochs__nnUNetPlans__3d_fullres/crossval_results_folds_0_1_2_3_4/PETCT_19838cb8e5_07292002.nii.gz,/well/papiez/users/hri611/python/nnUnet_raw/Dataset219_PETCT/labelsTr/PETCT_19838cb8e5_07292002.nii.gz,0.20578071002199183,5.7477516860961915,2.4508811302185056
79,0.6651438654967894,31909,2248,0.49828880304343354,52091919,33924,36172,65833,/well/papiez/users/hri611/python/nnUNet_results/Dataset219_PETCT/nnUNetTrainer_1500epochs__nnUNetPlans__3d_fullres/crossval_results_folds_0_1_2_3_4/PETCT_19b68a666b_04142005.nii.gz,/well/papiez/users/hri611/python/nnUnet_raw/Dataset219_PETCT/labelsTr/PETCT_19b68a666b_04142005.nii.gz,0.6651438654967894,1.5551276206970215,1.1072508659362792
80,0.05764192139737991,1079,0,0.029676258992805755,52158888,33,33,1112,/well/papiez/users/hri611/python/nnUNet_results/Dataset219_PETCT/nnUNetTrainer_1500epochs__nnUNetPlans__3d_fullres/crossval_results_folds_0_1_2_3_4/PETCT_1a1712f7d0_02142005.nii.gz,/well/papiez/users/hri611/python/nnUnet_raw/Dataset219_PETCT/labelsTr/PETCT_1a1712f7d0_02142005.nii.gz,0.05764192139737991,0.0,12.590313217163086
81,0.9081947011706716,92,57,0.8318284424379232,50399114,737,794,829,/well/papiez/users/hri611/python/nnUNet_results/Dataset219_PETCT/nnUNetTrainer_1500epochs__nnUNetPlans__3d_fullres/crossval_results_folds_0_1_2_3_4/PETCT_1a1712f7d0_02162007.nii.gz,/well/papiez/users/hri611/python/nnUnet_raw/Dataset219_PETCT/labelsTr/PETCT_1a1712f7d0_02162007.nii.gz,0.9081947011706716,0.360789608001709,0.0
82,0.5910846953937593,1443,4061,0.41953174435773044,52150518,3978,8039,5421,/well/papiez/users/hri611/python/nnUNet_results/Dataset219_PETCT/nnUNetTrainer_1500epochs__nnUNetPlans__3d_fullres/crossval_results_folds_0_1_2_3_4/PETCT_1a1712f7d0_07052001.nii.gz,/well/papiez/users/hri611/python/nnUnet_raw/Dataset219_PETCT/labelsTr/PETCT_1a1712f7d0_07052001.nii.gz,0.5910846953937593,48.13431011581421,4.628059799194336
83,0.0,0,1261,0.0,52158739,0,1261,0,/well/papiez/users/hri611/python/nnUNet_results/Dataset219_PETCT/nnUNetTrainer_1500epochs__nnUNetPlans__3d_fullres/crossval_results_folds_0_1_2_3_4/PETCT_1a3d4e63ee_07032004.nii.gz,/well/papiez/users/hri611/python/nnUnet_raw/Dataset219_PETCT/labelsTr/PETCT_1a3d4e63ee_07032004.nii.gz,0.0,15.688127437591552,0.0
84,0.0,0,6,0.0,45119994,0,6,0,/well/papiez/users/hri611/python/nnUNet_results/Dataset219_PETCT/nnUNetTrainer_1500epochs__nnUNetPlans__3d_fullres/crossval_results_folds_0_1_2_3_4/PETCT_1a8bd52f71_05052006.nii.gz,/well/papiez/users/hri611/python/nnUnet_raw/Dataset219_PETCT/labelsTr/PETCT_1a8bd52f71_05052006.nii.gz,0.0,0.07464612579345703,0.0
85,0.5568664464369986,170,769,0.3858731196860693,58878471,590,1359,760,/well/papiez/users/hri611/python/nnUNet_results/Dataset219_PETCT/nnUNetTrainer_1500epochs__nnUNetPlans__3d_fullres/crossval_results_folds_0_1_2_3_4/PETCT_1a90052cb2_06222001.nii.gz,/well/papiez/users/hri611/python/nnUnet_raw/Dataset219_PETCT/labelsTr/PETCT_1a90052cb2_06222001.nii.gz,0.5568664464369986,9.2934426612854,0.0
86,0.0,0,71,0.0,52159929,0,71,0,/well/papiez/users/hri611/python/nnUNet_results/Dataset219_PETCT/nnUNetTrainer_1500epochs__nnUNetPlans__3d_fullres/crossval_results_folds_0_1_2_3_4/PETCT_1a90052cb2_09062003.nii.gz,/well/papiez/users/hri611/python/nnUnet_raw/Dataset219_PETCT/labelsTr/PETCT_1a90052cb2_09062003.nii.gz,0.0,0.8833124885559082,0.0
87,0.0,0,1021,0.0,45438979,0,1021,0,/well/papiez/users/hri611/python/nnUNet_results/Dataset219_PETCT/nnUNetTrainer_1500epochs__nnUNetPlans__3d_fullres/crossval_results_folds_0_1_2_3_4/PETCT_1ac497ed9d_10282004.nii.gz,/well/papiez/users/hri611/python/nnUnet_raw/Dataset219_PETCT/labelsTr/PETCT_1ac497ed9d_10282004.nii.gz,0.0,12.702282405853271,0.0
88,0.10215053763440861,271,397,0.053824362606232294,58879294,38,435,309,/well/papiez/users/hri611/python/nnUNet_results/Dataset219_PETCT/nnUNetTrainer_1500epochs__nnUNetPlans__3d_fullres/crossval_results_folds_0_1_2_3_4/PETCT_1b199d094d_03162002.nii.gz,/well/papiez/users/hri611/python/nnUnet_raw/Dataset219_PETCT/labelsTr/PETCT_1b199d094d_03162002.nii.gz,0.10215053763440861,3.906480583190918,3.3590756607055665
89,0.848814126005642,640,3701,0.7373388999818479,52143473,12186,15887,12826,/well/papiez/users/hri611/python/nnUNet_results/Dataset219_PETCT/nnUNetTrainer_1500epochs__nnUNetPlans__3d_fullres/crossval_results_folds_0_1_2_3_4/PETCT_1b1bdfc35b_10292000.nii.gz,/well/papiez/users/hri611/python/nnUnet_raw/Dataset219_PETCT/labelsTr/PETCT_1b1bdfc35b_10292000.nii.gz,0.848814126005642,13.473625705718995,0.945517593383789
90,0.7942758052933037,10924,821,0.6587541402754372,52125582,22673,23494,33597,/well/papiez/users/hri611/python/nnUNet_results/Dataset219_PETCT/nnUNetTrainer_1500epochs__nnUNetPlans__3d_fullres/crossval_results_folds_0_1_2_3_4/PETCT_1bb48bfb40_12022000.nii.gz,/well/papiez/users/hri611/python/nnUnet_raw/Dataset219_PETCT/labelsTr/PETCT_1bb48bfb40_12022000.nii.gz,0.7942758052933037,1.9159172286987305,14.170322879791259
91,0.0,0,237,0.0,52159763,0,237,0,/well/papiez/users/hri611/python/nnUNet_results/Dataset219_PETCT/nnUNetTrainer_1500epochs__nnUNetPlans__3d_fullres/crossval_results_folds_0_1_2_3_4/PETCT_1bdefef7d5_01142006.nii.gz,/well/papiez/users/hri611/python/nnUnet_raw/Dataset219_PETCT/labelsTr/PETCT_1bdefef7d5_01142006.nii.gz,0.0,2.9485219688415527,0.0
92,,0,0,,52800000,0,0,0,/well/papiez/users/hri611/python/nnUNet_results/Dataset219_PETCT/nnUNetTrainer_1500epochs__nnUNetPlans__3d_fullres/crossval_results_folds_0_1_2_3_4/PETCT_1cb2d26a19_06042007.nii.gz,/well/papiez/users/hri611/python/nnUnet_raw/Dataset219_PETCT/labelsTr/PETCT_1cb2d26a19_06042007.nii.gz,,0.0,0.0
93,,0,0,,47520000,0,0,0,/well/papiez/users/hri611/python/nnUNet_results/Dataset219_PETCT/nnUNetTrainer_1500epochs__nnUNetPlans__3d_fullres/crossval_results_folds_0_1_2_3_4/PETCT_1f2a4f4280_06122005.nii.gz,/well/papiez/users/hri611/python/nnUnet_raw/Dataset219_PETCT/labelsTr/PETCT_1f2a4f4280_06122005.nii.gz,,0.0,0.0
94,,0,0,,52160000,0,0,0,/well/papiez/users/hri611/python/nnUNet_results/Dataset219_PETCT/nnUNetTrainer_1500epochs__nnUNetPlans__3d_fullres/crossval_results_folds_0_1_2_3_4/PETCT_1f2a4f4280_12202002.nii.gz,/well/papiez/users/hri611/python/nnUnet_raw/Dataset219_PETCT/labelsTr/PETCT_1f2a4f4280_12202002.nii.gz,,0.0,0.0
95,0.44594594594594594,6,76,0.28695652173913044,105759885,33,109,39,/well/papiez/users/hri611/python/nnUNet_results/Dataset219_PETCT/nnUNetTrainer_1500epochs__nnUNetPlans__3d_fullres/crossval_results_folds_0_1_2_3_4/PETCT_1f65acff65_05062007.nii.gz,/well/papiez/users/hri611/python/nnUnet_raw/Dataset219_PETCT/labelsTr/PETCT_1f65acff65_05062007.nii.gz,0.44594594594594594,0.9330765724182128,0.0
96,,0,0,,52160000,0,0,0,/well/papiez/users/hri611/python/nnUNet_results/Dataset219_PETCT/nnUNetTrainer_1500epochs__nnUNetPlans__3d_fullres/crossval_results_folds_0_1_2_3_4/PETCT_1fa22c576e_10172004.nii.gz,/well/papiez/users/hri611/python/nnUnet_raw/Dataset219_PETCT/labelsTr/PETCT_1fa22c576e_10172004.nii.gz,,0.0,0.0
97,0.8591824985607369,0,1223,0.7531287848203472,52155046,3731,4954,3731,/well/papiez/users/hri611/python/nnUNet_results/Dataset219_PETCT/nnUNetTrainer_1500epochs__nnUNetPlans__3d_fullres/crossval_results_folds_0_1_2_3_4/PETCT_1fc35d02da_08092003.nii.gz,/well/papiez/users/hri611/python/nnUnet_raw/Dataset219_PETCT/labelsTr/PETCT_1fc35d02da_08092003.nii.gz,0.8591824985607369,0.0,0.0
98,0.8441940056003042,189,4318,0.7303942094873482,58863283,12210,16528,12399,/well/papiez/users/hri611/python/nnUNet_results/Dataset219_PETCT/nnUNetTrainer_1500epochs__nnUNetPlans__3d_fullres/crossval_results_folds_0_1_2_3_4/PETCT_1fcfa34d10_09192003.nii.gz,/well/papiez/users/hri611/python/nnUnet_raw/Dataset219_PETCT/labelsTr/PETCT_1fcfa34d10_09192003.nii.gz,0.8441940056003042,1.891035186767578,0.0
99,0.8198509161678845,580,9232,0.6947011419148076,52127861,22327,31559,22907,/well/papiez/users/hri611/python/nnUNet_results/Dataset219_PETCT/nnUNetTrainer_1500epochs__nnUNetPlans__3d_fullres/crossval_results_folds_0_1_2_3_4/PETCT_1fe6e48293_06262003.nii.gz,/well/papiez/users/hri611/python/nnUnet_raw/Dataset219_PETCT/labelsTr/PETCT_1fe6e48293_06262003.nii.gz,0.8198509161678845,8.211073837280273,0.1368512306213379
100,0.7664104080425783,2,393,0.6212847555129435,55198957,648,1041,650,/well/papiez/users/hri611/python/nnUNet_results/Dataset219_PETCT/nnUNetTrainer_1500epochs__nnUNetPlans__3d_fullres/crossval_results_folds_0_1_2_3_4/PETCT_20995a0fe1_12022005.nii.gz,/well/papiez/users/hri611/python/nnUnet_raw/Dataset219_PETCT/labelsTr/PETCT_20995a0fe1_12022005.nii.gz,0.7664104080425783,4.19262406539917,0.0
101,0.0,0,511,0.0,45439489,0,511,0,/well/papiez/users/hri611/python/nnUNet_results/Dataset219_PETCT/nnUNetTrainer_1500epochs__nnUNetPlans__3d_fullres/crossval_results_folds_0_1_2_3_4/PETCT_20f4a3aa02_03172005.nii.gz,/well/papiez/users/hri611/python/nnUnet_raw/Dataset219_PETCT/labelsTr/PETCT_20f4a3aa02_03172005.nii.gz,0.0,6.357361713409424,0.0
102,0.0,0,823,0.0,43519177,0,823,0,/well/papiez/users/hri611/python/nnUNet_results/Dataset219_PETCT/nnUNetTrainer_1500epochs__nnUNetPlans__3d_fullres/crossval_results_folds_0_1_2_3_4/PETCT_2122b88719_09092006.nii.gz,/well/papiez/users/hri611/python/nnUnet_raw/Dataset219_PETCT/labelsTr/PETCT_2122b88719_09092006.nii.gz,0.0,10.23896025466919,0.0
103,0.4159674055391182,59604,601,0.26260028170739175,54638355,21440,22041,81044,/well/papiez/users/hri611/python/nnUNet_results/Dataset219_PETCT/nnUNetTrainer_1500epochs__nnUNetPlans__3d_fullres/crossval_results_folds_0_1_2_3_4/PETCT_2140db0ca5_04132007.nii.gz,/well/papiez/users/hri611/python/nnUnet_raw/Dataset219_PETCT/labelsTr/PETCT_2140db0ca5_04132007.nii.gz,0.4159674055391182,0.4105536918640137,49.29132506561279
104,0.8866615265998458,485,103,0.796398891966759,52157112,2300,2403,2785,/well/papiez/users/hri611/python/nnUNet_results/Dataset219_PETCT/nnUNetTrainer_1500epochs__nnUNetPlans__3d_fullres/crossval_results_folds_0_1_2_3_4/PETCT_21853fc15b_10122002.nii.gz,/well/papiez/users/hri611/python/nnUnet_raw/Dataset219_PETCT/labelsTr/PETCT_21853fc15b_10122002.nii.gz,0.8866615265998458,0.0,0.012441020965576172
105,0.8963046035176017,1152,2639,0.8120941759603469,45419825,16384,19023,17536,/well/papiez/users/hri611/python/nnUNet_results/Dataset219_PETCT/nnUNetTrainer_1500epochs__nnUNetPlans__3d_fullres/crossval_results_folds_0_1_2_3_4/PETCT_21e4ffcb52_05062002.nii.gz,/well/papiez/users/hri611/python/nnUnet_raw/Dataset219_PETCT/labelsTr/PETCT_21e4ffcb52_05062002.nii.gz,0.8963046035176017,4.35435733795166,4.5907367362976075
106,0.7998044146409612,1266,1600,0.666395064602491,45431409,5725,7325,6991,/well/papiez/users/hri611/python/nnUNet_results/Dataset219_PETCT/nnUNetTrainer_1500epochs__nnUNetPlans__3d_fullres/crossval_results_folds_0_1_2_3_4/PETCT_2202a936e0_05312002.nii.gz,/well/papiez/users/hri611/python/nnUnet_raw/Dataset219_PETCT/labelsTr/PETCT_2202a936e0_05312002.nii.gz,0.7998044146409612,0.5971690063476562,9.081945304870604
107,0.8029029793735676,1,515,0.6707083599234206,45438433,1051,1566,1052,/well/papiez/users/hri611/python/nnUNet_results/Dataset219_PETCT/nnUNetTrainer_1500epochs__nnUNetPlans__3d_fullres/crossval_results_folds_0_1_2_3_4/PETCT_223f70f0b0_11292003.nii.gz,/well/papiez/users/hri611/python/nnUnet_raw/Dataset219_PETCT/labelsTr/PETCT_223f70f0b0_11292003.nii.gz,0.8029029793735676,1.741742935180664,0.0
108,0.8160978094752929,351,10,0.689328743545611,45438838,801,811,1152,/well/papiez/users/hri611/python/nnUNet_results/Dataset219_PETCT/nnUNetTrainer_1500epochs__nnUNetPlans__3d_fullres/crossval_results_folds_0_1_2_3_4/PETCT_22d07bdc49_01052003.nii.gz,/well/papiez/users/hri611/python/nnUnet_raw/Dataset219_PETCT/labelsTr/PETCT_22d07bdc49_01052003.nii.gz,0.8160978094752929,0.012441020965576172,0.0
109,,0,0,,51840000,0,0,0,/well/papiez/users/hri611/python/nnUNet_results/Dataset219_PETCT/nnUNetTrainer_1500epochs__nnUNetPlans__3d_fullres/crossval_results_folds_0_1_2_3_4/PETCT_234f8427c0_12032005.nii.gz,/well/papiez/users/hri611/python/nnUnet_raw/Dataset219_PETCT/labelsTr/PETCT_234f8427c0_12032005.nii.gz,,0.0,0.0
110,0.0,0,353,0.0,45439647,0,353,0,/well/papiez/users/hri611/python/nnUNet_results/Dataset219_PETCT/nnUNetTrainer_1500epochs__nnUNetPlans__3d_fullres/crossval_results_folds_0_1_2_3_4/PETCT_234f8427c0_12092004.nii.gz,/well/papiez/users/hri611/python/nnUnet_raw/Dataset219_PETCT/labelsTr/PETCT_234f8427c0_12092004.nii.gz,0.0,4.391680400848388,0.0
111,0.04906333630686887,31,2101,0.025148605395518976,92317813,55,2156,86,/well/papiez/users/hri611/python/nnUNet_results/Dataset219_PETCT/nnUNetTrainer_1500epochs__nnUNetPlans__3d_fullres/crossval_results_folds_0_1_2_3_4/PETCT_23ed525e82_08012003.nii.gz,/well/papiez/users/hri611/python/nnUnet_raw/Dataset219_PETCT/labelsTr/PETCT_23ed525e82_08012003.nii.gz,0.04906333630686887,25.951969734191895,0.0
112,,0,0,,99520000,0,0,0,/well/papiez/users/hri611/python/nnUNet_results/Dataset219_PETCT/nnUNetTrainer_1500epochs__nnUNetPlans__3d_fullres/crossval_results_folds_0_1_2_3_4/PETCT_2428b44e92_03222007.nii.gz,/well/papiez/users/hri611/python/nnUnet_raw/Dataset219_PETCT/labelsTr/PETCT_2428b44e92_03222007.nii.gz,,0.0,0.0
113,0.2696629213483146,130,0,0.15584415584415584,45439846,24,24,154,/well/papiez/users/hri611/python/nnUNet_results/Dataset219_PETCT/nnUNetTrainer_1500epochs__nnUNetPlans__3d_fullres/crossval_results_folds_0_1_2_3_4/PETCT_245182006a_11042000.nii.gz,/well/papiez/users/hri611/python/nnUnet_raw/Dataset219_PETCT/labelsTr/PETCT_245182006a_11042000.nii.gz,0.2696629213483146,0.0,0.0
114,0.6361762096142805,23478,4404,0.46646510648883444,52107741,24377,28781,47855,/well/papiez/users/hri611/python/nnUNet_results/Dataset219_PETCT/nnUNetTrainer_1500epochs__nnUNetPlans__3d_fullres/crossval_results_folds_0_1_2_3_4/PETCT_249c02c01c_03062003.nii.gz,/well/papiez/users/hri611/python/nnUnet_raw/Dataset219_PETCT/labelsTr/PETCT_249c02c01c_03062003.nii.gz,0.6361762096142805,2.363793983459473,2.6374964447021485
115,,0,0,,45440000,0,0,0,/well/papiez/users/hri611/python/nnUNet_results/Dataset219_PETCT/nnUNetTrainer_1500epochs__nnUNetPlans__3d_fullres/crossval_results_folds_0_1_2_3_4/PETCT_249c02c01c_07262003.nii.gz,/well/papiez/users/hri611/python/nnUnet_raw/Dataset219_PETCT/labelsTr/PETCT_249c02c01c_07262003.nii.gz,,0.0,0.0
116,0.8116883116883117,641,2143,0.6830601092896175,50551216,6000,8143,6641,/well/papiez/users/hri611/python/nnUNet_results/Dataset219_PETCT/nnUNetTrainer_1500epochs__nnUNetPlans__3d_fullres/crossval_results_folds_0_1_2_3_4/PETCT_249dd35d0c_05202005.nii.gz,/well/papiez/users/hri611/python/nnUnet_raw/Dataset219_PETCT/labelsTr/PETCT_249dd35d0c_05202005.nii.gz,0.8116883116883117,7.53925870513916,4.77735205078125
117,0.0,0,77,0.0,72159923,0,77,0,/well/papiez/users/hri611/python/nnUNet_results/Dataset219_PETCT/nnUNetTrainer_1500epochs__nnUNetPlans__3d_fullres/crossval_results_folds_0_1_2_3_4/PETCT_24cb79a92b_04132003.nii.gz,/well/papiez/users/hri611/python/nnUnet_raw/Dataset219_PETCT/labelsTr/PETCT_24cb79a92b_04132003.nii.gz,0.0,0.9579586143493652,0.0
118,0.5289058180254347,12060,3276,0.3595322614324494,52136055,8609,11885,20669,/well/papiez/users/hri611/python/nnUNet_results/Dataset219_PETCT/nnUNetTrainer_1500epochs__nnUNetPlans__3d_fullres/crossval_results_folds_0_1_2_3_4/PETCT_25707f94a2_07032003.nii.gz,/well/papiez/users/hri611/python/nnUnet_raw/Dataset219_PETCT/labelsTr/PETCT_25707f94a2_07032003.nii.gz,0.5289058180254347,0.0,0.037323062896728515
119,0.0,0,88,0.0,47839912,0,88,0,/well/papiez/users/hri611/python/nnUNet_results/Dataset219_PETCT/nnUNetTrainer_1500epochs__nnUNetPlans__3d_fullres/crossval_results_folds_0_1_2_3_4/PETCT_265c26907a_11102005.nii.gz,/well/papiez/users/hri611/python/nnUnet_raw/Dataset219_PETCT/labelsTr/PETCT_265c26907a_11102005.nii.gz,0.0,1.094809844970703,0.0
120,0.0,0,6,0.0,58879994,0,6,0,/well/papiez/users/hri611/python/nnUNet_results/Dataset219_PETCT/nnUNetTrainer_1500epochs__nnUNetPlans__3d_fullres/crossval_results_folds_0_1_2_3_4/PETCT_2716c9bfff_10042003.nii.gz,/well/papiez/users/hri611/python/nnUnet_raw/Dataset219_PETCT/labelsTr/PETCT_2716c9bfff_10042003.nii.gz,0.0,0.07464612579345703,0.0
121,0.0,0,107,0.0,58879893,0,107,0,/well/papiez/users/hri611/python/nnUNet_results/Dataset219_PETCT/nnUNetTrainer_1500epochs__nnUNetPlans__3d_fullres/crossval_results_folds_0_1_2_3_4/PETCT_2716c9bfff_10312002.nii.gz,/well/papiez/users/hri611/python/nnUnet_raw/Dataset219_PETCT/labelsTr/PETCT_2716c9bfff_10312002.nii.gz,0.0,1.3311892433166503,0.0
122,0.0,0,227,0.0,52159773,0,227,0,/well/papiez/users/hri611/python/nnUNet_results/Dataset219_PETCT/nnUNetTrainer_1500epochs__nnUNetPlans__3d_fullres/crossval_results_folds_0_1_2_3_4/PETCT_2716c9bfff_11202004.nii.gz,/well/papiez/users/hri611/python/nnUnet_raw/Dataset219_PETCT/labelsTr/PETCT_2716c9bfff_11202004.nii.gz,0.0,2.824111759185791,0.0
123,0.0,0,184,0.0,54559816,0,184,0,/well/papiez/users/hri611/python/nnUNet_results/Dataset219_PETCT/nnUNetTrainer_1500epochs__nnUNetPlans__3d_fullres/crossval_results_folds_0_1_2_3_4/PETCT_274688d0a8_03242007.nii.gz,/well/papiez/users/hri611/python/nnUnet_raw/Dataset219_PETCT/labelsTr/PETCT_274688d0a8_03242007.nii.gz,0.0,2.2891478576660154,0.0
124,0.8088419994976137,907,2137,0.6790383804301983,52150516,6440,8577,7347,/well/papiez/users/hri611/python/nnUNet_results/Dataset219_PETCT/nnUNetTrainer_1500epochs__nnUNetPlans__3d_fullres/crossval_results_folds_0_1_2_3_4/PETCT_275fb00a66_05042001.nii.gz,/well/papiez/users/hri611/python/nnUnet_raw/Dataset219_PETCT/labelsTr/PETCT_275fb00a66_05042001.nii.gz,0.8088419994976137,6.668387237548828,1.0699278030395507
125,0.0,0,414,0.0,46239586,0,414,0,/well/papiez/users/hri611/python/nnUNet_results/Dataset219_PETCT/nnUNetTrainer_1500epochs__nnUNetPlans__3d_fullres/crossval_results_folds_0_1_2_3_4/PETCT_2791a0b3c2_08292005.nii.gz,/well/papiez/users/hri611/python/nnUnet_raw/Dataset219_PETCT/labelsTr/PETCT_2791a0b3c2_08292005.nii.gz,0.0,5.150582679748535,0.0
126,0.8244677011909058,521,4343,0.7013569104193529,45423713,11423,15766,11944,/well/papiez/users/hri611/python/nnUNet_results/Dataset219_PETCT/nnUNetTrainer_1500epochs__nnUNetPlans__3d_fullres/crossval_results_folds_0_1_2_3_4/PETCT_27ad42f8a9_07142002.nii.gz,/well/papiez/users/hri611/python/nnUnet_raw/Dataset219_PETCT/labelsTr/PETCT_27ad42f8a9_07142002.nii.gz,0.8244677011909058,0.2239383773803711,0.0
127,0.4731953290870488,15385,495,0.30992525638797147,52136988,7132,7627,22517,/well/papiez/users/hri611/python/nnUNet_results/Dataset219_PETCT/nnUNetTrainer_1500epochs__nnUNetPlans__3d_fullres/crossval_results_folds_0_1_2_3_4/PETCT_27d69a8466_12162001.nii.gz,/well/papiez/users/hri611/python/nnUnet_raw/Dataset219_PETCT/labelsTr/PETCT_27d69a8466_12162001.nii.gz,0.4731953290870488,0.0,62.777391792297365
128,,0,0,,52160000,0,0,0,/well/papiez/users/hri611/python/nnUNet_results/Dataset219_PETCT/nnUNetTrainer_1500epochs__nnUNetPlans__3d_fullres/crossval_results_folds_0_1_2_3_4/PETCT_28a0a0a163_10222004.nii.gz,/well/papiez/users/hri611/python/nnUnet_raw/Dataset219_PETCT/labelsTr/PETCT_28a0a0a163_10222004.nii.gz,,0.0,0.0
129,0.0,0,252,0.0,98079748,0,252,0,/well/papiez/users/hri611/python/nnUNet_results/Dataset219_PETCT/nnUNetTrainer_1500epochs__nnUNetPlans__3d_fullres/crossval_results_folds_0_1_2_3_4/PETCT_2946d59a94_11062006.nii.gz,/well/papiez/users/hri611/python/nnUnet_raw/Dataset219_PETCT/labelsTr/PETCT_2946d59a94_11062006.nii.gz,0.0,3.135137283325195,0.0
130,0.7610991590064541,25,4861,0.6143342015944431,52147331,7783,12644,7808,/well/papiez/users/hri611/python/nnUNet_results/Dataset219_PETCT/nnUNetTrainer_1500epochs__nnUNetPlans__3d_fullres/crossval_results_folds_0_1_2_3_4/PETCT_29ab45ef17_06272002.nii.gz,/well/papiez/users/hri611/python/nnUnet_raw/Dataset219_PETCT/labelsTr/PETCT_29ab45ef17_06272002.nii.gz,0.7610991590064541,3.3839577026367187,0.09952816772460937
131,0.0,0,224,0.0,45439776,0,224,0,/well/papiez/users/hri611/python/nnUNet_results/Dataset219_PETCT/nnUNetTrainer_1500epochs__nnUNetPlans__3d_fullres/crossval_results_folds_0_1_2_3_4/PETCT_2a41141775_09242005.nii.gz,/well/papiez/users/hri611/python/nnUnet_raw/Dataset219_PETCT/labelsTr/PETCT_2a41141775_09242005.nii.gz,0.0,2.7867886962890625,0.0
132,0.9545454545454546,4,0,0.9130434782608695,85599954,42,42,46,/well/papiez/users/hri611/python/nnUNet_results/Dataset219_PETCT/nnUNetTrainer_1500epochs__nnUNetPlans__3d_fullres/crossval_results_folds_0_1_2_3_4/PETCT_2a6f4f0753_07312003.nii.gz,/well/papiez/users/hri611/python/nnUnet_raw/Dataset219_PETCT/labelsTr/PETCT_2a6f4f0753_07312003.nii.gz,0.9545454545454546,0.0,0.0
133,0.8679944418712366,628,227,0.7667757774140753,45436334,2811,3038,3439,/well/papiez/users/hri611/python/nnUNet_results/Dataset219_PETCT/nnUNetTrainer_1500epochs__nnUNetPlans__3d_fullres/crossval_results_folds_0_1_2_3_4/PETCT_2a78eed085_12222001.nii.gz,/well/papiez/users/hri611/python/nnUnet_raw/Dataset219_PETCT/labelsTr/PETCT_2a78eed085_12222001.nii.gz,0.8679944418712366,0.18661531448364257,0.0
134,0.0,0,647,0.0,31999353,0,647,0,/well/papiez/users/hri611/python/nnUNet_results/Dataset219_PETCT/nnUNetTrainer_1500epochs__nnUNetPlans__3d_fullres/crossval_results_folds_0_1_2_3_4/PETCT_2ad62beb52_03082003.nii.gz,/well/papiez/users/hri611/python/nnUnet_raw/Dataset219_PETCT/labelsTr/PETCT_2ad62beb52_03082003.nii.gz,0.0,8.049340564727784,0.0
135,0.795213910648188,9,2370,0.6600457273506716,51033002,4619,6989,4628,/well/papiez/users/hri611/python/nnUNet_results/Dataset219_PETCT/nnUNetTrainer_1500epochs__nnUNetPlans__3d_fullres/crossval_results_folds_0_1_2_3_4/PETCT_2b29531d8c_10162005.nii.gz,/well/papiez/users/hri611/python/nnUnet_raw/Dataset219_PETCT/labelsTr/PETCT_2b29531d8c_10162005.nii.gz,0.795213910648188,12.73960546875,0.0
136,0.0,0,218,0.0,47839782,0,218,0,/well/papiez/users/hri611/python/nnUNet_results/Dataset219_PETCT/nnUNetTrainer_1500epochs__nnUNetPlans__3d_fullres/crossval_results_folds_0_1_2_3_4/PETCT_2b8064fbe2_06112006.nii.gz,/well/papiez/users/hri611/python/nnUnet_raw/Dataset219_PETCT/labelsTr/PETCT_2b8064fbe2_06112006.nii.gz,0.0,2.7121425704956055,0.0
137,0.7676056338028169,0,66,0.6228571428571429,43839825,109,175,109,/well/papiez/users/hri611/python/nnUNet_results/Dataset219_PETCT/nnUNetTrainer_1500epochs__nnUNetPlans__3d_fullres/crossval_results_folds_0_1_2_3_4/PETCT_2ce074c2ea_02042006.nii.gz,/well/papiez/users/hri611/python/nnUnet_raw/Dataset219_PETCT/labelsTr/PETCT_2ce074c2ea_02042006.nii.gz,0.7676056338028169,0.49764083862304687,0.0
138,0.6705539358600583,111,2,0.5043859649122807,94079772,115,117,226,/well/papiez/users/hri611/python/nnUNet_results/Dataset219_PETCT/nnUNetTrainer_1500epochs__nnUNetPlans__3d_fullres/crossval_results_folds_0_1_2_3_4/PETCT_2d70838805_04302007.nii.gz,/well/papiez/users/hri611/python/nnUnet_raw/Dataset219_PETCT/labelsTr/PETCT_2d70838805_04302007.nii.gz,0.6705539358600583,0.0,0.0
139,0.7102599179206567,1046,13,0.5507000424268137,45437643,1298,1311,2344,/well/papiez/users/hri611/python/nnUNet_results/Dataset219_PETCT/nnUNetTrainer_1500epochs__nnUNetPlans__3d_fullres/crossval_results_folds_0_1_2_3_4/PETCT_2dac5ef654_11042000.nii.gz,/well/papiez/users/hri611/python/nnUnet_raw/Dataset219_PETCT/labelsTr/PETCT_2dac5ef654_11042000.nii.gz,0.7102599179206567,0.1368512306213379,0.0
140,0.7871287128712872,117,2549,0.6489795918367347,51832405,4929,7478,5046,/well/papiez/users/hri611/python/nnUNet_results/Dataset219_PETCT/nnUNetTrainer_1500epochs__nnUNetPlans__3d_fullres/crossval_results_folds_0_1_2_3_4/PETCT_2dc17aaeaf_07012005.nii.gz,/well/papiez/users/hri611/python/nnUnet_raw/Dataset219_PETCT/labelsTr/PETCT_2dc17aaeaf_07012005.nii.gz,0.7871287128712872,2.3015888786315917,0.0870871467590332
141,0.8727385720204391,2054,1632,0.7742113323124042,78863675,12639,14271,14693,/well/papiez/users/hri611/python/nnUNet_results/Dataset219_PETCT/nnUNetTrainer_1500epochs__nnUNetPlans__3d_fullres/crossval_results_folds_0_1_2_3_4/PETCT_2e44706eaf_05062005.nii.gz,/well/papiez/users/hri611/python/nnUnet_raw/Dataset219_PETCT/labelsTr/PETCT_2e44706eaf_05062005.nii.gz,0.8727385720204391,15.513953144073486,1.16945597076416
142,0.9242189916486235,198,47,0.8591144335825187,45438261,1494,1541,1692,/well/papiez/users/hri611/python/nnUNet_results/Dataset219_PETCT/nnUNetTrainer_1500epochs__nnUNetPlans__3d_fullres/crossval_results_folds_0_1_2_3_4/PETCT_2e97a9e5c2_06232003.nii.gz,/well/papiez/users/hri611/python/nnUnet_raw/Dataset219_PETCT/labelsTr/PETCT_2e97a9e5c2_06232003.nii.gz,0.9242189916486235,0.04976408386230469,0.0
143,,0,0,,52160000,0,0,0,/well/papiez/users/hri611/python/nnUNet_results/Dataset219_PETCT/nnUNetTrainer_1500epochs__nnUNetPlans__3d_fullres/crossval_results_folds_0_1_2_3_4/PETCT_2f2ee78c89_05012003.nii.gz,/well/papiez/users/hri611/python/nnUnet_raw/Dataset219_PETCT/labelsTr/PETCT_2f2ee78c89_05012003.nii.gz,,0.0,0.0
144,0.8556286222901409,1799,15962,0.7476843959540856,46649608,52631,68593,54430,/well/papiez/users/hri611/python/nnUNet_results/Dataset219_PETCT/nnUNetTrainer_1500epochs__nnUNetPlans__3d_fullres/crossval_results_folds_0_1_2_3_4/PETCT_2f7200f771_11052005.nii.gz,/well/papiez/users/hri611/python/nnUnet_raw/Dataset219_PETCT/labelsTr/PETCT_2f7200f771_11052005.nii.gz,0.8556286222901409,0.9206355514526368,1.6795378303527833
145,0.0,0,297,0.0,52319703,0,297,0,/well/papiez/users/hri611/python/nnUNet_results/Dataset219_PETCT/nnUNetTrainer_1500epochs__nnUNetPlans__3d_fullres/crossval_results_folds_0_1_2_3_4/PETCT_302613f9a5_04062007.nii.gz,/well/papiez/users/hri611/python/nnUnet_raw/Dataset219_PETCT/labelsTr/PETCT_302613f9a5_04062007.nii.gz,0.0,3.694983226776123,0.0
146,0.0,0,465,0.0,99039535,0,465,0,/well/papiez/users/hri611/python/nnUNet_results/Dataset219_PETCT/nnUNetTrainer_1500epochs__nnUNetPlans__3d_fullres/crossval_results_folds_0_1_2_3_4/PETCT_30287f520f_11232003.nii.gz,/well/papiez/users/hri611/python/nnUnet_raw/Dataset219_PETCT/labelsTr/PETCT_30287f520f_11232003.nii.gz,0.0,5.78507474899292,0.0
147,0.743898671609515,2248,239,0.5922282341367437,52153901,3612,3851,5860,/well/papiez/users/hri611/python/nnUNet_results/Dataset219_PETCT/nnUNetTrainer_1500epochs__nnUNetPlans__3d_fullres/crossval_results_folds_0_1_2_3_4/PETCT_3049d4f1a4_02242002.nii.gz,/well/papiez/users/hri611/python/nnUnet_raw/Dataset219_PETCT/labelsTr/PETCT_3049d4f1a4_02242002.nii.gz,0.743898671609515,0.037323062896728515,3.2844295349121095
148,0.8921746776084408,12117,2599,0.8053387655758089,45364402,60882,63481,72999,/well/papiez/users/hri611/python/nnUNet_results/Dataset219_PETCT/nnUNetTrainer_1500epochs__nnUNetPlans__3d_fullres/crossval_results_folds_0_1_2_3_4/PETCT_30c4b7062b_01182001.nii.gz,/well/papiez/users/hri611/python/nnUnet_raw/Dataset219_PETCT/labelsTr/PETCT_30c4b7062b_01182001.nii.gz,0.8921746776084408,7.439730537414551,1.2938661804199219
149,0.0,0,331,0.0,99039669,0,331,0,/well/papiez/users/hri611/python/nnUNet_results/Dataset219_PETCT/nnUNetTrainer_1500epochs__nnUNetPlans__3d_fullres/crossval_results_folds_0_1_2_3_4/PETCT_30e2b83b74_04262003.nii.gz,/well/papiez/users/hri611/python/nnUnet_raw/Dataset219_PETCT/labelsTr/PETCT_30e2b83b74_04262003.nii.gz,0.0,4.117977939605713,0.0
150,0.0,0,235,0.0,92319765,0,235,0,/well/papiez/users/hri611/python/nnUNet_results/Dataset219_PETCT/nnUNetTrainer_1500epochs__nnUNetPlans__3d_fullres/crossval_results_folds_0_1_2_3_4/PETCT_30e2b83b74_07212003.nii.gz,/well/papiez/users/hri611/python/nnUnet_raw/Dataset219_PETCT/labelsTr/PETCT_30e2b83b74_07212003.nii.gz,0.0,2.9236399269104005,0.0
151,0.0,0,38,0.0,99039962,0,38,0,/well/papiez/users/hri611/python/nnUNet_results/Dataset219_PETCT/nnUNetTrainer_1500epochs__nnUNetPlans__3d_fullres/crossval_results_folds_0_1_2_3_4/PETCT_30e2b83b74_09012002.nii.gz,/well/papiez/users/hri611/python/nnUnet_raw/Dataset219_PETCT/labelsTr/PETCT_30e2b83b74_09012002.nii.gz,0.0,0.4727587966918945,0.0
152,0.9441631504922644,473,321,0.8942320500865859,52152493,6713,7034,7186,/well/papiez/users/hri611/python/nnUNet_results/Dataset219_PETCT/nnUNetTrainer_1500epochs__nnUNetPlans__3d_fullres/crossval_results_folds_0_1_2_3_4/PETCT_31ddf5013a_02222001.nii.gz,/well/papiez/users/hri611/python/nnUnet_raw/Dataset219_PETCT/labelsTr/PETCT_31ddf5013a_02222001.nii.gz,0.9441631504922644,0.870871467590332,0.0
153,0.6381826969550507,1941,9288,0.46862578080636,45418868,9903,19191,11844,/well/papiez/users/hri611/python/nnUNet_results/Dataset219_PETCT/nnUNetTrainer_1500epochs__nnUNetPlans__3d_fullres/crossval_results_folds_0_1_2_3_4/PETCT_321bba14bc_03072002.nii.gz,/well/papiez/users/hri611/python/nnUnet_raw/Dataset219_PETCT/labelsTr/PETCT_321bba14bc_03072002.nii.gz,0.6381826969550507,3.2844295349121095,0.9703996353149413
154,0.0,0,84,0.0,45439916,0,84,0,/well/papiez/users/hri611/python/nnUNet_results/Dataset219_PETCT/nnUNetTrainer_1500epochs__nnUNetPlans__3d_fullres/crossval_results_folds_0_1_2_3_4/PETCT_32219760da_03132003.nii.gz,/well/papiez/users/hri611/python/nnUnet_raw/Dataset219_PETCT/labelsTr/PETCT_32219760da_03132003.nii.gz,0.0,1.0450457611083985,0.0
155,0.8693181818181818,2347,1195,0.7688442211055276,52144677,11781,12976,14128,/well/papiez/users/hri611/python/nnUNet_results/Dataset219_PETCT/nnUNetTrainer_1500epochs__nnUNetPlans__3d_fullres/crossval_results_folds_0_1_2_3_4/PETCT_323cc5aff8_11092001.nii.gz,/well/papiez/users/hri611/python/nnUnet_raw/Dataset219_PETCT/labelsTr/PETCT_323cc5aff8_11092001.nii.gz,0.8693181818181818,6.481771923065185,0.012441020965576172
156,0.703125,49,103,0.5421686746987951,99839668,180,283,229,/well/papiez/users/hri611/python/nnUNet_results/Dataset219_PETCT/nnUNetTrainer_1500epochs__nnUNetPlans__3d_fullres/crossval_results_folds_0_1_2_3_4/PETCT_32aa845af1_01262007.nii.gz,/well/papiez/users/hri611/python/nnUnet_raw/Dataset219_PETCT/labelsTr/PETCT_32aa845af1_01262007.nii.gz,0.703125,1.0326047401428222,0.0
157,0.9185423365487674,272,944,0.8493557978196233,50871928,6856,7800,7128,/well/papiez/users/hri611/python/nnUNet_results/Dataset219_PETCT/nnUNetTrainer_1500epochs__nnUNetPlans__3d_fullres/crossval_results_folds_0_1_2_3_4/PETCT_32aa845af1_06152007.nii.gz,/well/papiez/users/hri611/python/nnUnet_raw/Dataset219_PETCT/labelsTr/PETCT_32aa845af1_06152007.nii.gz,0.9185423365487674,1.9034762077331542,1.7915070190429687
158,0.8310867540873494,9653,1412,0.7109909627540093,45401714,27221,28633,36874,/well/papiez/users/hri611/python/nnUNet_results/Dataset219_PETCT/nnUNetTrainer_1500epochs__nnUNetPlans__3d_fullres/crossval_results_folds_0_1_2_3_4/PETCT_335a00191d_02162001.nii.gz,/well/papiez/users/hri611/python/nnUnet_raw/Dataset219_PETCT/labelsTr/PETCT_335a00191d_02162001.nii.gz,0.8310867540873494,0.2985845031738281,0.6096100273132324
159,0.0,0,351,0.0,49919649,0,351,0,/well/papiez/users/hri611/python/nnUNet_results/Dataset219_PETCT/nnUNetTrainer_1500epochs__nnUNetPlans__3d_fullres/crossval_results_folds_0_1_2_3_4/PETCT_345b11778a_10142005.nii.gz,/well/papiez/users/hri611/python/nnUnet_raw/Dataset219_PETCT/labelsTr/PETCT_345b11778a_10142005.nii.gz,0.0,4.3667983589172366,0.0
160,0.0,0,88,0.0,54239912,0,88,0,/well/papiez/users/hri611/python/nnUNet_results/Dataset219_PETCT/nnUNetTrainer_1500epochs__nnUNetPlans__3d_fullres/crossval_results_folds_0_1_2_3_4/PETCT_3481507253_06172007.nii.gz,/well/papiez/users/hri611/python/nnUnet_raw/Dataset219_PETCT/labelsTr/PETCT_3481507253_06172007.nii.gz,0.0,1.094809844970703,0.0
161,,0,0,,55360000,0,0,0,/well/papiez/users/hri611/python/nnUNet_results/Dataset219_PETCT/nnUNetTrainer_1500epochs__nnUNetPlans__3d_fullres/crossval_results_folds_0_1_2_3_4/PETCT_34aa521b46_03302007.nii.gz,/well/papiez/users/hri611/python/nnUnet_raw/Dataset219_PETCT/labelsTr/PETCT_34aa521b46_03302007.nii.gz,,0.0,0.0
162,,0,0,,52160000,0,0,0,/well/papiez/users/hri611/python/nnUNet_results/Dataset219_PETCT/nnUNetTrainer_1500epochs__nnUNetPlans__3d_fullres/crossval_results_folds_0_1_2_3_4/PETCT_34d3efa936_10222004.nii.gz,/well/papiez/users/hri611/python/nnUnet_raw/Dataset219_PETCT/labelsTr/PETCT_34d3efa936_10222004.nii.gz,,0.0,0.0
163,0.6781396362052065,2329,626,0.5130191166776532,45593932,3113,3739,5442,/well/papiez/users/hri611/python/nnUNet_results/Dataset219_PETCT/nnUNetTrainer_1500epochs__nnUNetPlans__3d_fullres/crossval_results_folds_0_1_2_3_4/PETCT_350e91119a_10232005.nii.gz,/well/papiez/users/hri611/python/nnUnet_raw/Dataset219_PETCT/labelsTr/PETCT_350e91119a_10232005.nii.gz,0.6781396362052065,5.187905742645263,5.78507474899292
164,0.8399509803921569,639,667,0.724065075005282,92315267,3427,4094,4066,/well/papiez/users/hri611/python/nnUNet_results/Dataset219_PETCT/nnUNetTrainer_1500epochs__nnUNetPlans__3d_fullres/crossval_results_folds_0_1_2_3_4/PETCT_35c9c85a96_04082005.nii.gz,/well/papiez/users/hri611/python/nnUnet_raw/Dataset219_PETCT/labelsTr/PETCT_35c9c85a96_04082005.nii.gz,0.8399509803921569,1.6919788513183593,0.7091381950378418
165,0.860655521916546,2735,2558,0.7553953509866445,90378361,16346,18904,19081,/well/papiez/users/hri611/python/nnUNet_results/Dataset219_PETCT/nnUNetTrainer_1500epochs__nnUNetPlans__3d_fullres/crossval_results_folds_0_1_2_3_4/PETCT_35c9c85a96_09232005.nii.gz,/well/papiez/users/hri611/python/nnUnet_raw/Dataset219_PETCT/labelsTr/PETCT_35c9c85a96_09232005.nii.gz,0.860655521916546,0.0,6.942089698791504
166,0.0,0,14,0.0,52799986,0,14,0,/well/papiez/users/hri611/python/nnUNet_results/Dataset219_PETCT/nnUNetTrainer_1500epochs__nnUNetPlans__3d_fullres/crossval_results_folds_0_1_2_3_4/PETCT_35de69968e_10272006.nii.gz,/well/papiez/users/hri611/python/nnUnet_raw/Dataset219_PETCT/labelsTr/PETCT_35de69968e_10272006.nii.gz,0.0,0.1741742935180664,0.0
167,0.34285714285714286,59,33,0.20689655172413793,49919884,24,57,83,/well/papiez/users/hri611/python/nnUNet_results/Dataset219_PETCT/nnUNetTrainer_1500epochs__nnUNetPlans__3d_fullres/crossval_results_folds_0_1_2_3_4/PETCT_36870de2f2_05142006.nii.gz,/well/papiez/users/hri611/python/nnUnet_raw/Dataset219_PETCT/labelsTr/PETCT_36870de2f2_05142006.nii.gz,0.34285714285714286,0.3981126708984375,0.0
168,0.10623423423423424,12247,154,0.05609681838940478,52146862,737,891,12984,/well/papiez/users/hri611/python/nnUNet_results/Dataset219_PETCT/nnUNetTrainer_1500epochs__nnUNetPlans__3d_fullres/crossval_results_folds_0_1_2_3_4/PETCT_36bb0257fc_08032003.nii.gz,/well/papiez/users/hri611/python/nnUnet_raw/Dataset219_PETCT/labelsTr/PETCT_36bb0257fc_08032003.nii.gz,0.10623423423423424,0.7713432998657226,145.47285815048218
169,0.8302226638924257,1829,3638,0.7097270893065732,100941166,13367,17005,15196,/well/papiez/users/hri611/python/nnUNet_results/Dataset219_PETCT/nnUNetTrainer_1500epochs__nnUNetPlans__3d_fullres/crossval_results_folds_0_1_2_3_4/PETCT_36d8219e3f_02092006.nii.gz,/well/papiez/users/hri611/python/nnUnet_raw/Dataset219_PETCT/labelsTr/PETCT_36d8219e3f_02092006.nii.gz,0.8302226638924257,10.549985778808594,2.0403274383544923
170,0.883367839889579,763,758,0.7911001236093943,99032719,5760,6518,6523,/well/papiez/users/hri611/python/nnUNet_results/Dataset219_PETCT/nnUNetTrainer_1500epochs__nnUNetPlans__3d_fullres/crossval_results_folds_0_1_2_3_4/PETCT_3708f576ec_03082002.nii.gz,/well/papiez/users/hri611/python/nnUnet_raw/Dataset219_PETCT/labelsTr/PETCT_3708f576ec_03082002.nii.gz,0.883367839889579,2.5006452140808104,0.024882041931152343
171,0.0,0,117,0.0,48799883,0,117,0,/well/papiez/users/hri611/python/nnUNet_results/Dataset219_PETCT/nnUNetTrainer_1500epochs__nnUNetPlans__3d_fullres/crossval_results_folds_0_1_2_3_4/PETCT_372746cc99_07152006.nii.gz,/well/papiez/users/hri611/python/nnUnet_raw/Dataset219_PETCT/labelsTr/PETCT_372746cc99_07152006.nii.gz,0.0,1.4555994529724121,0.0
172,0.7742195367573012,953,168,0.6316135392704568,45436957,1922,2090,2875,/well/papiez/users/hri611/python/nnUNet_results/Dataset219_PETCT/nnUNetTrainer_1500epochs__nnUNetPlans__3d_fullres/crossval_results_folds_0_1_2_3_4/PETCT_37472e737f_06202003.nii.gz,/well/papiez/users/hri611/python/nnUnet_raw/Dataset219_PETCT/labelsTr/PETCT_37472e737f_06202003.nii.gz,0.7742195367573012,0.012441020965576172,0.0
173,0.8805858054825385,3896,1192,0.7866487755786649,52136152,18760,19952,22656,/well/papiez/users/hri611/python/nnUNet_results/Dataset219_PETCT/nnUNetTrainer_1500epochs__nnUNetPlans__3d_fullres/crossval_results_folds_0_1_2_3_4/PETCT_37952b7ffb_08242002.nii.gz,/well/papiez/users/hri611/python/nnUnet_raw/Dataset219_PETCT/labelsTr/PETCT_37952b7ffb_08242002.nii.gz,0.8805858054825385,0.16173327255249023,0.0
174,0.7992123287671233,10138,1588,0.6655733964578046,52124937,23337,24925,33475,/well/papiez/users/hri611/python/nnUNet_results/Dataset219_PETCT/nnUNetTrainer_1500epochs__nnUNetPlans__3d_fullres/crossval_results_folds_0_1_2_3_4/PETCT_380f71df1e_08192001.nii.gz,/well/papiez/users/hri611/python/nnUnet_raw/Dataset219_PETCT/labelsTr/PETCT_380f71df1e_08192001.nii.gz,0.7992123287671233,3.0978142204284667,17.106403827667236
175,0.0,0,2393,0.0,52157607,0,2393,0,/well/papiez/users/hri611/python/nnUNet_results/Dataset219_PETCT/nnUNetTrainer_1500epochs__nnUNetPlans__3d_fullres/crossval_results_folds_0_1_2_3_4/PETCT_389462c0ac_03032005.nii.gz,/well/papiez/users/hri611/python/nnUnet_raw/Dataset219_PETCT/labelsTr/PETCT_389462c0ac_03032005.nii.gz,0.0,29.77136317062378,0.0
176,0.0,0,115,0.0,52159885,0,115,0,/well/papiez/users/hri611/python/nnUNet_results/Dataset219_PETCT/nnUNetTrainer_1500epochs__nnUNetPlans__3d_fullres/crossval_results_folds_0_1_2_3_4/PETCT_389462c0ac_04272003.nii.gz,/well/papiez/users/hri611/python/nnUnet_raw/Dataset219_PETCT/labelsTr/PETCT_389462c0ac_04272003.nii.gz,0.0,1.4307174110412597,0.0
177,0.0,0,101,0.0,56159899,0,101,0,/well/papiez/users/hri611/python/nnUNet_results/Dataset219_PETCT/nnUNetTrainer_1500epochs__nnUNetPlans__3d_fullres/crossval_results_folds_0_1_2_3_4/PETCT_389462c0ac_08292005.nii.gz,/well/papiez/users/hri611/python/nnUnet_raw/Dataset219_PETCT/labelsTr/PETCT_389462c0ac_08292005.nii.gz,0.0,1.2565431175231934,0.0
178,0.0,0,189,0.0,97279811,0,189,0,/well/papiez/users/hri611/python/nnUNet_results/Dataset219_PETCT/nnUNetTrainer_1500epochs__nnUNetPlans__3d_fullres/crossval_results_folds_0_1_2_3_4/PETCT_389c968170_02172006.nii.gz,/well/papiez/users/hri611/python/nnUnet_raw/Dataset219_PETCT/labelsTr/PETCT_389c968170_02172006.nii.gz,0.0,2.3513529624938965,0.0
179,0.0,0,1077,0.0,100958923,0,1077,0,/well/papiez/users/hri611/python/nnUNet_results/Dataset219_PETCT/nnUNetTrainer_1500epochs__nnUNetPlans__3d_fullres/crossval_results_folds_0_1_2_3_4/PETCT_389c968170_08192005.nii.gz,/well/papiez/users/hri611/python/nnUnet_raw/Dataset219_PETCT/labelsTr/PETCT_389c968170_08192005.nii.gz,0.0,13.398979579925538,0.0
180,0.0,0,939,0.0,52799061,0,939,0,/well/papiez/users/hri611/python/nnUNet_results/Dataset219_PETCT/nnUNetTrainer_1500epochs__nnUNetPlans__3d_fullres/crossval_results_folds_0_1_2_3_4/PETCT_38a374d01a_05242007.nii.gz,/well/papiez/users/hri611/python/nnUnet_raw/Dataset219_PETCT/labelsTr/PETCT_38a374d01a_05242007.nii.gz,0.0,11.682118686676025,0.0
181,,0,0,,71520000,0,0,0,/well/papiez/users/hri611/python/nnUNet_results/Dataset219_PETCT/nnUNetTrainer_1500epochs__nnUNetPlans__3d_fullres/crossval_results_folds_0_1_2_3_4/PETCT_390129c0d2_04272007.nii.gz,/well/papiez/users/hri611/python/nnUnet_raw/Dataset219_PETCT/labelsTr/PETCT_390129c0d2_04272007.nii.gz,,0.0,0.0
182,0.7682312855980472,15759,2471,0.623681440042937,52111557,30213,32684,45972,/well/papiez/users/hri611/python/nnUNet_results/Dataset219_PETCT/nnUNetTrainer_1500epochs__nnUNetPlans__3d_fullres/crossval_results_folds_0_1_2_3_4/PETCT_39159c05c2_02232001.nii.gz,/well/papiez/users/hri611/python/nnUnet_raw/Dataset219_PETCT/labelsTr/PETCT_39159c05c2_02232001.nii.gz,0.7682312855980472,0.18661531448364257,28.863168640136717
183,0.0,0,30,0.0,65439970,0,30,0,/well/papiez/users/hri611/python/nnUNet_results/Dataset219_PETCT/nnUNetTrainer_1500epochs__nnUNetPlans__3d_fullres/crossval_results_folds_0_1_2_3_4/PETCT_39eca178a1_06082003.nii.gz,/well/papiez/users/hri611/python/nnUnet_raw/Dataset219_PETCT/labelsTr/PETCT_39eca178a1_06082003.nii.gz,0.0,0.37323062896728515,0.0
184,,0,0,,49440000,0,0,0,/well/papiez/users/hri611/python/nnUNet_results/Dataset219_PETCT/nnUNetTrainer_1500epochs__nnUNetPlans__3d_fullres/crossval_results_folds_0_1_2_3_4/PETCT_3a40a26443_10022005.nii.gz,/well/papiez/users/hri611/python/nnUnet_raw/Dataset219_PETCT/labelsTr/PETCT_3a40a26443_10022005.nii.gz,,0.0,0.0
185,0.0,0,12,0.0,52159988,0,12,0,/well/papiez/users/hri611/python/nnUNet_results/Dataset219_PETCT/nnUNetTrainer_1500epochs__nnUNetPlans__3d_fullres/crossval_results_folds_0_1_2_3_4/PETCT_3b14690fce_09072002.nii.gz,/well/papiez/users/hri611/python/nnUnet_raw/Dataset219_PETCT/labelsTr/PETCT_3b14690fce_09072002.nii.gz,0.0,0.14929225158691406,0.0
186,0.6907543003254301,14567,6719,0.5275971504028052,58834941,23773,30492,38340,/well/papiez/users/hri611/python/nnUNet_results/Dataset219_PETCT/nnUNetTrainer_1500epochs__nnUNetPlans__3d_fullres/crossval_results_folds_0_1_2_3_4/PETCT_3b1c9155f5_01312003.nii.gz,/well/papiez/users/hri611/python/nnUnet_raw/Dataset219_PETCT/labelsTr/PETCT_3b1c9155f5_01312003.nii.gz,0.6907543003254301,24.583457427978516,42.498527618408204
187,0.8891470526731569,4306,465,0.8004183225266681,52136095,19134,19599,23440,/well/papiez/users/hri611/python/nnUNet_results/Dataset219_PETCT/nnUNetTrainer_1500epochs__nnUNetPlans__3d_fullres/crossval_results_folds_0_1_2_3_4/PETCT_3b26172779_11102001.nii.gz,/well/papiez/users/hri611/python/nnUnet_raw/Dataset219_PETCT/labelsTr/PETCT_3b26172779_11102001.nii.gz,0.8891470526731569,1.3311892433166503,11.707000728607177
188,0.0,0,8,0.0,45439992,0,8,0,/well/papiez/users/hri611/python/nnUNet_results/Dataset219_PETCT/nnUNetTrainer_1500epochs__nnUNetPlans__3d_fullres/crossval_results_folds_0_1_2_3_4/PETCT_3b2a4af482_01262003.nii.gz,/well/papiez/users/hri611/python/nnUnet_raw/Dataset219_PETCT/labelsTr/PETCT_3b2a4af482_01262003.nii.gz,0.0,0.09952816772460937,0.0
189,0.8981666191697539,1013,1131,0.815156479006811,45428401,9455,10586,10468,/well/papiez/users/hri611/python/nnUNet_results/Dataset219_PETCT/nnUNetTrainer_1500epochs__nnUNetPlans__3d_fullres/crossval_results_folds_0_1_2_3_4/PETCT_3b73c2480a_10192001.nii.gz,/well/papiez/users/hri611/python/nnUnet_raw/Dataset219_PETCT/labelsTr/PETCT_3b73c2480a_10192001.nii.gz,0.8981666191697539,0.7091381950378418,0.0
190,,0,0,,48480000,0,0,0,/well/papiez/users/hri611/python/nnUNet_results/Dataset219_PETCT/nnUNetTrainer_1500epochs__nnUNetPlans__3d_fullres/crossval_results_folds_0_1_2_3_4/PETCT_3bce0eb7aa_06032007.nii.gz,/well/papiez/users/hri611/python/nnUnet_raw/Dataset219_PETCT/labelsTr/PETCT_3bce0eb7aa_06032007.nii.gz,,0.0,0.0
191,0.8874172185430463,4,47,0.7976190476190477,45439748,201,248,205,/well/papiez/users/hri611/python/nnUNet_results/Dataset219_PETCT/nnUNetTrainer_1500epochs__nnUNetPlans__3d_fullres/crossval_results_folds_0_1_2_3_4/PETCT_3c3050f75e_09052002.nii.gz,/well/papiez/users/hri611/python/nnUnet_raw/Dataset219_PETCT/labelsTr/PETCT_3c3050f75e_09052002.nii.gz,0.8874172185430463,0.0,0.0
192,0.02896527656604432,186,5379,0.014695467422096316,78874352,83,5462,269,/well/papiez/users/hri611/python/nnUNet_results/Dataset219_PETCT/nnUNetTrainer_1500epochs__nnUNetPlans__3d_fullres/crossval_results_folds_0_1_2_3_4/PETCT_3c3ee87fc6_06132003.nii.gz,/well/papiez/users/hri611/python/nnUnet_raw/Dataset219_PETCT/labelsTr/PETCT_3c3ee87fc6_06132003.nii.gz,0.02896527656604432,66.92025177383422,2.027886417388916
193,0.843877842260489,9543,1944,0.7299210006583279,52117468,31045,32989,40588,/well/papiez/users/hri611/python/nnUNet_results/Dataset219_PETCT/nnUNetTrainer_1500epochs__nnUNetPlans__3d_fullres/crossval_results_folds_0_1_2_3_4/PETCT_3c71e8f518_12112000.nii.gz,/well/papiez/users/hri611/python/nnUnet_raw/Dataset219_PETCT/labelsTr/PETCT_3c71e8f518_12112000.nii.gz,0.843877842260489,5.20034676361084,13.22480528640747
194,0.0,0,200,0.0,94719800,0,200,0,/well/papiez/users/hri611/python/nnUNet_results/Dataset219_PETCT/nnUNetTrainer_1500epochs__nnUNetPlans__3d_fullres/crossval_results_folds_0_1_2_3_4/PETCT_3c94a00f90_05112007.nii.gz,/well/papiez/users/hri611/python/nnUnet_raw/Dataset219_PETCT/labelsTr/PETCT_3c94a00f90_05112007.nii.gz,0.0,2.4882041931152346,0.0
195,0.0,0,1,0.0,45439999,0,1,0,/well/papiez/users/hri611/python/nnUNet_results/Dataset219_PETCT/nnUNetTrainer_1500epochs__nnUNetPlans__3d_fullres/crossval_results_folds_0_1_2_3_4/PETCT_3cd49210eb_12292002.nii.gz,/well/papiez/users/hri611/python/nnUnet_raw/Dataset219_PETCT/labelsTr/PETCT_3cd49210eb_12292002.nii.gz,0.0,0.012441020965576172,0.0
196,0.0,0,798,0.0,52159202,0,798,0,/well/papiez/users/hri611/python/nnUNet_results/Dataset219_PETCT/nnUNetTrainer_1500epochs__nnUNetPlans__3d_fullres/crossval_results_folds_0_1_2_3_4/PETCT_3cf68da275_03202003.nii.gz,/well/papiez/users/hri611/python/nnUnet_raw/Dataset219_PETCT/labelsTr/PETCT_3cf68da275_03202003.nii.gz,0.0,9.927934730529785,0.0
197,0.8279783393501805,360,5358,0.7064531033420607,52140521,13761,19119,14121,/well/papiez/users/hri611/python/nnUNet_results/Dataset219_PETCT/nnUNetTrainer_1500epochs__nnUNetPlans__3d_fullres/crossval_results_folds_0_1_2_3_4/PETCT_3d6f425a76_01282002.nii.gz,/well/papiez/users/hri611/python/nnUnet_raw/Dataset219_PETCT/labelsTr/PETCT_3d6f425a76_01282002.nii.gz,0.8279783393501805,32.8940594329834,0.4478767547607422
198,0.0,0,132,0.0,52159868,0,132,0,/well/papiez/users/hri611/python/nnUNet_results/Dataset219_PETCT/nnUNetTrainer_1500epochs__nnUNetPlans__3d_fullres/crossval_results_folds_0_1_2_3_4/PETCT_3d6f425a76_07222002.nii.gz,/well/papiez/users/hri611/python/nnUnet_raw/Dataset219_PETCT/labelsTr/PETCT_3d6f425a76_07222002.nii.gz,0.0,1.6422147674560548,0.0
199,,0,0,,45440000,0,0,0,/well/papiez/users/hri611/python/nnUNet_results/Dataset219_PETCT/nnUNetTrainer_1500epochs__nnUNetPlans__3d_fullres/crossval_results_folds_0_1_2_3_4/PETCT_3d8b79d739_11282004.nii.gz,/well/papiez/users/hri611/python/nnUnet_raw/Dataset219_PETCT/labelsTr/PETCT_3d8b79d739_11282004.nii.gz,,0.0,0.0
200,0.8817492190986167,1790,65,0.7885075818036712,45431229,6916,6981,8706,/well/papiez/users/hri611/python/nnUNet_results/Dataset219_PETCT/nnUNetTrainer_1500epochs__nnUNetPlans__3d_fullres/crossval_results_folds_0_1_2_3_4/PETCT_3eac8f16d4_09302001.nii.gz,/well/papiez/users/hri611/python/nnUnet_raw/Dataset219_PETCT/labelsTr/PETCT_3eac8f16d4_09302001.nii.gz,0.8817492190986167,0.0,9.741319416046142
201,0.0,0,99,0.0,52159901,0,99,0,/well/papiez/users/hri611/python/nnUNet_results/Dataset219_PETCT/nnUNetTrainer_1500epochs__nnUNetPlans__3d_fullres/crossval_results_folds_0_1_2_3_4/PETCT_3f2ee0274d_09162002.nii.gz,/well/papiez/users/hri611/python/nnUnet_raw/Dataset219_PETCT/labelsTr/PETCT_3f2ee0274d_09162002.nii.gz,0.0,1.231661075592041,0.0
202,,0,0,,52160000,0,0,0,/well/papiez/users/hri611/python/nnUNet_results/Dataset219_PETCT/nnUNetTrainer_1500epochs__nnUNetPlans__3d_fullres/crossval_results_folds_0_1_2_3_4/PETCT_3f3df20439_05092005.nii.gz,/well/papiez/users/hri611/python/nnUnet_raw/Dataset219_PETCT/labelsTr/PETCT_3f3df20439_05092005.nii.gz,,0.0,0.0
203,0.6356128717301981,591,8366,0.46585962192140257,45583231,7812,16178,8403,/well/papiez/users/hri611/python/nnUNet_results/Dataset219_PETCT/nnUNetTrainer_1500epochs__nnUNetPlans__3d_fullres/crossval_results_folds_0_1_2_3_4/PETCT_3f5a9f616f_06032007.nii.gz,/well/papiez/users/hri611/python/nnUnet_raw/Dataset219_PETCT/labelsTr/PETCT_3f5a9f616f_06032007.nii.gz,0.6356128717301981,2.9360809478759764,2.898757884979248
204,0.6918902392417641,3913,118,0.5289236882084842,45431443,4526,4644,8439,/well/papiez/users/hri611/python/nnUNet_results/Dataset219_PETCT/nnUNetTrainer_1500epochs__nnUNetPlans__3d_fullres/crossval_results_folds_0_1_2_3_4/PETCT_3fd361ec14_10242004.nii.gz,/well/papiez/users/hri611/python/nnUnet_raw/Dataset219_PETCT/labelsTr/PETCT_3fd361ec14_10242004.nii.gz,0.6918902392417641,0.0,1.8412711029052735
205,0.0,0,172,0.0,58879828,0,172,0,/well/papiez/users/hri611/python/nnUNet_results/Dataset219_PETCT/nnUNetTrainer_1500epochs__nnUNetPlans__3d_fullres/crossval_results_folds_0_1_2_3_4/PETCT_402c061122_02222003.nii.gz,/well/papiez/users/hri611/python/nnUnet_raw/Dataset219_PETCT/labelsTr/PETCT_402c061122_02222003.nii.gz,0.0,2.1398556060791014,0.0
206,0.0,0,65,0.0,45439935,0,65,0,/well/papiez/users/hri611/python/nnUNet_results/Dataset219_PETCT/nnUNetTrainer_1500epochs__nnUNetPlans__3d_fullres/crossval_results_folds_0_1_2_3_4/PETCT_402c061122_08252003.nii.gz,/well/papiez/users/hri611/python/nnUnet_raw/Dataset219_PETCT/labelsTr/PETCT_402c061122_08252003.nii.gz,0.0,0.8086663627624512,0.0
207,,0,0,,45120000,0,0,0,/well/papiez/users/hri611/python/nnUNet_results/Dataset219_PETCT/nnUNetTrainer_1500epochs__nnUNetPlans__3d_fullres/crossval_results_folds_0_1_2_3_4/PETCT_404f8c732f_06142007.nii.gz,/well/papiez/users/hri611/python/nnUnet_raw/Dataset219_PETCT/labelsTr/PETCT_404f8c732f_06142007.nii.gz,,0.0,0.0
208,0.14450867052023122,294,2,0.0778816199376947,52159679,25,27,319,/well/papiez/users/hri611/python/nnUNet_results/Dataset219_PETCT/nnUNetTrainer_1500epochs__nnUNetPlans__3d_fullres/crossval_results_folds_0_1_2_3_4/PETCT_4076ea9a15_04292005.nii.gz,/well/papiez/users/hri611/python/nnUnet_raw/Dataset219_PETCT/labelsTr/PETCT_4076ea9a15_04292005.nii.gz,0.14450867052023122,0.012441020965576172,3.3715166816711424
209,0.0,0,2,0.0,79519998,0,2,0,/well/papiez/users/hri611/python/nnUNet_results/Dataset219_PETCT/nnUNetTrainer_1500epochs__nnUNetPlans__3d_fullres/crossval_results_folds_0_1_2_3_4/PETCT_4095c12e2d_11302006.nii.gz,/well/papiez/users/hri611/python/nnUnet_raw/Dataset219_PETCT/labelsTr/PETCT_4095c12e2d_11302006.nii.gz,0.0,0.024882041931152343,0.0
210,0.6880733944954128,250,702,0.5244755244755245,52157998,1050,1752,1300,/well/papiez/users/hri611/python/nnUNet_results/Dataset219_PETCT/nnUNetTrainer_1500epochs__nnUNetPlans__3d_fullres/crossval_results_folds_0_1_2_3_4/PETCT_40a125468a_07032004.nii.gz,/well/papiez/users/hri611/python/nnUnet_raw/Dataset219_PETCT/labelsTr/PETCT_40a125468a_07032004.nii.gz,0.6880733944954128,7.9871354598999025,0.0
211,0.8939264645865024,1681,1178,0.8081980410572923,45425094,12047,13225,13728,/well/papiez/users/hri611/python/nnUNet_results/Dataset219_PETCT/nnUNetTrainer_1500epochs__nnUNetPlans__3d_fullres/crossval_results_folds_0_1_2_3_4/PETCT_40f0749cb7_10062001.nii.gz,/well/papiez/users/hri611/python/nnUnet_raw/Dataset219_PETCT/labelsTr/PETCT_40f0749cb7_10062001.nii.gz,0.8939264645865024,0.06220510482788086,2.8365527801513672
212,0.0,0,12778,0.0,52147222,0,12778,0,/well/papiez/users/hri611/python/nnUNet_results/Dataset219_PETCT/nnUNetTrainer_1500epochs__nnUNetPlans__3d_fullres/crossval_results_folds_0_1_2_3_4/PETCT_411801de5a_08252002.nii.gz,/well/papiez/users/hri611/python/nnUnet_raw/Dataset219_PETCT/labelsTr/PETCT_411801de5a_08252002.nii.gz,0.0,158.97136589813232,0.0
213,,0,0,,53600000,0,0,0,/well/papiez/users/hri611/python/nnUNet_results/Dataset219_PETCT/nnUNetTrainer_1500epochs__nnUNetPlans__3d_fullres/crossval_results_folds_0_1_2_3_4/PETCT_416d3b9b78_08142006.nii.gz,/well/papiez/users/hri611/python/nnUnet_raw/Dataset219_PETCT/labelsTr/PETCT_416d3b9b78_08142006.nii.gz,,0.0,0.0
214,,0,0,,93760000,0,0,0,/well/papiez/users/hri611/python/nnUNet_results/Dataset219_PETCT/nnUNetTrainer_1500epochs__nnUNetPlans__3d_fullres/crossval_results_folds_0_1_2_3_4/PETCT_41bd54f97a_03252007.nii.gz,/well/papiez/users/hri611/python/nnUnet_raw/Dataset219_PETCT/labelsTr/PETCT_41bd54f97a_03252007.nii.gz,,0.0,0.0
215,0.0,0,1774,0.0,52158226,0,1774,0,/well/papiez/users/hri611/python/nnUNet_results/Dataset219_PETCT/nnUNetTrainer_1500epochs__nnUNetPlans__3d_fullres/crossval_results_folds_0_1_2_3_4/PETCT_41f4d41517_11132004.nii.gz,/well/papiez/users/hri611/python/nnUnet_raw/Dataset219_PETCT/labelsTr/PETCT_41f4d41517_11132004.nii.gz,0.0,22.07037119293213,0.0
216,0.06981981981981981,0,826,0.03617269544924154,45439143,31,857,31,/well/papiez/users/hri611/python/nnUNet_results/Dataset219_PETCT/nnUNetTrainer_1500epochs__nnUNetPlans__3d_fullres/crossval_results_folds_0_1_2_3_4/PETCT_41fadf6520_02272003.nii.gz,/well/papiez/users/hri611/python/nnUnet_raw/Dataset219_PETCT/labelsTr/PETCT_41fadf6520_02272003.nii.gz,0.06981981981981981,10.102109024047852,0.0
217,0.8505097405874634,927,554,0.7399016508605549,92314306,4213,4767,5140,/well/papiez/users/hri611/python/nnUNet_results/Dataset219_PETCT/nnUNetTrainer_1500epochs__nnUNetPlans__3d_fullres/crossval_results_folds_0_1_2_3_4/PETCT_424e9b79c5_05112003.nii.gz,/well/papiez/users/hri611/python/nnUnet_raw/Dataset219_PETCT/labelsTr/PETCT_424e9b79c5_05112003.nii.gz,0.8505097405874634,6.170746398925781,0.012441020965576172
218,0.8667379842591885,2049,1439,0.7648169374957858,52145169,11343,12782,13392,/well/papiez/users/hri611/python/nnUNet_results/Dataset219_PETCT/nnUNetTrainer_1500epochs__nnUNetPlans__3d_fullres/crossval_results_folds_0_1_2_3_4/PETCT_4250de48c8_02122001.nii.gz,/well/papiez/users/hri611/python/nnUnet_raw/Dataset219_PETCT/labelsTr/PETCT_4250de48c8_02122001.nii.gz,0.8667379842591885,0.8335484046936035,5.8846029167175296
219,0.694854407658556,3631,194,0.53239608801956,52151820,4355,4549,7986,/well/papiez/users/hri611/python/nnUNet_results/Dataset219_PETCT/nnUNetTrainer_1500epochs__nnUNetPlans__3d_fullres/crossval_results_folds_0_1_2_3_4/PETCT_42e9f16c09_01052003.nii.gz,/well/papiez/users/hri611/python/nnUnet_raw/Dataset219_PETCT/labelsTr/PETCT_42e9f16c09_01052003.nii.gz,0.694854407658556,1.8163890609741211,15.066076389312745
220,0.8327734864785374,9111,1692,0.7134634767386345,45402298,26899,28591,36010,/well/papiez/users/hri611/python/nnUNet_results/Dataset219_PETCT/nnUNetTrainer_1500epochs__nnUNetPlans__3d_fullres/crossval_results_folds_0_1_2_3_4/PETCT_43323b7d42_05272001.nii.gz,/well/papiez/users/hri611/python/nnUnet_raw/Dataset219_PETCT/labelsTr/PETCT_43323b7d42_05272001.nii.gz,0.8327734864785374,0.07464612579345703,13.672682041168212
221,0.8888039740160489,119,172,0.7998624484181568,50878546,1163,1335,1282,/well/papiez/users/hri611/python/nnUNet_results/Dataset219_PETCT/nnUNetTrainer_1500epochs__nnUNetPlans__3d_fullres/crossval_results_folds_0_1_2_3_4/PETCT_43647ff727_03022006.nii.gz,/well/papiez/users/hri611/python/nnUnet_raw/Dataset219_PETCT/labelsTr/PETCT_43647ff727_03022006.nii.gz,0.8888039740160489,0.0,0.0
222,,0,0,,45440000,0,0,0,/well/papiez/users/hri611/python/nnUNet_results/Dataset219_PETCT/nnUNetTrainer_1500epochs__nnUNetPlans__3d_fullres/crossval_results_folds_0_1_2_3_4/PETCT_437d2c96fe_11162003.nii.gz,/well/papiez/users/hri611/python/nnUnet_raw/Dataset219_PETCT/labelsTr/PETCT_437d2c96fe_11162003.nii.gz,,0.0,0.0
223,0.0,0,128,0.0,46399872,0,128,0,/well/papiez/users/hri611/python/nnUNet_results/Dataset219_PETCT/nnUNetTrainer_1500epochs__nnUNetPlans__3d_fullres/crossval_results_folds_0_1_2_3_4/PETCT_43c9c71b31_05142007.nii.gz,/well/papiez/users/hri611/python/nnUnet_raw/Dataset219_PETCT/labelsTr/PETCT_43c9c71b31_05142007.nii.gz,0.0,1.59245068359375,0.0
224,0.9565217391304348,2,9,0.9166666666666666,101759868,121,130,123,/well/papiez/users/hri611/python/nnUNet_results/Dataset219_PETCT/nnUNetTrainer_1500epochs__nnUNetPlans__3d_fullres/crossval_results_folds_0_1_2_3_4/PETCT_4404466919_09102005.nii.gz,/well/papiez/users/hri611/python/nnUnet_raw/Dataset219_PETCT/labelsTr/PETCT_4404466919_09102005.nii.gz,0.9565217391304348,0.0,0.0
225,0.0,0,440,0.0,45439560,0,440,0,/well/papiez/users/hri611/python/nnUNet_results/Dataset219_PETCT/nnUNetTrainer_1500epochs__nnUNetPlans__3d_fullres/crossval_results_folds_0_1_2_3_4/PETCT_4481687483_10172003.nii.gz,/well/papiez/users/hri611/python/nnUnet_raw/Dataset219_PETCT/labelsTr/PETCT_4481687483_10172003.nii.gz,0.0,5.474049224853515,0.0
226,0.0,0,3,0.0,87839997,0,3,0,/well/papiez/users/hri611/python/nnUNet_results/Dataset219_PETCT/nnUNetTrainer_1500epochs__nnUNetPlans__3d_fullres/crossval_results_folds_0_1_2_3_4/PETCT_448225c237_01162006.nii.gz,/well/papiez/users/hri611/python/nnUnet_raw/Dataset219_PETCT/labelsTr/PETCT_448225c237_01162006.nii.gz,0.0,0.037323062896728515,0.0
227,0.9094324338602598,3818,11611,0.8339074644218141,45347106,77465,89076,81283,/well/papiez/users/hri611/python/nnUNet_results/Dataset219_PETCT/nnUNetTrainer_1500epochs__nnUNetPlans__3d_fullres/crossval_results_folds_0_1_2_3_4/PETCT_44b08f570e_02102001.nii.gz,/well/papiez/users/hri611/python/nnUnet_raw/Dataset219_PETCT/labelsTr/PETCT_44b08f570e_02102001.nii.gz,0.9094324338602598,31.612634273529054,0.9579586143493652
228,0.0,0,31,0.0,52159969,0,31,0,/well/papiez/users/hri611/python/nnUNet_results/Dataset219_PETCT/nnUNetTrainer_1500epochs__nnUNetPlans__3d_fullres/crossval_results_folds_0_1_2_3_4/PETCT_44b95650c3_10022003.nii.gz,/well/papiez/users/hri611/python/nnUnet_raw/Dataset219_PETCT/labelsTr/PETCT_44b95650c3_10022003.nii.gz,0.0,0.3856716499328613,0.0
229,0.0,0,319,0.0,52159681,0,319,0,/well/papiez/users/hri611/python/nnUNet_results/Dataset219_PETCT/nnUNetTrainer_1500epochs__nnUNetPlans__3d_fullres/crossval_results_folds_0_1_2_3_4/PETCT_44bf7dc508_07252002.nii.gz,/well/papiez/users/hri611/python/nnUnet_raw/Dataset219_PETCT/labelsTr/PETCT_44bf7dc508_07252002.nii.gz,0.0,3.9686856880187986,0.0
230,0.0,0,415,0.0,99039585,0,415,0,/well/papiez/users/hri611/python/nnUNet_results/Dataset219_PETCT/nnUNetTrainer_1500epochs__nnUNetPlans__3d_fullres/crossval_results_folds_0_1_2_3_4/PETCT_44c04dcf65_10032003.nii.gz,/well/papiez/users/hri611/python/nnUnet_raw/Dataset219_PETCT/labelsTr/PETCT_44c04dcf65_10032003.nii.gz,0.0,5.1630237007141115,0.0
231,0.0,0,408,0.0,93599592,0,408,0,/well/papiez/users/hri611/python/nnUNet_results/Dataset219_PETCT/nnUNetTrainer_1500epochs__nnUNetPlans__3d_fullres/crossval_results_folds_0_1_2_3_4/PETCT_44cfacfd6e_04152007.nii.gz,/well/papiez/users/hri611/python/nnUnet_raw/Dataset219_PETCT/labelsTr/PETCT_44cfacfd6e_04152007.nii.gz,0.0,5.075936553955078,0.0
232,0.0,0,79,0.0,38719921,0,79,0,/well/papiez/users/hri611/python/nnUNet_results/Dataset219_PETCT/nnUNetTrainer_1500epochs__nnUNetPlans__3d_fullres/crossval_results_folds_0_1_2_3_4/PETCT_44d6ba6772_07132003.nii.gz,/well/papiez/users/hri611/python/nnUnet_raw/Dataset219_PETCT/labelsTr/PETCT_44d6ba6772_07132003.nii.gz,0.0,0.9828406562805175,0.0
233,0.929635761589404,3,337,0.868522815158546,52157414,2246,2583,2249,/well/papiez/users/hri611/python/nnUNet_results/Dataset219_PETCT/nnUNetTrainer_1500epochs__nnUNetPlans__3d_fullres/crossval_results_folds_0_1_2_3_4/PETCT_456d14846b_09012003.nii.gz,/well/papiez/users/hri611/python/nnUnet_raw/Dataset219_PETCT/labelsTr/PETCT_456d14846b_09012003.nii.gz,0.929635761589404,1.741742935180664,0.0
234,0.08225729316116691,74,1845,0.0428927680798005,52477995,86,1931,160,/well/papiez/users/hri611/python/nnUNet_results/Dataset219_PETCT/nnUNetTrainer_1500epochs__nnUNetPlans__3d_fullres/crossval_results_folds_0_1_2_3_4/PETCT_456e6f9dc2_07282005.nii.gz,/well/papiez/users/hri611/python/nnUnet_raw/Dataset219_PETCT/labelsTr/PETCT_456e6f9dc2_07282005.nii.gz,0.08225729316116691,22.953683681488037,0.0
235,0.7804878048780488,1674,36,0.64,45435250,3040,3076,4714,/well/papiez/users/hri611/python/nnUNet_results/Dataset219_PETCT/nnUNetTrainer_1500epochs__nnUNetPlans__3d_fullres/crossval_results_folds_0_1_2_3_4/PETCT_465176d213_05162002.nii.gz,/well/papiez/users/hri611/python/nnUnet_raw/Dataset219_PETCT/labelsTr/PETCT_465176d213_05162002.nii.gz,0.7804878048780488,0.0,0.0
236,0.8668407310704961,47,208,0.7649769585253456,48638915,830,1038,877,/well/papiez/users/hri611/python/nnUNet_results/Dataset219_PETCT/nnUNetTrainer_1500epochs__nnUNetPlans__3d_fullres/crossval_results_folds_0_1_2_3_4/PETCT_46ee4ddd68_03192007.nii.gz,/well/papiez/users/hri611/python/nnUnet_raw/Dataset219_PETCT/labelsTr/PETCT_46ee4ddd68_03192007.nii.gz,0.8668407310704961,0.23637939834594726,0.18661531448364257
237,0.0,0,118,0.0,45439882,0,118,0,/well/papiez/users/hri611/python/nnUNet_results/Dataset219_PETCT/nnUNetTrainer_1500epochs__nnUNetPlans__3d_fullres/crossval_results_folds_0_1_2_3_4/PETCT_474d7af918_12092004.nii.gz,/well/papiez/users/hri611/python/nnUnet_raw/Dataset219_PETCT/labelsTr/PETCT_474d7af918_12092004.nii.gz,0.0,1.4680404739379882,0.0
238,0.6789235412474849,12426,340,0.5139169173361764,103813737,13497,13837,25923,/well/papiez/users/hri611/python/nnUNet_results/Dataset219_PETCT/nnUNetTrainer_1500epochs__nnUNetPlans__3d_fullres/crossval_results_folds_0_1_2_3_4/PETCT_4776e75543_04012007.nii.gz,/well/papiez/users/hri611/python/nnUnet_raw/Dataset219_PETCT/labelsTr/PETCT_4776e75543_04012007.nii.gz,0.6789235412474849,1.3311892433166503,0.0
239,0.0,0,1902,0.0,51838098,0,1902,0,/well/papiez/users/hri611/python/nnUNet_results/Dataset219_PETCT/nnUNetTrainer_1500epochs__nnUNetPlans__3d_fullres/crossval_results_folds_0_1_2_3_4/PETCT_4785066413_08242006.nii.gz,/well/papiez/users/hri611/python/nnUnet_raw/Dataset219_PETCT/labelsTr/PETCT_4785066413_08242006.nii.gz,0.0,23.66282187652588,0.0
240,0.401041378164294,10014,799,0.25081410656135245,52145567,3620,4419,13634,/well/papiez/users/hri611/python/nnUNet_results/Dataset219_PETCT/nnUNetTrainer_1500epochs__nnUNetPlans__3d_fullres/crossval_results_folds_0_1_2_3_4/PETCT_47cd731006_01252002.nii.gz,/well/papiez/users/hri611/python/nnUnet_raw/Dataset219_PETCT/labelsTr/PETCT_47cd731006_01252002.nii.gz,0.401041378164294,1.7666249771118163,0.0
241,,0,0,,50400000,0,0,0,/well/papiez/users/hri611/python/nnUNet_results/Dataset219_PETCT/nnUNetTrainer_1500epochs__nnUNetPlans__3d_fullres/crossval_results_folds_0_1_2_3_4/PETCT_47f4460050_08062006.nii.gz,/well/papiez/users/hri611/python/nnUnet_raw/Dataset219_PETCT/labelsTr/PETCT_47f4460050_08062006.nii.gz,,0.0,0.0
242,0.8457541041691272,328,7508,0.7327330400081858,52130681,21483,28991,21811,/well/papiez/users/hri611/python/nnUNet_results/Dataset219_PETCT/nnUNetTrainer_1500epochs__nnUNetPlans__3d_fullres/crossval_results_folds_0_1_2_3_4/PETCT_4848bebb10_02232003.nii.gz,/well/papiez/users/hri611/python/nnUnet_raw/Dataset219_PETCT/labelsTr/PETCT_4848bebb10_02232003.nii.gz,0.8457541041691272,2.314029899597168,0.5225228805541993
243,0.0,0,275,0.0,52159725,0,275,0,/well/papiez/users/hri611/python/nnUNet_results/Dataset219_PETCT/nnUNetTrainer_1500epochs__nnUNetPlans__3d_fullres/crossval_results_folds_0_1_2_3_4/PETCT_48a34ccdf0_02152003.nii.gz,/well/papiez/users/hri611/python/nnUnet_raw/Dataset219_PETCT/labelsTr/PETCT_48a34ccdf0_02152003.nii.gz,0.0,3.421280765533447,0.0
244,0.0,0,8,0.0,58399992,0,8,0,/well/papiez/users/hri611/python/nnUNet_results/Dataset219_PETCT/nnUNetTrainer_1500epochs__nnUNetPlans__3d_fullres/crossval_results_folds_0_1_2_3_4/PETCT_48c70dc4a3_04132007.nii.gz,/well/papiez/users/hri611/python/nnUnet_raw/Dataset219_PETCT/labelsTr/PETCT_48c70dc4a3_04132007.nii.gz,0.0,0.09952816772460937,0.0
245,,0,0,,44960000,0,0,0,/well/papiez/users/hri611/python/nnUNet_results/Dataset219_PETCT/nnUNetTrainer_1500epochs__nnUNetPlans__3d_fullres/crossval_results_folds_0_1_2_3_4/PETCT_48c70dc4a3_10202006.nii.gz,/well/papiez/users/hri611/python/nnUnet_raw/Dataset219_PETCT/labelsTr/PETCT_48c70dc4a3_10202006.nii.gz,,0.0,0.0
246,0.8905070118662352,728,84,0.8026251823043267,92315886,3302,3386,4030,/well/papiez/users/hri611/python/nnUNet_results/Dataset219_PETCT/nnUNetTrainer_1500epochs__nnUNetPlans__3d_fullres/crossval_results_folds_0_1_2_3_4/PETCT_48cb8662f7_03072003.nii.gz,/well/papiez/users/hri611/python/nnUnet_raw/Dataset219_PETCT/labelsTr/PETCT_48cb8662f7_03072003.nii.gz,0.8905070118662352,0.11196918869018554,1.157014949798584
247,,0,0,,49120000,0,0,0,/well/papiez/users/hri611/python/nnUNet_results/Dataset219_PETCT/nnUNetTrainer_1500epochs__nnUNetPlans__3d_fullres/crossval_results_folds_0_1_2_3_4/PETCT_48d5467561_01272006.nii.gz,/well/papiez/users/hri611/python/nnUnet_raw/Dataset219_PETCT/labelsTr/PETCT_48d5467561_01272006.nii.gz,,0.0,0.0
248,0.0,0,44,0.0,51039956,0,44,0,/well/papiez/users/hri611/python/nnUNet_results/Dataset219_PETCT/nnUNetTrainer_1500epochs__nnUNetPlans__3d_fullres/crossval_results_folds_0_1_2_3_4/PETCT_48d5467561_10282005.nii.gz,/well/papiez/users/hri611/python/nnUnet_raw/Dataset219_PETCT/labelsTr/PETCT_48d5467561_10282005.nii.gz,0.0,0.5474049224853516,0.0
249,0.8934913950933724,8628,680,0.8074870734229576,52111650,39042,39722,47670,/well/papiez/users/hri611/python/nnUNet_results/Dataset219_PETCT/nnUNetTrainer_1500epochs__nnUNetPlans__3d_fullres/crossval_results_folds_0_1_2_3_4/PETCT_49479d6e64_06072002.nii.gz,/well/papiez/users/hri611/python/nnUnet_raw/Dataset219_PETCT/labelsTr/PETCT_49479d6e64_06072002.nii.gz,0.8934913950933724,0.23637939834594726,0.6842561531066894
250,0.7509266123054115,459,213,0.601186943620178,52158315,1013,1226,1472,/well/papiez/users/hri611/python/nnUNet_results/Dataset219_PETCT/nnUNetTrainer_1500epochs__nnUNetPlans__3d_fullres/crossval_results_folds_0_1_2_3_4/PETCT_49f3d297b0_07242003.nii.gz,/well/papiez/users/hri611/python/nnUnet_raw/Dataset219_PETCT/labelsTr/PETCT_49f3d297b0_07242003.nii.gz,0.7509266123054115,0.0870871467590332,0.21149735641479492
251,,0,0,,36160000,0,0,0,/well/papiez/users/hri611/python/nnUNet_results/Dataset219_PETCT/nnUNetTrainer_1500epochs__nnUNetPlans__3d_fullres/crossval_results_folds_0_1_2_3_4/PETCT_4a0d2e5166_11242006.nii.gz,/well/papiez/users/hri611/python/nnUnet_raw/Dataset219_PETCT/labelsTr/PETCT_4a0d2e5166_11242006.nii.gz,,0.0,0.0
252,0.5614154474310991,847,442,0.3902554399243141,45437886,825,1267,1672,/well/papiez/users/hri611/python/nnUNet_results/Dataset219_PETCT/nnUNetTrainer_1500epochs__nnUNetPlans__3d_fullres/crossval_results_folds_0_1_2_3_4/PETCT_4a255db7bd_05242003.nii.gz,/well/papiez/users/hri611/python/nnUnet_raw/Dataset219_PETCT/labelsTr/PETCT_4a255db7bd_05242003.nii.gz,0.5614154474310991,1.3311892433166503,1.9034762077331542
253,0.35951758770468323,2832,106727,0.21915357641759559,52019692,30749,137476,33581,/well/papiez/users/hri611/python/nnUNet_results/Dataset219_PETCT/nnUNetTrainer_1500epochs__nnUNetPlans__3d_fullres/crossval_results_folds_0_1_2_3_4/PETCT_4b688f46b0_02182005.nii.gz,/well/papiez/users/hri611/python/nnUnet_raw/Dataset219_PETCT/labelsTr/PETCT_4b688f46b0_02182005.nii.gz,0.35951758770468323,9.430293891906738,0.11196918869018554
254,,0,0,,44960000,0,0,0,/well/papiez/users/hri611/python/nnUNet_results/Dataset219_PETCT/nnUNetTrainer_1500epochs__nnUNetPlans__3d_fullres/crossval_results_folds_0_1_2_3_4/PETCT_4bab91dccd_01052006.nii.gz,/well/papiez/users/hri611/python/nnUnet_raw/Dataset219_PETCT/labelsTr/PETCT_4bab91dccd_01052006.nii.gz,,0.0,0.0
255,0.8450154496666125,607,346,0.7316248943959448,45436449,2598,2944,3205,/well/papiez/users/hri611/python/nnUNet_results/Dataset219_PETCT/nnUNetTrainer_1500epochs__nnUNetPlans__3d_fullres/crossval_results_folds_0_1_2_3_4/PETCT_4be28f9cd7_02032002.nii.gz,/well/papiez/users/hri611/python/nnUnet_raw/Dataset219_PETCT/labelsTr/PETCT_4be28f9cd7_02032002.nii.gz,0.8450154496666125,1.5053635368347167,0.1741742935180664
256,0.8875822877398301,15345,4635,0.7978857923220879,98941145,78875,83510,94220,/well/papiez/users/hri611/python/nnUNet_results/Dataset219_PETCT/nnUNetTrainer_1500epochs__nnUNetPlans__3d_fullres/crossval_results_folds_0_1_2_3_4/PETCT_4c670a5445_06222001.nii.gz,/well/papiez/users/hri611/python/nnUnet_raw/Dataset219_PETCT/labelsTr/PETCT_4c670a5445_06222001.nii.gz,0.8875822877398301,8.658950592041016,0.0
257,0.37099816609903064,91415,4621,0.22774570192508725,52035642,28322,32943,119737,/well/papiez/users/hri611/python/nnUNet_results/Dataset219_PETCT/nnUNetTrainer_1500epochs__nnUNetPlans__3d_fullres/crossval_results_folds_0_1_2_3_4/PETCT_4c75fa4a5d_04192001.nii.gz,/well/papiez/users/hri611/python/nnUnet_raw/Dataset219_PETCT/labelsTr/PETCT_4c75fa4a5d_04192001.nii.gz,0.37099816609903064,0.0,292.46352085876464
258,0.8691022794639017,5656,5605,0.7685065268784048,52111355,37384,42989,43040,/well/papiez/users/hri611/python/nnUNet_results/Dataset219_PETCT/nnUNetTrainer_1500epochs__nnUNetPlans__3d_fullres/crossval_results_folds_0_1_2_3_4/PETCT_4c9e7be363_09172000.nii.gz,/well/papiez/users/hri611/python/nnUnet_raw/Dataset219_PETCT/labelsTr/PETCT_4c9e7be363_09172000.nii.gz,0.8691022794639017,2.0652094802856444,0.4478767547607422
259,0.15748031496062992,44,63,0.08547008547008547,85599883,10,73,54,/well/papiez/users/hri611/python/nnUNet_results/Dataset219_PETCT/nnUNetTrainer_1500epochs__nnUNetPlans__3d_fullres/crossval_results_folds_0_1_2_3_4/PETCT_4cb875dc0b_01132005.nii.gz,/well/papiez/users/hri611/python/nnUnet_raw/Dataset219_PETCT/labelsTr/PETCT_4cb875dc0b_01132005.nii.gz,0.15748031496062992,0.7713432998657226,0.0
260,,0,0,,48160000,0,0,0,/well/papiez/users/hri611/python/nnUNet_results/Dataset219_PETCT/nnUNetTrainer_1500epochs__nnUNetPlans__3d_fullres/crossval_results_folds_0_1_2_3_4/PETCT_4cc808d16f_06112006.nii.gz,/well/papiez/users/hri611/python/nnUnet_raw/Dataset219_PETCT/labelsTr/PETCT_4cc808d16f_06112006.nii.gz,,0.0,0.0
261,0.5554382259767687,3284,84,0.3845029239766082,45434528,2104,2188,5388,/well/papiez/users/hri611/python/nnUNet_results/Dataset219_PETCT/nnUNetTrainer_1500epochs__nnUNetPlans__3d_fullres/crossval_results_folds_0_1_2_3_4/PETCT_4dcf62f869_11032000.nii.gz,/well/papiez/users/hri611/python/nnUnet_raw/Dataset219_PETCT/labelsTr/PETCT_4dcf62f869_11032000.nii.gz,0.5554382259767687,0.945517593383789,6.170746398925781
262,0.0,0,1,0.0,52159999,0,1,0,/well/papiez/users/hri611/python/nnUNet_results/Dataset219_PETCT/nnUNetTrainer_1500epochs__nnUNetPlans__3d_fullres/crossval_results_folds_0_1_2_3_4/PETCT_4ea806706c_10302003.nii.gz,/well/papiez/users/hri611/python/nnUnet_raw/Dataset219_PETCT/labelsTr/PETCT_4ea806706c_10302003.nii.gz,0.0,0.012441020965576172,0.0
263,0.0,0,296,0.0,38719704,0,296,0,/well/papiez/users/hri611/python/nnUNet_results/Dataset219_PETCT/nnUNetTrainer_1500epochs__nnUNetPlans__3d_fullres/crossval_results_folds_0_1_2_3_4/PETCT_4ef69de4e1_10252002.nii.gz,/well/papiez/users/hri611/python/nnUnet_raw/Dataset219_PETCT/labelsTr/PETCT_4ef69de4e1_10252002.nii.gz,0.0,3.682542205810547,0.0
264,0.0,0,447,0.0,89439553,0,447,0,/well/papiez/users/hri611/python/nnUNet_results/Dataset219_PETCT/nnUNetTrainer_1500epochs__nnUNetPlans__3d_fullres/crossval_results_folds_0_1_2_3_4/PETCT_4f6ff86453_08252006.nii.gz,/well/papiez/users/hri611/python/nnUnet_raw/Dataset219_PETCT/labelsTr/PETCT_4f6ff86453_08252006.nii.gz,0.0,5.561136371612549,0.0
265,0.7086723786480171,15088,2491,0.5487936344969199,52121040,21381,23872,36469,/well/papiez/users/hri611/python/nnUNet_results/Dataset219_PETCT/nnUNetTrainer_1500epochs__nnUNetPlans__3d_fullres/crossval_results_folds_0_1_2_3_4/PETCT_4f7a8f41c0_05272001.nii.gz,/well/papiez/users/hri611/python/nnUnet_raw/Dataset219_PETCT/labelsTr/PETCT_4f7a8f41c0_05272001.nii.gz,0.7086723786480171,0.0,32.060511028289795
266,0.0,0,392,0.0,42399608,0,392,0,/well/papiez/users/hri611/python/nnUNet_results/Dataset219_PETCT/nnUNetTrainer_1500epochs__nnUNetPlans__3d_fullres/crossval_results_folds_0_1_2_3_4/PETCT_4fb1817df3_06062005.nii.gz,/well/papiez/users/hri611/python/nnUnet_raw/Dataset219_PETCT/labelsTr/PETCT_4fb1817df3_06062005.nii.gz,0.0,4.8768802185058595,0.0
267,,0,0,,45440000,0,0,0,/well/papiez/users/hri611/python/nnUNet_results/Dataset219_PETCT/nnUNetTrainer_1500epochs__nnUNetPlans__3d_fullres/crossval_results_folds_0_1_2_3_4/PETCT_5001354a69_11282002.nii.gz,/well/papiez/users/hri611/python/nnUnet_raw/Dataset219_PETCT/labelsTr/PETCT_5001354a69_11282002.nii.gz,,0.0,0.0
268,0.8394160583941606,60,28,0.7232704402515723,52159682,230,258,290,/well/papiez/users/hri611/python/nnUNet_results/Dataset219_PETCT/nnUNetTrainer_1500epochs__nnUNetPlans__3d_fullres/crossval_results_folds_0_1_2_3_4/PETCT_5060603ba4_09192003.nii.gz,/well/papiez/users/hri611/python/nnUnet_raw/Dataset219_PETCT/labelsTr/PETCT_5060603ba4_09192003.nii.gz,0.8394160583941606,0.0,0.7464612579345703
269,,0,0,,52160000,0,0,0,/well/papiez/users/hri611/python/nnUNet_results/Dataset219_PETCT/nnUNetTrainer_1500epochs__nnUNetPlans__3d_fullres/crossval_results_folds_0_1_2_3_4/PETCT_5109748328_08032002.nii.gz,/well/papiez/users/hri611/python/nnUnet_raw/Dataset219_PETCT/labelsTr/PETCT_5109748328_08032002.nii.gz,,0.0,0.0
270,0.9170380913142814,6036,609,0.8467870235871896,45396629,36726,37335,42762,/well/papiez/users/hri611/python/nnUNet_results/Dataset219_PETCT/nnUNetTrainer_1500epochs__nnUNetPlans__3d_fullres/crossval_results_folds_0_1_2_3_4/PETCT_510fb36781_02062003.nii.gz,/well/papiez/users/hri611/python/nnUnet_raw/Dataset219_PETCT/labelsTr/PETCT_510fb36781_02062003.nii.gz,0.9170380913142814,0.0,0.0
271,0.0,0,131,0.0,43679869,0,131,0,/well/papiez/users/hri611/python/nnUNet_results/Dataset219_PETCT/nnUNetTrainer_1500epochs__nnUNetPlans__3d_fullres/crossval_results_folds_0_1_2_3_4/PETCT_515c40c4a6_07242006.nii.gz,/well/papiez/users/hri611/python/nnUnet_raw/Dataset219_PETCT/labelsTr/PETCT_515c40c4a6_07242006.nii.gz,0.0,1.6297737464904785,0.0
272,0.7061284250156871,4857,763,0.5457484642741675,45427628,6752,7515,11609,/well/papiez/users/hri611/python/nnUNet_results/Dataset219_PETCT/nnUNetTrainer_1500epochs__nnUNetPlans__3d_fullres/crossval_results_folds_0_1_2_3_4/PETCT_5255c79083_10202001.nii.gz,/well/papiez/users/hri611/python/nnUnet_raw/Dataset219_PETCT/labelsTr/PETCT_5255c79083_10202001.nii.gz,0.7061284250156871,0.48519981765747067,19.258700454711914
273,0.9319630622579684,515,1769,0.8725944106654766,45422073,15643,17412,16158,/well/papiez/users/hri611/python/nnUNet_results/Dataset219_PETCT/nnUNetTrainer_1500epochs__nnUNetPlans__3d_fullres/crossval_results_folds_0_1_2_3_4/PETCT_527c5afc5d_07182003.nii.gz,/well/papiez/users/hri611/python/nnUnet_raw/Dataset219_PETCT/labelsTr/PETCT_527c5afc5d_07182003.nii.gz,0.9319630622579684,2.7370246124267577,0.49764083862304687
274,,0,0,,41440000,0,0,0,/well/papiez/users/hri611/python/nnUNet_results/Dataset219_PETCT/nnUNetTrainer_1500epochs__nnUNetPlans__3d_fullres/crossval_results_folds_0_1_2_3_4/PETCT_52f84711a5_04012006.nii.gz,/well/papiez/users/hri611/python/nnUnet_raw/Dataset219_PETCT/labelsTr/PETCT_52f84711a5_04012006.nii.gz,,0.0,0.0
275,,0,0,,48480000,0,0,0,/well/papiez/users/hri611/python/nnUNet_results/Dataset219_PETCT/nnUNetTrainer_1500epochs__nnUNetPlans__3d_fullres/crossval_results_folds_0_1_2_3_4/PETCT_53ccb9efbb_12152005.nii.gz,/well/papiez/users/hri611/python/nnUnet_raw/Dataset219_PETCT/labelsTr/PETCT_53ccb9efbb_12152005.nii.gz,,0.0,0.0
276,0.6540751277593383,494,12638,0.4859670411398599,50054453,12415,25053,12909,/well/papiez/users/hri611/python/nnUNet_results/Dataset219_PETCT/nnUNetTrainer_1500epochs__nnUNetPlans__3d_fullres/crossval_results_folds_0_1_2_3_4/PETCT_53dad1785b_12112005.nii.gz,/well/papiez/users/hri611/python/nnUnet_raw/Dataset219_PETCT/labelsTr/PETCT_53dad1785b_12112005.nii.gz,0.6540751277593383,66.27331868362427,4.503649589538574
277,0.0,0,391,0.0,46079609,0,391,0,/well/papiez/users/hri611/python/nnUNet_results/Dataset219_PETCT/nnUNetTrainer_1500epochs__nnUNetPlans__3d_fullres/crossval_results_folds_0_1_2_3_4/PETCT_5420205a5f_12072006.nii.gz,/well/papiez/users/hri611/python/nnUnet_raw/Dataset219_PETCT/labelsTr/PETCT_5420205a5f_12072006.nii.gz,0.0,4.864439197540283,0.0
278,,0,0,,52480000,0,0,0,/well/papiez/users/hri611/python/nnUNet_results/Dataset219_PETCT/nnUNetTrainer_1500epochs__nnUNetPlans__3d_fullres/crossval_results_folds_0_1_2_3_4/PETCT_544676de40_03232007.nii.gz,/well/papiez/users/hri611/python/nnUnet_raw/Dataset219_PETCT/labelsTr/PETCT_544676de40_03232007.nii.gz,,0.0,0.0
279,0.7793962423474773,465,580,0.6385333794534763,53437109,1846,2426,2311,/well/papiez/users/hri611/python/nnUNet_results/Dataset219_PETCT/nnUNetTrainer_1500epochs__nnUNetPlans__3d_fullres/crossval_results_folds_0_1_2_3_4/PETCT_544676de40_07032005.nii.gz,/well/papiez/users/hri611/python/nnUnet_raw/Dataset219_PETCT/labelsTr/PETCT_544676de40_07032005.nii.gz,0.7793962423474773,0.2737024612426758,5.648223518371582
280,,0,0,,50560000,0,0,0,/well/papiez/users/hri611/python/nnUNet_results/Dataset219_PETCT/nnUNetTrainer_1500epochs__nnUNetPlans__3d_fullres/crossval_results_folds_0_1_2_3_4/PETCT_544676de40_12152005.nii.gz,/well/papiez/users/hri611/python/nnUnet_raw/Dataset219_PETCT/labelsTr/PETCT_544676de40_12152005.nii.gz,,0.0,0.0
281,0.9005054351589005,1362,75,0.8190176322418136,48792060,6503,6578,7865,/well/papiez/users/hri611/python/nnUNet_results/Dataset219_PETCT/nnUNetTrainer_1500epochs__nnUNetPlans__3d_fullres/crossval_results_folds_0_1_2_3_4/PETCT_548213edf7_09192005.nii.gz,/well/papiez/users/hri611/python/nnUnet_raw/Dataset219_PETCT/labelsTr/PETCT_548213edf7_09192005.nii.gz,0.9005054351589005,0.0,0.8211073837280274
282,0.7167907758827768,224,955,0.5585922875327592,52157329,1492,2447,1716,/well/papiez/users/hri611/python/nnUNet_results/Dataset219_PETCT/nnUNetTrainer_1500epochs__nnUNetPlans__3d_fullres/crossval_results_folds_0_1_2_3_4/PETCT_548bd05667_04242004.nii.gz,/well/papiez/users/hri611/python/nnUnet_raw/Dataset219_PETCT/labelsTr/PETCT_548bd05667_04242004.nii.gz,0.7167907758827768,4.466326526641845,0.0
283,0.0,0,6,0.0,45439994,0,6,0,/well/papiez/users/hri611/python/nnUNet_results/Dataset219_PETCT/nnUNetTrainer_1500epochs__nnUNetPlans__3d_fullres/crossval_results_folds_0_1_2_3_4/PETCT_54977a7e76_02212003.nii.gz,/well/papiez/users/hri611/python/nnUnet_raw/Dataset219_PETCT/labelsTr/PETCT_54977a7e76_02212003.nii.gz,0.0,0.07464612579345703,0.0
284,0.961974418524039,9,1088,0.926734789287384,58865027,13876,14964,13885,/well/papiez/users/hri611/python/nnUNet_results/Dataset219_PETCT/nnUNetTrainer_1500epochs__nnUNetPlans__3d_fullres/crossval_results_folds_0_1_2_3_4/PETCT_556b56485a_08292003.nii.gz,/well/papiez/users/hri611/python/nnUnet_raw/Dataset219_PETCT/labelsTr/PETCT_556b56485a_08292003.nii.gz,0.961974418524039,0.0,0.024882041931152343
285,0.0,0,46,0.0,50879954,0,46,0,/well/papiez/users/hri611/python/nnUNet_results/Dataset219_PETCT/nnUNetTrainer_1500epochs__nnUNetPlans__3d_fullres/crossval_results_folds_0_1_2_3_4/PETCT_55819a54c2_04142007.nii.gz,/well/papiez/users/hri611/python/nnUnet_raw/Dataset219_PETCT/labelsTr/PETCT_55819a54c2_04142007.nii.gz,0.0,0.5722869644165038,0.0
286,0.0,58,0,0.0,52159942,0,0,58,/well/papiez/users/hri611/python/nnUNet_results/Dataset219_PETCT/nnUNetTrainer_1500epochs__nnUNetPlans__3d_fullres/crossval_results_folds_0_1_2_3_4/PETCT_55ae7986e1_05102003.nii.gz,/well/papiez/users/hri611/python/nnUnet_raw/Dataset219_PETCT/labelsTr/PETCT_55ae7986e1_05102003.nii.gz,0.0,0.0,0.721579216003418
287,0.8814133683629372,230,5999,0.7879705902375927,52130622,23149,29148,23379,/well/papiez/users/hri611/python/nnUNet_results/Dataset219_PETCT/nnUNetTrainer_1500epochs__nnUNetPlans__3d_fullres/crossval_results_folds_0_1_2_3_4/PETCT_55ca11402a_06052003.nii.gz,/well/papiez/users/hri611/python/nnUnet_raw/Dataset219_PETCT/labelsTr/PETCT_55ca11402a_06052003.nii.gz,0.8814133683629372,0.6220510482788086,0.2737024612426758
288,0.0,0,59,0.0,92959941,0,59,0,/well/papiez/users/hri611/python/nnUNet_results/Dataset219_PETCT/nnUNetTrainer_1500epochs__nnUNetPlans__3d_fullres/crossval_results_folds_0_1_2_3_4/PETCT_55d55902c6_05112006.nii.gz,/well/papiez/users/hri611/python/nnUnet_raw/Dataset219_PETCT/labelsTr/PETCT_55d55902c6_05112006.nii.gz,0.0,0.7340202369689941,0.0
289,,0,0,,51520000,0,0,0,/well/papiez/users/hri611/python/nnUNet_results/Dataset219_PETCT/nnUNetTrainer_1500epochs__nnUNetPlans__3d_fullres/crossval_results_folds_0_1_2_3_4/PETCT_55e3e62722_03032007.nii.gz,/well/papiez/users/hri611/python/nnUnet_raw/Dataset219_PETCT/labelsTr/PETCT_55e3e62722_03032007.nii.gz,,0.0,0.0
290,,0,0,,56000000,0,0,0,/well/papiez/users/hri611/python/nnUNet_results/Dataset219_PETCT/nnUNetTrainer_1500epochs__nnUNetPlans__3d_fullres/crossval_results_folds_0_1_2_3_4/PETCT_57c05962c1_09302005.nii.gz,/well/papiez/users/hri611/python/nnUnet_raw/Dataset219_PETCT/labelsTr/PETCT_57c05962c1_09302005.nii.gz,,0.0,0.0
291,0.15300306882946077,3654,210,0.08283883218609067,52155787,349,559,4003,/well/papiez/users/hri611/python/nnUNet_results/Dataset219_PETCT/nnUNetTrainer_1500epochs__nnUNetPlans__3d_fullres/crossval_results_folds_0_1_2_3_4/PETCT_581fa95eb0_03242003.nii.gz,/well/papiez/users/hri611/python/nnUnet_raw/Dataset219_PETCT/labelsTr/PETCT_581fa95eb0_03242003.nii.gz,0.15300306882946077,2.4882041931152346,0.0
292,0.0,0,72,0.0,52159928,0,72,0,/well/papiez/users/hri611/python/nnUNet_results/Dataset219_PETCT/nnUNetTrainer_1500epochs__nnUNetPlans__3d_fullres/crossval_results_folds_0_1_2_3_4/PETCT_591b3025ff_11132004.nii.gz,/well/papiez/users/hri611/python/nnUnet_raw/Dataset219_PETCT/labelsTr/PETCT_591b3025ff_11132004.nii.gz,0.0,0.8957535095214844,0.0
293,0.5328330206378987,0,249,0.3631713554987212,44319609,142,391,142,/well/papiez/users/hri611/python/nnUNet_results/Dataset219_PETCT/nnUNetTrainer_1500epochs__nnUNetPlans__3d_fullres/crossval_results_folds_0_1_2_3_4/PETCT_59309d6625_03032006.nii.gz,/well/papiez/users/hri611/python/nnUnet_raw/Dataset219_PETCT/labelsTr/PETCT_59309d6625_03032006.nii.gz,0.5328330206378987,2.687260528564453,0.0
294,0.0,0,40,0.0,48799960,0,40,0,/well/papiez/users/hri611/python/nnUNet_results/Dataset219_PETCT/nnUNetTrainer_1500epochs__nnUNetPlans__3d_fullres/crossval_results_folds_0_1_2_3_4/PETCT_5951afb86e_03172006.nii.gz,/well/papiez/users/hri611/python/nnUnet_raw/Dataset219_PETCT/labelsTr/PETCT_5951afb86e_03172006.nii.gz,0.0,0.49764083862304687,0.0
295,0.0,0,184,0.0,48159816,0,184,0,/well/papiez/users/hri611/python/nnUNet_results/Dataset219_PETCT/nnUNetTrainer_1500epochs__nnUNetPlans__3d_fullres/crossval_results_folds_0_1_2_3_4/PETCT_595975bc57_03102006.nii.gz,/well/papiez/users/hri611/python/nnUnet_raw/Dataset219_PETCT/labelsTr/PETCT_595975bc57_03102006.nii.gz,0.0,2.2891478576660154,0.0
296,0.8254706019056472,1237,265,0.7028096557182429,51194946,3552,3817,4789,/well/papiez/users/hri611/python/nnUNet_results/Dataset219_PETCT/nnUNetTrainer_1500epochs__nnUNetPlans__3d_fullres/crossval_results_folds_0_1_2_3_4/PETCT_59e6d1de22_08062005.nii.gz,/well/papiez/users/hri611/python/nnUnet_raw/Dataset219_PETCT/labelsTr/PETCT_59e6d1de22_08062005.nii.gz,0.8254706019056472,0.32346654510498046,0.3110255241394043
297,0.0,0,121,0.0,52159879,0,121,0,/well/papiez/users/hri611/python/nnUNet_results/Dataset219_PETCT/nnUNetTrainer_1500epochs__nnUNetPlans__3d_fullres/crossval_results_folds_0_1_2_3_4/PETCT_5a274a0f26_11082004.nii.gz,/well/papiez/users/hri611/python/nnUnet_raw/Dataset219_PETCT/labelsTr/PETCT_5a274a0f26_11082004.nii.gz,0.0,1.5053635368347167,0.0
298,0.8728989759633135,5907,634,0.7744638300806841,52130998,22461,23095,28368,/well/papiez/users/hri611/python/nnUNet_results/Dataset219_PETCT/nnUNetTrainer_1500epochs__nnUNetPlans__3d_fullres/crossval_results_folds_0_1_2_3_4/PETCT_5ac322455f_05262003.nii.gz,/well/papiez/users/hri611/python/nnUnet_raw/Dataset219_PETCT/labelsTr/PETCT_5ac322455f_05262003.nii.gz,0.8728989759633135,0.06220510482788086,1.306307201385498
299,0.0,0,413,0.0,52159587,0,413,0,/well/papiez/users/hri611/python/nnUNet_results/Dataset219_PETCT/nnUNetTrainer_1500epochs__nnUNetPlans__3d_fullres/crossval_results_folds_0_1_2_3_4/PETCT_5ac4fd9091_11142004.nii.gz,/well/papiez/users/hri611/python/nnUnet_raw/Dataset219_PETCT/labelsTr/PETCT_5ac4fd9091_11142004.nii.gz,0.0,5.138141658782959,0.0
300,,0,0,,47520000,0,0,0,/well/papiez/users/hri611/python/nnUNet_results/Dataset219_PETCT/nnUNetTrainer_1500epochs__nnUNetPlans__3d_fullres/crossval_results_folds_0_1_2_3_4/PETCT_5b0aa4e971_09102006.nii.gz,/well/papiez/users/hri611/python/nnUnet_raw/Dataset219_PETCT/labelsTr/PETCT_5b0aa4e971_09102006.nii.gz,,0.0,0.0
301,0.0,0,4,0.0,58879996,0,4,0,/well/papiez/users/hri611/python/nnUNet_results/Dataset219_PETCT/nnUNetTrainer_1500epochs__nnUNetPlans__3d_fullres/crossval_results_folds_0_1_2_3_4/PETCT_5b10c3f524_09122002.nii.gz,/well/papiez/users/hri611/python/nnUnet_raw/Dataset219_PETCT/labelsTr/PETCT_5b10c3f524_09122002.nii.gz,0.0,0.04976408386230469,0.0
302,0.0,0,221,0.0,50399779,0,221,0,/well/papiez/users/hri611/python/nnUNet_results/Dataset219_PETCT/nnUNetTrainer_1500epochs__nnUNetPlans__3d_fullres/crossval_results_folds_0_1_2_3_4/PETCT_5bd311a5e9_09122005.nii.gz,/well/papiez/users/hri611/python/nnUnet_raw/Dataset219_PETCT/labelsTr/PETCT_5bd311a5e9_09122005.nii.gz,0.0,2.749465633392334,0.0
303,0.0,611,45,0.0,52159344,0,45,611,/well/papiez/users/hri611/python/nnUNet_results/Dataset219_PETCT/nnUNetTrainer_1500epochs__nnUNetPlans__3d_fullres/crossval_results_folds_0_1_2_3_4/PETCT_5c1baad5d8_03062003.nii.gz,/well/papiez/users/hri611/python/nnUnet_raw/Dataset219_PETCT/labelsTr/PETCT_5c1baad5d8_03062003.nii.gz,0.0,0.5598459434509278,7.601463809967041
304,0.7151515151515152,158,218,0.5566037735849056,45439152,472,690,630,/well/papiez/users/hri611/python/nnUNet_results/Dataset219_PETCT/nnUNetTrainer_1500epochs__nnUNetPlans__3d_fullres/crossval_results_folds_0_1_2_3_4/PETCT_5c35fcbe89_08102002.nii.gz,/well/papiez/users/hri611/python/nnUnet_raw/Dataset219_PETCT/labelsTr/PETCT_5c35fcbe89_08102002.nii.gz,0.7151515151515152,2.388676025390625,0.0
305,0.8792797102439691,2558,4508,0.7845666026403244,45407201,25733,30241,28291,/well/papiez/users/hri611/python/nnUNet_results/Dataset219_PETCT/nnUNetTrainer_1500epochs__nnUNetPlans__3d_fullres/crossval_results_folds_0_1_2_3_4/PETCT_5c55b3087d_12112000.nii.gz,/well/papiez/users/hri611/python/nnUnet_raw/Dataset219_PETCT/labelsTr/PETCT_5c55b3087d_12112000.nii.gz,0.8792797102439691,26.38740546798706,12.490785049438477
306,,0,0,,45440000,0,0,0,/well/papiez/users/hri611/python/nnUNet_results/Dataset219_PETCT/nnUNetTrainer_1500epochs__nnUNetPlans__3d_fullres/crossval_results_folds_0_1_2_3_4/PETCT_5c57a98a43_02242005.nii.gz,/well/papiez/users/hri611/python/nnUnet_raw/Dataset219_PETCT/labelsTr/PETCT_5c57a98a43_02242005.nii.gz,,0.0,0.0
307,0.8463138667613781,7515,4601,0.733573753188495,52114524,33360,37961,40875,/well/papiez/users/hri611/python/nnUNet_results/Dataset219_PETCT/nnUNetTrainer_1500epochs__nnUNetPlans__3d_fullres/crossval_results_folds_0_1_2_3_4/PETCT_5cf118ac06_02282004.nii.gz,/well/papiez/users/hri611/python/nnUnet_raw/Dataset219_PETCT/labelsTr/PETCT_5cf118ac06_02282004.nii.gz,0.8463138667613781,14.767491886138917,5.78507474899292
308,0.8911767559177338,1408,7566,0.8037139919945756,47314281,36745,44311,38153,/well/papiez/users/hri611/python/nnUNet_results/Dataset219_PETCT/nnUNetTrainer_1500epochs__nnUNetPlans__3d_fullres/crossval_results_folds_0_1_2_3_4/PETCT_5d10be5b89_05302005.nii.gz,/well/papiez/users/hri611/python/nnUnet_raw/Dataset219_PETCT/labelsTr/PETCT_5d10be5b89_05302005.nii.gz,0.8911767559177338,3.495926891326904,1.0077226982116698
309,0.7039475016709538,13406,1211,0.5431473667760588,52128005,17378,18589,30784,/well/papiez/users/hri611/python/nnUNet_results/Dataset219_PETCT/nnUNetTrainer_1500epochs__nnUNetPlans__3d_fullres/crossval_results_folds_0_1_2_3_4/PETCT_5d553bf6b4_09162001.nii.gz,/well/papiez/users/hri611/python/nnUnet_raw/Dataset219_PETCT/labelsTr/PETCT_5d553bf6b4_09162001.nii.gz,0.7039475016709538,1.953240291595459,25.155744392395018
310,0.02976190476190476,2,650,0.015105740181268883,46719338,10,660,12,/well/papiez/users/hri611/python/nnUNet_results/Dataset219_PETCT/nnUNetTrainer_1500epochs__nnUNetPlans__3d_fullres/crossval_results_folds_0_1_2_3_4/PETCT_5d994c3f44_03052006.nii.gz,/well/papiez/users/hri611/python/nnUnet_raw/Dataset219_PETCT/labelsTr/PETCT_5d994c3f44_03052006.nii.gz,0.02976190476190476,8.036899543762207,0.0
311,0.9154716981132075,212,12,0.8441196938065414,47518563,1213,1225,1425,/well/papiez/users/hri611/python/nnUNet_results/Dataset219_PETCT/nnUNetTrainer_1500epochs__nnUNetPlans__3d_fullres/crossval_results_folds_0_1_2_3_4/PETCT_5de3ac617a_11132005.nii.gz,/well/papiez/users/hri611/python/nnUnet_raw/Dataset219_PETCT/labelsTr/PETCT_5de3ac617a_11132005.nii.gz,0.9154716981132075,0.0,0.0
312,0.6863357215967246,11799,459,0.5224589972340177,52134331,13411,13870,25210,/well/papiez/users/hri611/python/nnUNet_results/Dataset219_PETCT/nnUNetTrainer_1500epochs__nnUNetPlans__3d_fullres/crossval_results_folds_0_1_2_3_4/PETCT_5e2da717db_06282002.nii.gz,/well/papiez/users/hri611/python/nnUnet_raw/Dataset219_PETCT/labelsTr/PETCT_5e2da717db_06282002.nii.gz,0.6863357215967246,0.6842561531066894,51.65511904907226
313,,0,0,,45440000,0,0,0,/well/papiez/users/hri611/python/nnUNet_results/Dataset219_PETCT/nnUNetTrainer_1500epochs__nnUNetPlans__3d_fullres/crossval_results_folds_0_1_2_3_4/PETCT_5e339b2ecf_04032003.nii.gz,/well/papiez/users/hri611/python/nnUnet_raw/Dataset219_PETCT/labelsTr/PETCT_5e339b2ecf_04032003.nii.gz,,0.0,0.0
314,,0,0,,46400000,0,0,0,/well/papiez/users/hri611/python/nnUNet_results/Dataset219_PETCT/nnUNetTrainer_1500epochs__nnUNetPlans__3d_fullres/crossval_results_folds_0_1_2_3_4/PETCT_5e339b2ecf_05272006.nii.gz,/well/papiez/users/hri611/python/nnUnet_raw/Dataset219_PETCT/labelsTr/PETCT_5e339b2ecf_05272006.nii.gz,,0.0,0.0
315,,0,0,,43840000,0,0,0,/well/papiez/users/hri611/python/nnUNet_results/Dataset219_PETCT/nnUNetTrainer_1500epochs__nnUNetPlans__3d_fullres/crossval_results_folds_0_1_2_3_4/PETCT_5e339b2ecf_11112005.nii.gz,/well/papiez/users/hri611/python/nnUnet_raw/Dataset219_PETCT/labelsTr/PETCT_5e339b2ecf_11112005.nii.gz,,0.0,0.0
316,0.0,0,27,0.0,52159973,0,27,0,/well/papiez/users/hri611/python/nnUNet_results/Dataset219_PETCT/nnUNetTrainer_1500epochs__nnUNetPlans__3d_fullres/crossval_results_folds_0_1_2_3_4/PETCT_5e81863014_10182002.nii.gz,/well/papiez/users/hri611/python/nnUnet_raw/Dataset219_PETCT/labelsTr/PETCT_5e81863014_10182002.nii.gz,0.0,0.3359075660705566,0.0
317,0.6207436399217221,1805,133,0.4500567536889898,45436476,1586,1719,3391,/well/papiez/users/hri611/python/nnUNet_results/Dataset219_PETCT/nnUNetTrainer_1500epochs__nnUNetPlans__3d_fullres/crossval_results_folds_0_1_2_3_4/PETCT_5e8b013935_12162001.nii.gz,/well/papiez/users/hri611/python/nnUnet_raw/Dataset219_PETCT/labelsTr/PETCT_5e8b013935_12162001.nii.gz,0.6207436399217221,0.23637939834594726,9.753760437011719
318,0.923307098228867,640,6639,0.8575398767002642,45388905,43816,50455,44456,/well/papiez/users/hri611/python/nnUNet_results/Dataset219_PETCT/nnUNetTrainer_1500epochs__nnUNetPlans__3d_fullres/crossval_results_folds_0_1_2_3_4/PETCT_5ef99b0b6b_09072000.nii.gz,/well/papiez/users/hri611/python/nnUnet_raw/Dataset219_PETCT/labelsTr/PETCT_5ef99b0b6b_09072000.nii.gz,0.923307098228867,1.4680404739379882,0.024882041931152343
319,0.6692749087115284,318,2218,0.5029400235201882,52154898,2566,4784,2884,/well/papiez/users/hri611/python/nnUNet_results/Dataset219_PETCT/nnUNetTrainer_1500epochs__nnUNetPlans__3d_fullres/crossval_results_folds_0_1_2_3_4/PETCT_5f569fb737_09122002.nii.gz,/well/papiez/users/hri611/python/nnUnet_raw/Dataset219_PETCT/labelsTr/PETCT_5f569fb737_09122002.nii.gz,0.6692749087115284,25.34235970687866,0.0
320,0.0,0,674,0.0,45439326,0,674,0,/well/papiez/users/hri611/python/nnUNet_results/Dataset219_PETCT/nnUNetTrainer_1500epochs__nnUNetPlans__3d_fullres/crossval_results_folds_0_1_2_3_4/PETCT_5fa9d9a820_03242003.nii.gz,/well/papiez/users/hri611/python/nnUnet_raw/Dataset219_PETCT/labelsTr/PETCT_5fa9d9a820_03242003.nii.gz,0.0,8.38524813079834,0.0
321,,0,0,,45440000,0,0,0,/well/papiez/users/hri611/python/nnUNet_results/Dataset219_PETCT/nnUNetTrainer_1500epochs__nnUNetPlans__3d_fullres/crossval_results_folds_0_1_2_3_4/PETCT_5fa9d9a820_09132003.nii.gz,/well/papiez/users/hri611/python/nnUnet_raw/Dataset219_PETCT/labelsTr/PETCT_5fa9d9a820_09132003.nii.gz,,0.0,0.0
322,0.0,0,222,0.0,45439778,0,222,0,/well/papiez/users/hri611/python/nnUNet_results/Dataset219_PETCT/nnUNetTrainer_1500epochs__nnUNetPlans__3d_fullres/crossval_results_folds_0_1_2_3_4/PETCT_5fa9d9a820_09152002.nii.gz,/well/papiez/users/hri611/python/nnUnet_raw/Dataset219_PETCT/labelsTr/PETCT_5fa9d9a820_09152002.nii.gz,0.0,2.7619066543579103,0.0
323,0.0,0,142,0.0,52159858,0,142,0,/well/papiez/users/hri611/python/nnUNet_results/Dataset219_PETCT/nnUNetTrainer_1500epochs__nnUNetPlans__3d_fullres/crossval_results_folds_0_1_2_3_4/PETCT_5fa9d9a820_09272004.nii.gz,/well/papiez/users/hri611/python/nnUnet_raw/Dataset219_PETCT/labelsTr/PETCT_5fa9d9a820_09272004.nii.gz,0.0,1.7666249771118163,0.0
324,0.0,0,406,0.0,52159594,0,406,0,/well/papiez/users/hri611/python/nnUNet_results/Dataset219_PETCT/nnUNetTrainer_1500epochs__nnUNetPlans__3d_fullres/crossval_results_folds_0_1_2_3_4/PETCT_6016a6c3af_07012002.nii.gz,/well/papiez/users/hri611/python/nnUnet_raw/Dataset219_PETCT/labelsTr/PETCT_6016a6c3af_07012002.nii.gz,0.0,5.051054512023926,0.0
325,0.8343267860462235,8807,4562,0.7157467256336112,52112968,33663,38225,42470,/well/papiez/users/hri611/python/nnUNet_results/Dataset219_PETCT/nnUNetTrainer_1500epochs__nnUNetPlans__3d_fullres/crossval_results_folds_0_1_2_3_4/PETCT_605369e88d_09152002.nii.gz,/well/papiez/users/hri611/python/nnUnet_raw/Dataset219_PETCT/labelsTr/PETCT_605369e88d_09152002.nii.gz,0.8343267860462235,0.8086663627624512,0.0
326,0.0,0,221,0.0,50879779,0,221,0,/well/papiez/users/hri611/python/nnUNet_results/Dataset219_PETCT/nnUNetTrainer_1500epochs__nnUNetPlans__3d_fullres/crossval_results_folds_0_1_2_3_4/PETCT_607c1b38e3_04142007.nii.gz,/well/papiez/users/hri611/python/nnUnet_raw/Dataset219_PETCT/labelsTr/PETCT_607c1b38e3_04142007.nii.gz,0.0,2.749465633392334,0.0
327,0.0,0,32,0.0,48639968,0,32,0,/well/papiez/users/hri611/python/nnUNet_results/Dataset219_PETCT/nnUNetTrainer_1500epochs__nnUNetPlans__3d_fullres/crossval_results_folds_0_1_2_3_4/PETCT_607c1b38e3_10162006.nii.gz,/well/papiez/users/hri611/python/nnUnet_raw/Dataset219_PETCT/labelsTr/PETCT_607c1b38e3_10162006.nii.gz,0.0,0.3981126708984375,0.0
328,0.7737551259519625,1643,288,0.6309956048155934,45434767,3302,3590,4945,/well/papiez/users/hri611/python/nnUNet_results/Dataset219_PETCT/nnUNetTrainer_1500epochs__nnUNetPlans__3d_fullres/crossval_results_folds_0_1_2_3_4/PETCT_60baa6979c_08162003.nii.gz,/well/papiez/users/hri611/python/nnUnet_raw/Dataset219_PETCT/labelsTr/PETCT_60baa6979c_08162003.nii.gz,0.7737551259519625,0.48519981765747067,0.4727587966918945
329,0.8442006546934442,1480,281,0.7304041641151255,45433468,4771,5052,6251,/well/papiez/users/hri611/python/nnUNet_results/Dataset219_PETCT/nnUNetTrainer_1500epochs__nnUNetPlans__3d_fullres/crossval_results_folds_0_1_2_3_4/PETCT_61663450f8_08162003.nii.gz,/well/papiez/users/hri611/python/nnUnet_raw/Dataset219_PETCT/labelsTr/PETCT_61663450f8_08162003.nii.gz,0.8442006546934442,1.5675686416625976,0.0
330,0.9286439929328622,3081,3381,0.8667930984725114,45391489,42049,45430,45130,/well/papiez/users/hri611/python/nnUNet_results/Dataset219_PETCT/nnUNetTrainer_1500epochs__nnUNetPlans__3d_fullres/crossval_results_folds_0_1_2_3_4/PETCT_6170317f2e_02182000.nii.gz,/well/papiez/users/hri611/python/nnUnet_raw/Dataset219_PETCT/labelsTr/PETCT_6170317f2e_02182000.nii.gz,0.9286439929328622,0.012441020965576172,6.120982315063476
331,0.0,0,202,0.0,58079798,0,202,0,/well/papiez/users/hri611/python/nnUNet_results/Dataset219_PETCT/nnUNetTrainer_1500epochs__nnUNetPlans__3d_fullres/crossval_results_folds_0_1_2_3_4/PETCT_61d5bc58fc_06152007.nii.gz,/well/papiez/users/hri611/python/nnUnet_raw/Dataset219_PETCT/labelsTr/PETCT_61d5bc58fc_06152007.nii.gz,0.0,2.5130862350463867,0.0
332,0.0,0,82,0.0,59839918,0,82,0,/well/papiez/users/hri611/python/nnUNet_results/Dataset219_PETCT/nnUNetTrainer_1500epochs__nnUNetPlans__3d_fullres/crossval_results_folds_0_1_2_3_4/PETCT_61d5bc58fc_06182005.nii.gz,/well/papiez/users/hri611/python/nnUnet_raw/Dataset219_PETCT/labelsTr/PETCT_61d5bc58fc_06182005.nii.gz,0.0,1.0201637191772461,0.0
333,0.0,0,80,0.0,59199920,0,80,0,/well/papiez/users/hri611/python/nnUNet_results/Dataset219_PETCT/nnUNetTrainer_1500epochs__nnUNetPlans__3d_fullres/crossval_results_folds_0_1_2_3_4/PETCT_61d5bc58fc_06232006.nii.gz,/well/papiez/users/hri611/python/nnUnet_raw/Dataset219_PETCT/labelsTr/PETCT_61d5bc58fc_06232006.nii.gz,0.0,0.9952816772460937,0.0
334,0.0,0,512,0.0,55999488,0,512,0,/well/papiez/users/hri611/python/nnUNet_results/Dataset219_PETCT/nnUNetTrainer_1500epochs__nnUNetPlans__3d_fullres/crossval_results_folds_0_1_2_3_4/PETCT_61d5bc58fc_12152005.nii.gz,/well/papiez/users/hri611/python/nnUnet_raw/Dataset219_PETCT/labelsTr/PETCT_61d5bc58fc_12152005.nii.gz,0.0,6.369802734375,0.0
335,0.9169514219913234,6475,1278,0.8466392372512561,52109446,42801,44079,49276,/well/papiez/users/hri611/python/nnUNet_results/Dataset219_PETCT/nnUNetTrainer_1500epochs__nnUNetPlans__3d_fullres/crossval_results_folds_0_1_2_3_4/PETCT_62011ff15b_05052005.nii.gz,/well/papiez/users/hri611/python/nnUnet_raw/Dataset219_PETCT/labelsTr/PETCT_62011ff15b_05052005.nii.gz,0.9169514219913234,0.04976408386230469,17.218373016357422
336,0.9682681040543708,223,454,0.9384880974014174,52148994,10329,10783,10552,/well/papiez/users/hri611/python/nnUNet_results/Dataset219_PETCT/nnUNetTrainer_1500epochs__nnUNetPlans__3d_fullres/crossval_results_folds_0_1_2_3_4/PETCT_62405d117c_03112001.nii.gz,/well/papiez/users/hri611/python/nnUnet_raw/Dataset219_PETCT/labelsTr/PETCT_62405d117c_03112001.nii.gz,0.9682681040543708,0.14929225158691406,0.012441020965576172
337,0.8999646518204313,214,69,0.8181233933161953,52158444,1273,1342,1487,/well/papiez/users/hri611/python/nnUNet_results/Dataset219_PETCT/nnUNetTrainer_1500epochs__nnUNetPlans__3d_fullres/crossval_results_folds_0_1_2_3_4/PETCT_62b114e09b_03272003.nii.gz,/well/papiez/users/hri611/python/nnUnet_raw/Dataset219_PETCT/labelsTr/PETCT_62b114e09b_03272003.nii.gz,0.8999646518204313,0.18661531448364257,0.0
338,0.0,0,3,0.0,52159997,0,3,0,/well/papiez/users/hri611/python/nnUNet_results/Dataset219_PETCT/nnUNetTrainer_1500epochs__nnUNetPlans__3d_fullres/crossval_results_folds_0_1_2_3_4/PETCT_62b114e09b_06092003.nii.gz,/well/papiez/users/hri611/python/nnUnet_raw/Dataset219_PETCT/labelsTr/PETCT_62b114e09b_06092003.nii.gz,0.0,0.037323062896728515,0.0
339,0.9176232275489534,375,2309,0.8477854023705552,52142367,14949,17258,15324,/well/papiez/users/hri611/python/nnUNet_results/Dataset219_PETCT/nnUNetTrainer_1500epochs__nnUNetPlans__3d_fullres/crossval_results_folds_0_1_2_3_4/PETCT_62ced197ca_04142003.nii.gz,/well/papiez/users/hri611/python/nnUnet_raw/Dataset219_PETCT/labelsTr/PETCT_62ced197ca_04142003.nii.gz,0.9176232275489534,0.0,0.0
340,,0,0,,101600000,0,0,0,/well/papiez/users/hri611/python/nnUNet_results/Dataset219_PETCT/nnUNetTrainer_1500epochs__nnUNetPlans__3d_fullres/crossval_results_folds_0_1_2_3_4/PETCT_631b419cef_11232006.nii.gz,/well/papiez/users/hri611/python/nnUnet_raw/Dataset219_PETCT/labelsTr/PETCT_631b419cef_11232006.nii.gz,,0.0,0.0
341,,0,0,,52160000,0,0,0,/well/papiez/users/hri611/python/nnUNet_results/Dataset219_PETCT/nnUNetTrainer_1500epochs__nnUNetPlans__3d_fullres/crossval_results_folds_0_1_2_3_4/PETCT_63464433c8_01042003.nii.gz,/well/papiez/users/hri611/python/nnUnet_raw/Dataset219_PETCT/labelsTr/PETCT_63464433c8_01042003.nii.gz,,0.0,0.0
342,0.9239210307157204,665,888,0.8585996540107439,45429017,9430,10318,10095,/well/papiez/users/hri611/python/nnUNet_results/Dataset219_PETCT/nnUNetTrainer_1500epochs__nnUNetPlans__3d_fullres/crossval_results_folds_0_1_2_3_4/PETCT_63508c679d_02172005.nii.gz,/well/papiez/users/hri611/python/nnUnet_raw/Dataset219_PETCT/labelsTr/PETCT_63508c679d_02172005.nii.gz,0.9239210307157204,4.67782388305664,0.0
343,0.0,0,149,0.0,45759851,0,149,0,/well/papiez/users/hri611/python/nnUNet_results/Dataset219_PETCT/nnUNetTrainer_1500epochs__nnUNetPlans__3d_fullres/crossval_results_folds_0_1_2_3_4/PETCT_63508c679d_08212005.nii.gz,/well/papiez/users/hri611/python/nnUnet_raw/Dataset219_PETCT/labelsTr/PETCT_63508c679d_08212005.nii.gz,0.0,1.8537121238708496,0.0
344,0.865142478462558,4003,881,0.7623357664233577,52139450,15666,16547,19669,/well/papiez/users/hri611/python/nnUNet_results/Dataset219_PETCT/nnUNetTrainer_1500epochs__nnUNetPlans__3d_fullres/crossval_results_folds_0_1_2_3_4/PETCT_63dd9503eb_01182001.nii.gz,/well/papiez/users/hri611/python/nnUnet_raw/Dataset219_PETCT/labelsTr/PETCT_63dd9503eb_01182001.nii.gz,0.865142478462558,3.682542205810547,0.0
345,0.8769318832283916,54,1021,0.780835881753313,52155095,3830,4851,3884,/well/papiez/users/hri611/python/nnUNet_results/Dataset219_PETCT/nnUNetTrainer_1500epochs__nnUNetPlans__3d_fullres/crossval_results_folds_0_1_2_3_4/PETCT_644d80e987_02152003.nii.gz,/well/papiez/users/hri611/python/nnUnet_raw/Dataset219_PETCT/labelsTr/PETCT_644d80e987_02152003.nii.gz,0.8769318832283916,3.620337100982666,0.0
346,0.8972609927589463,549,430,0.8136657784545108,52154746,4275,4705,4824,/well/papiez/users/hri611/python/nnUNet_results/Dataset219_PETCT/nnUNetTrainer_1500epochs__nnUNetPlans__3d_fullres/crossval_results_folds_0_1_2_3_4/PETCT_64909533c5_04142003.nii.gz,/well/papiez/users/hri611/python/nnUnet_raw/Dataset219_PETCT/labelsTr/PETCT_64909533c5_04142003.nii.gz,0.8972609927589463,1.8412711029052735,0.0
347,,0,0,,49920000,0,0,0,/well/papiez/users/hri611/python/nnUNet_results/Dataset219_PETCT/nnUNetTrainer_1500epochs__nnUNetPlans__3d_fullres/crossval_results_folds_0_1_2_3_4/PETCT_64aff75516_01202006.nii.gz,/well/papiez/users/hri611/python/nnUnet_raw/Dataset219_PETCT/labelsTr/PETCT_64aff75516_01202006.nii.gz,,0.0,0.0
348,0.0,0,411,0.0,47839589,0,411,0,/well/papiez/users/hri611/python/nnUNet_results/Dataset219_PETCT/nnUNetTrainer_1500epochs__nnUNetPlans__3d_fullres/crossval_results_folds_0_1_2_3_4/PETCT_64aff75516_10162005.nii.gz,/well/papiez/users/hri611/python/nnUnet_raw/Dataset219_PETCT/labelsTr/PETCT_64aff75516_10162005.nii.gz,0.0,5.113259616851806,0.0
349,0.0,0,1366,0.0,41918634,0,1366,0,/well/papiez/users/hri611/python/nnUNet_results/Dataset219_PETCT/nnUNetTrainer_1500epochs__nnUNetPlans__3d_fullres/crossval_results_folds_0_1_2_3_4/PETCT_64c0cba177_08072006.nii.gz,/well/papiez/users/hri611/python/nnUnet_raw/Dataset219_PETCT/labelsTr/PETCT_64c0cba177_08072006.nii.gz,0.0,16.99443463897705,0.0
350,0.6601123595505618,206,36,0.49266247379454925,92319523,235,271,441,/well/papiez/users/hri611/python/nnUNet_results/Dataset219_PETCT/nnUNetTrainer_1500epochs__nnUNetPlans__3d_fullres/crossval_results_folds_0_1_2_3_4/PETCT_65346b03b8_03142004.nii.gz,/well/papiez/users/hri611/python/nnUnet_raw/Dataset219_PETCT/labelsTr/PETCT_65346b03b8_03142004.nii.gz,0.6601123595505618,0.21149735641479492,0.0
351,0.4735632183908046,584,103,0.3102409638554217,52159004,309,412,893,/well/papiez/users/hri611/python/nnUNet_results/Dataset219_PETCT/nnUNetTrainer_1500epochs__nnUNetPlans__3d_fullres/crossval_results_folds_0_1_2_3_4/PETCT_6543c58e13_02252001.nii.gz,/well/papiez/users/hri611/python/nnUnet_raw/Dataset219_PETCT/labelsTr/PETCT_6543c58e13_02252001.nii.gz,0.4735632183908046,1.16945597076416,2.2891478576660154
352,0.7032871972318339,3652,464,0.542361574382922,45431006,4878,5342,8530,/well/papiez/users/hri611/python/nnUNet_results/Dataset219_PETCT/nnUNetTrainer_1500epochs__nnUNetPlans__3d_fullres/crossval_results_folds_0_1_2_3_4/PETCT_65a1330e90_06162001.nii.gz,/well/papiez/users/hri611/python/nnUnet_raw/Dataset219_PETCT/labelsTr/PETCT_65a1330e90_06162001.nii.gz,0.7032871972318339,0.0,33.030910663604736
353,0.8226516297620685,4886,272,0.6987325506687694,49102879,11963,12235,16849,/well/papiez/users/hri611/python/nnUNet_results/Dataset219_PETCT/nnUNetTrainer_1500epochs__nnUNetPlans__3d_fullres/crossval_results_folds_0_1_2_3_4/PETCT_65bd1a4c38_09302005.nii.gz,/well/papiez/users/hri611/python/nnUnet_raw/Dataset219_PETCT/labelsTr/PETCT_65bd1a4c38_09302005.nii.gz,0.8226516297620685,1.16945597076416,7.763197082519531
354,0.0,0,4,0.0,52159996,0,4,0,/well/papiez/users/hri611/python/nnUNet_results/Dataset219_PETCT/nnUNetTrainer_1500epochs__nnUNetPlans__3d_fullres/crossval_results_folds_0_1_2_3_4/PETCT_6604b228c6_10232004.nii.gz,/well/papiez/users/hri611/python/nnUnet_raw/Dataset219_PETCT/labelsTr/PETCT_6604b228c6_10232004.nii.gz,0.0,0.04976408386230469,0.0
355,0.0,0,4252,0.0,52155748,0,4252,0,/well/papiez/users/hri611/python/nnUNet_results/Dataset219_PETCT/nnUNetTrainer_1500epochs__nnUNetPlans__3d_fullres/crossval_results_folds_0_1_2_3_4/PETCT_674c49778c_12222002.nii.gz,/well/papiez/users/hri611/python/nnUnet_raw/Dataset219_PETCT/labelsTr/PETCT_674c49778c_12222002.nii.gz,0.0,52.89922114562988,0.0
356,0.7122556158700737,6231,19849,0.5531032591932554,52101642,32278,52127,38509,/well/papiez/users/hri611/python/nnUNet_results/Dataset219_PETCT/nnUNetTrainer_1500epochs__nnUNetPlans__3d_fullres/crossval_results_folds_0_1_2_3_4/PETCT_685d7c09b5_12232000.nii.gz,/well/papiez/users/hri611/python/nnUnet_raw/Dataset219_PETCT/labelsTr/PETCT_685d7c09b5_12232000.nii.gz,0.7122556158700737,3.682542205810547,1.9407992706298827
357,0.7341709167806941,1754,383,0.5799921383647799,52154912,2951,3334,4705,/well/papiez/users/hri611/python/nnUNet_results/Dataset219_PETCT/nnUNetTrainer_1500epochs__nnUNetPlans__3d_fullres/crossval_results_folds_0_1_2_3_4/PETCT_68b75093c5_11122000.nii.gz,/well/papiez/users/hri611/python/nnUnet_raw/Dataset219_PETCT/labelsTr/PETCT_68b75093c5_11122000.nii.gz,0.7341709167806941,0.024882041931152343,9.853288604736328
358,0.943285874638152,1899,21,0.8926594733605412,45422113,15967,15988,17866,/well/papiez/users/hri611/python/nnUNet_results/Dataset219_PETCT/nnUNetTrainer_1500epochs__nnUNetPlans__3d_fullres/crossval_results_folds_0_1_2_3_4/PETCT_68f73c4518_11132004.nii.gz,/well/papiez/users/hri611/python/nnUnet_raw/Dataset219_PETCT/labelsTr/PETCT_68f73c4518_11132004.nii.gz,0.943285874638152,0.0,0.0
359,,0,0,,50560000,0,0,0,/well/papiez/users/hri611/python/nnUNet_results/Dataset219_PETCT/nnUNetTrainer_1500epochs__nnUNetPlans__3d_fullres/crossval_results_folds_0_1_2_3_4/PETCT_69606f6a25_08132006.nii.gz,/well/papiez/users/hri611/python/nnUnet_raw/Dataset219_PETCT/labelsTr/PETCT_69606f6a25_08132006.nii.gz,,0.0,0.0
360,0.0,0,3,0.0,38719997,0,3,0,/well/papiez/users/hri611/python/nnUNet_results/Dataset219_PETCT/nnUNetTrainer_1500epochs__nnUNetPlans__3d_fullres/crossval_results_folds_0_1_2_3_4/PETCT_69aa8dbfd2_05242003.nii.gz,/well/papiez/users/hri611/python/nnUnet_raw/Dataset219_PETCT/labelsTr/PETCT_69aa8dbfd2_05242003.nii.gz,0.0,0.037323062896728515,0.0
361,,0,0,,44320000,0,0,0,/well/papiez/users/hri611/python/nnUNet_results/Dataset219_PETCT/nnUNetTrainer_1500epochs__nnUNetPlans__3d_fullres/crossval_results_folds_0_1_2_3_4/PETCT_69c90b6820_11212005.nii.gz,/well/papiez/users/hri611/python/nnUnet_raw/Dataset219_PETCT/labelsTr/PETCT_69c90b6820_11212005.nii.gz,,0.0,0.0
362,0.0,0,1392,0.0,52158608,0,1392,0,/well/papiez/users/hri611/python/nnUNet_results/Dataset219_PETCT/nnUNetTrainer_1500epochs__nnUNetPlans__3d_fullres/crossval_results_folds_0_1_2_3_4/PETCT_69ee62b035_12262002.nii.gz,/well/papiez/users/hri611/python/nnUnet_raw/Dataset219_PETCT/labelsTr/PETCT_69ee62b035_12262002.nii.gz,0.0,17.317901184082032,0.0
363,0.8900242771111466,16219,10644,0.801841210359759,45304437,108700,119344,124919,/well/papiez/users/hri611/python/nnUNet_results/Dataset219_PETCT/nnUNetTrainer_1500epochs__nnUNetPlans__3d_fullres/crossval_results_folds_0_1_2_3_4/PETCT_6a3477cd9a_01152005.nii.gz,/well/papiez/users/hri611/python/nnUnet_raw/Dataset219_PETCT/labelsTr/PETCT_6a3477cd9a_01152005.nii.gz,0.8900242771111466,11.358652141571044,24.844718868255615
364,0.4464065708418891,2674,22,0.2873380914618028,45436217,1087,1109,3761,/well/papiez/users/hri611/python/nnUNet_results/Dataset219_PETCT/nnUNetTrainer_1500epochs__nnUNetPlans__3d_fullres/crossval_results_folds_0_1_2_3_4/PETCT_6aea5c3a03_12272001.nii.gz,/well/papiez/users/hri611/python/nnUnet_raw/Dataset219_PETCT/labelsTr/PETCT_6aea5c3a03_12272001.nii.gz,0.4464065708418891,0.0,28.62678924179077
365,,0,0,,51840000,0,0,0,/well/papiez/users/hri611/python/nnUNet_results/Dataset219_PETCT/nnUNetTrainer_1500epochs__nnUNetPlans__3d_fullres/crossval_results_folds_0_1_2_3_4/PETCT_6b177a3c28_06302005.nii.gz,/well/papiez/users/hri611/python/nnUnet_raw/Dataset219_PETCT/labelsTr/PETCT_6b177a3c28_06302005.nii.gz,,0.0,0.0
366,,0,0,,38720000,0,0,0,/well/papiez/users/hri611/python/nnUNet_results/Dataset219_PETCT/nnUNetTrainer_1500epochs__nnUNetPlans__3d_fullres/crossval_results_folds_0_1_2_3_4/PETCT_6b20c7eabb_07312003.nii.gz,/well/papiez/users/hri611/python/nnUnet_raw/Dataset219_PETCT/labelsTr/PETCT_6b20c7eabb_07312003.nii.gz,,0.0,0.0
367,0.8806863360535677,1481,1370,0.7868092425035519,51666627,10522,11892,12003,/well/papiez/users/hri611/python/nnUNet_results/Dataset219_PETCT/nnUNetTrainer_1500epochs__nnUNetPlans__3d_fullres/crossval_results_folds_0_1_2_3_4/PETCT_6c23f2686d_04212007.nii.gz,/well/papiez/users/hri611/python/nnUnet_raw/Dataset219_PETCT/labelsTr/PETCT_6c23f2686d_04212007.nii.gz,0.8806863360535677,5.859720874786377,0.0
368,0.8539210239315184,3365,3734,0.7450804366561333,45412152,20749,24483,24114,/well/papiez/users/hri611/python/nnUNet_results/Dataset219_PETCT/nnUNetTrainer_1500epochs__nnUNetPlans__3d_fullres/crossval_results_folds_0_1_2_3_4/PETCT_6c469107a0_06232002.nii.gz,/well/papiez/users/hri611/python/nnUnet_raw/Dataset219_PETCT/labelsTr/PETCT_6c469107a0_06232002.nii.gz,0.8539210239315184,2.724583591461182,2.774347675323486
369,0.7437641723356009,594,197,0.592057761732852,95838061,1148,1345,1742,/well/papiez/users/hri611/python/nnUNet_results/Dataset219_PETCT/nnUNetTrainer_1500epochs__nnUNetPlans__3d_fullres/crossval_results_folds_0_1_2_3_4/PETCT_6c660140ca_08062006.nii.gz,/well/papiez/users/hri611/python/nnUnet_raw/Dataset219_PETCT/labelsTr/PETCT_6c660140ca_08062006.nii.gz,0.7437641723356009,1.6173327255249024,0.0
370,0.9592088998763906,14,19,0.9216152019002375,54079579,388,407,402,/well/papiez/users/hri611/python/nnUNet_results/Dataset219_PETCT/nnUNetTrainer_1500epochs__nnUNetPlans__3d_fullres/crossval_results_folds_0_1_2_3_4/PETCT_6d62e15c29_02232007.nii.gz,/well/papiez/users/hri611/python/nnUnet_raw/Dataset219_PETCT/labelsTr/PETCT_6d62e15c29_02232007.nii.gz,0.9592088998763906,0.012441020965576172,0.0
371,0.0,0,23,0.0,54879977,0,23,0,/well/papiez/users/hri611/python/nnUNet_results/Dataset219_PETCT/nnUNetTrainer_1500epochs__nnUNetPlans__3d_fullres/crossval_results_folds_0_1_2_3_4/PETCT_6d62e15c29_08242006.nii.gz,/well/papiez/users/hri611/python/nnUnet_raw/Dataset219_PETCT/labelsTr/PETCT_6d62e15c29_08242006.nii.gz,0.0,0.2861434822082519,0.0
372,0.8719101123595505,1042,1352,0.7729083665338645,52149458,8148,9500,9190,/well/papiez/users/hri611/python/nnUNet_results/Dataset219_PETCT/nnUNetTrainer_1500epochs__nnUNetPlans__3d_fullres/crossval_results_folds_0_1_2_3_4/PETCT_6d6a193655_11172002.nii.gz,/well/papiez/users/hri611/python/nnUnet_raw/Dataset219_PETCT/labelsTr/PETCT_6d6a193655_11172002.nii.gz,0.8719101123595505,0.024882041931152343,0.0
373,,0,0,,45440000,0,0,0,/well/papiez/users/hri611/python/nnUNet_results/Dataset219_PETCT/nnUNetTrainer_1500epochs__nnUNetPlans__3d_fullres/crossval_results_folds_0_1_2_3_4/PETCT_6dd36a2c19_11282003.nii.gz,/well/papiez/users/hri611/python/nnUnet_raw/Dataset219_PETCT/labelsTr/PETCT_6dd36a2c19_11282003.nii.gz,,0.0,0.0
374,0.0,0,1666,0.0,52158334,0,1666,0,/well/papiez/users/hri611/python/nnUNet_results/Dataset219_PETCT/nnUNetTrainer_1500epochs__nnUNetPlans__3d_fullres/crossval_results_folds_0_1_2_3_4/PETCT_6e1dba94e8_11152002.nii.gz,/well/papiez/users/hri611/python/nnUnet_raw/Dataset219_PETCT/labelsTr/PETCT_6e1dba94e8_11152002.nii.gz,0.0,20.726740928649903,0.0
375,0.904424487105545,3305,1335,0.8255245544107693,52133406,21954,23289,25259,/well/papiez/users/hri611/python/nnUNet_results/Dataset219_PETCT/nnUNetTrainer_1500epochs__nnUNetPlans__3d_fullres/crossval_results_folds_0_1_2_3_4/PETCT_6e7c7f8087_03232003.nii.gz,/well/papiez/users/hri611/python/nnUnet_raw/Dataset219_PETCT/labelsTr/PETCT_6e7c7f8087_03232003.nii.gz,0.904424487105545,0.0870871467590332,0.06220510482788086
376,0.66110183639399,116,290,0.4937655860349127,52159198,396,686,512,/well/papiez/users/hri611/python/nnUNet_results/Dataset219_PETCT/nnUNetTrainer_1500epochs__nnUNetPlans__3d_fullres/crossval_results_folds_0_1_2_3_4/PETCT_6efefcb92a_03262005.nii.gz,/well/papiez/users/hri611/python/nnUnet_raw/Dataset219_PETCT/labelsTr/PETCT_6efefcb92a_03262005.nii.gz,0.66110183639399,3.2719885139465332,0.8957535095214844
377,0.0,0,3144,0.0,94236856,0,3144,0,/well/papiez/users/hri611/python/nnUNet_results/Dataset219_PETCT/nnUNetTrainer_1500epochs__nnUNetPlans__3d_fullres/crossval_results_folds_0_1_2_3_4/PETCT_6f46454a8d_09032005.nii.gz,/well/papiez/users/hri611/python/nnUnet_raw/Dataset219_PETCT/labelsTr/PETCT_6f46454a8d_09032005.nii.gz,0.0,39.11456991577148,0.0
378,0.0,0,490,0.0,99039510,0,490,0,/well/papiez/users/hri611/python/nnUNet_results/Dataset219_PETCT/nnUNetTrainer_1500epochs__nnUNetPlans__3d_fullres/crossval_results_folds_0_1_2_3_4/PETCT_6f46454a8d_09072003.nii.gz,/well/papiez/users/hri611/python/nnUnet_raw/Dataset219_PETCT/labelsTr/PETCT_6f46454a8d_09072003.nii.gz,0.0,6.096100273132324,0.0
379,0.0,0,292,0.0,99039708,0,292,0,/well/papiez/users/hri611/python/nnUNet_results/Dataset219_PETCT/nnUNetTrainer_1500epochs__nnUNetPlans__3d_fullres/crossval_results_folds_0_1_2_3_4/PETCT_6f46454a8d_09122002.nii.gz,/well/papiez/users/hri611/python/nnUnet_raw/Dataset219_PETCT/labelsTr/PETCT_6f46454a8d_09122002.nii.gz,0.0,3.6327781219482422,0.0
380,0.8413900213550767,3240,845,0.7262064343163539,52145080,10835,11680,14075,/well/papiez/users/hri611/python/nnUNet_results/Dataset219_PETCT/nnUNetTrainer_1500epochs__nnUNetPlans__3d_fullres/crossval_results_folds_0_1_2_3_4/PETCT_6fe855c937_12292001.nii.gz,/well/papiez/users/hri611/python/nnUnet_raw/Dataset219_PETCT/labelsTr/PETCT_6fe855c937_12292001.nii.gz,0.8413900213550767,0.6220510482788086,0.0
381,0.5524861878453039,862,29,0.3816793893129771,52158559,550,579,1412,/well/papiez/users/hri611/python/nnUNet_results/Dataset219_PETCT/nnUNetTrainer_1500epochs__nnUNetPlans__3d_fullres/crossval_results_folds_0_1_2_3_4/PETCT_7094acd4c0_08232001.nii.gz,/well/papiez/users/hri611/python/nnUnet_raw/Dataset219_PETCT/labelsTr/PETCT_7094acd4c0_08232001.nii.gz,0.5524861878453039,0.06220510482788086,9.281001640319824
382,0.8812923247170333,2458,7411,0.7877771326581081,45393497,36634,44045,39092,/well/papiez/users/hri611/python/nnUNet_results/Dataset219_PETCT/nnUNetTrainer_1500epochs__nnUNetPlans__3d_fullres/crossval_results_folds_0_1_2_3_4/PETCT_7147385005_05092002.nii.gz,/well/papiez/users/hri611/python/nnUnet_raw/Dataset219_PETCT/labelsTr/PETCT_7147385005_05092002.nii.gz,0.8812923247170333,40.694579578399654,0.0
383,0.0,0,314,0.0,87999686,0,314,0,/well/papiez/users/hri611/python/nnUNet_results/Dataset219_PETCT/nnUNetTrainer_1500epochs__nnUNetPlans__3d_fullres/crossval_results_folds_0_1_2_3_4/PETCT_71ac560ffe_03192007.nii.gz,/well/papiez/users/hri611/python/nnUnet_raw/Dataset219_PETCT/labelsTr/PETCT_71ac560ffe_03192007.nii.gz,0.0,3.906480583190918,0.0
384,,0,0,,45440000,0,0,0,/well/papiez/users/hri611/python/nnUNet_results/Dataset219_PETCT/nnUNetTrainer_1500epochs__nnUNetPlans__3d_fullres/crossval_results_folds_0_1_2_3_4/PETCT_71ae114917_04132003.nii.gz,/well/papiez/users/hri611/python/nnUnet_raw/Dataset219_PETCT/labelsTr/PETCT_71ae114917_04132003.nii.gz,,0.0,0.0
385,,0,0,,50880000,0,0,0,/well/papiez/users/hri611/python/nnUNet_results/Dataset219_PETCT/nnUNetTrainer_1500epochs__nnUNetPlans__3d_fullres/crossval_results_folds_0_1_2_3_4/PETCT_72725f2bda_07062007.nii.gz,/well/papiez/users/hri611/python/nnUnet_raw/Dataset219_PETCT/labelsTr/PETCT_72725f2bda_07062007.nii.gz,,0.0,0.0
386,0.0,0,398,0.0,38239602,0,398,0,/well/papiez/users/hri611/python/nnUNet_results/Dataset219_PETCT/nnUNetTrainer_1500epochs__nnUNetPlans__3d_fullres/crossval_results_folds_0_1_2_3_4/PETCT_72d2d6de52_08052005.nii.gz,/well/papiez/users/hri611/python/nnUnet_raw/Dataset219_PETCT/labelsTr/PETCT_72d2d6de52_08052005.nii.gz,0.0,4.9515263442993165,0.0
387,0.8659685863874346,1383,409,0.7636195752539243,45432419,5789,6198,7172,/well/papiez/users/hri611/python/nnUNet_results/Dataset219_PETCT/nnUNetTrainer_1500epochs__nnUNetPlans__3d_fullres/crossval_results_folds_0_1_2_3_4/PETCT_72ee9ec897_11122001.nii.gz,/well/papiez/users/hri611/python/nnUnet_raw/Dataset219_PETCT/labelsTr/PETCT_72ee9ec897_11122001.nii.gz,0.8659685863874346,0.0,0.0
388,0.6889304893212904,11888,10877,0.5254721307374828,45072026,25209,36086,37097,/well/papiez/users/hri611/python/nnUNet_results/Dataset219_PETCT/nnUNetTrainer_1500epochs__nnUNetPlans__3d_fullres/crossval_results_folds_0_1_2_3_4/PETCT_7323c415d0_02262006.nii.gz,/well/papiez/users/hri611/python/nnUnet_raw/Dataset219_PETCT/labelsTr/PETCT_7323c415d0_02262006.nii.gz,0.6889304893212904,36.128724884033204,57.25357848358154
389,0.778638895616372,871,4613,0.6375173507832639,84304871,9645,14258,10516,/well/papiez/users/hri611/python/nnUNet_results/Dataset219_PETCT/nnUNetTrainer_1500epochs__nnUNetPlans__3d_fullres/crossval_results_folds_0_1_2_3_4/PETCT_73597f33fe_02102007.nii.gz,/well/papiez/users/hri611/python/nnUnet_raw/Dataset219_PETCT/labelsTr/PETCT_73597f33fe_02102007.nii.gz,0.778638895616372,29.01246089172363,0.0870871467590332
390,0.8248009362307533,5927,1708,0.7018393408052486,84454393,17972,19680,23899,/well/papiez/users/hri611/python/nnUNet_results/Dataset219_PETCT/nnUNetTrainer_1500epochs__nnUNetPlans__3d_fullres/crossval_results_folds_0_1_2_3_4/PETCT_73597f33fe_05172007.nii.gz,/well/papiez/users/hri611/python/nnUnet_raw/Dataset219_PETCT/labelsTr/PETCT_73597f33fe_05172007.nii.gz,0.8248009362307533,4.453885505676269,1.0450457611083985
391,0.0,0,35,0.0,51839965,0,35,0,/well/papiez/users/hri611/python/nnUNet_results/Dataset219_PETCT/nnUNetTrainer_1500epochs__nnUNetPlans__3d_fullres/crossval_results_folds_0_1_2_3_4/PETCT_7365362464_03222007.nii.gz,/well/papiez/users/hri611/python/nnUnet_raw/Dataset219_PETCT/labelsTr/PETCT_7365362464_03222007.nii.gz,0.0,0.435435733795166,0.0
392,0.9443186359397895,428,2080,0.8945110410094638,48136225,21267,23347,21695,/well/papiez/users/hri611/python/nnUNet_results/Dataset219_PETCT/nnUNetTrainer_1500epochs__nnUNetPlans__3d_fullres/crossval_results_folds_0_1_2_3_4/PETCT_73fda3a382_08122005.nii.gz,/well/papiez/users/hri611/python/nnUnet_raw/Dataset219_PETCT/labelsTr/PETCT_73fda3a382_08122005.nii.gz,0.9443186359397895,1.9034762077331542,0.037323062896728515
393,,0,0,,38720000,0,0,0,/well/papiez/users/hri611/python/nnUNet_results/Dataset219_PETCT/nnUNetTrainer_1500epochs__nnUNetPlans__3d_fullres/crossval_results_folds_0_1_2_3_4/PETCT_741f6130ed_11282004.nii.gz,/well/papiez/users/hri611/python/nnUnet_raw/Dataset219_PETCT/labelsTr/PETCT_741f6130ed_11282004.nii.gz,,0.0,0.0
394,0.9149731428995768,1512,1923,0.8432723456677464,52138083,18482,20405,19994,/well/papiez/users/hri611/python/nnUNet_results/Dataset219_PETCT/nnUNetTrainer_1500epochs__nnUNetPlans__3d_fullres/crossval_results_folds_0_1_2_3_4/PETCT_742a9413db_11102001.nii.gz,/well/papiez/users/hri611/python/nnUnet_raw/Dataset219_PETCT/labelsTr/PETCT_742a9413db_11102001.nii.gz,0.9149731428995768,1.3311892433166503,0.0
395,0.20027063599458728,26,565,0.11127819548872181,45119335,74,639,100,/well/papiez/users/hri611/python/nnUNet_results/Dataset219_PETCT/nnUNetTrainer_1500epochs__nnUNetPlans__3d_fullres/crossval_results_folds_0_1_2_3_4/PETCT_74bbceaeeb_06032005.nii.gz,/well/papiez/users/hri611/python/nnUnet_raw/Dataset219_PETCT/labelsTr/PETCT_74bbceaeeb_06032005.nii.gz,0.20027063599458728,6.232951503753662,0.32346654510498046
396,0.0,0,194,0.0,52159806,0,194,0,/well/papiez/users/hri611/python/nnUNet_results/Dataset219_PETCT/nnUNetTrainer_1500epochs__nnUNetPlans__3d_fullres/crossval_results_folds_0_1_2_3_4/PETCT_75046e0c12_10292004.nii.gz,/well/papiez/users/hri611/python/nnUnet_raw/Dataset219_PETCT/labelsTr/PETCT_75046e0c12_10292004.nii.gz,0.0,2.413558067321777,0.0
397,0.0,0,1151,0.0,46078849,0,1151,0,/well/papiez/users/hri611/python/nnUNet_results/Dataset219_PETCT/nnUNetTrainer_1500epochs__nnUNetPlans__3d_fullres/crossval_results_folds_0_1_2_3_4/PETCT_75210090cd_07022005.nii.gz,/well/papiez/users/hri611/python/nnUnet_raw/Dataset219_PETCT/labelsTr/PETCT_75210090cd_07022005.nii.gz,0.0,14.319615131378173,0.0
398,0.0,0,268,0.0,52159732,0,268,0,/well/papiez/users/hri611/python/nnUNet_results/Dataset219_PETCT/nnUNetTrainer_1500epochs__nnUNetPlans__3d_fullres/crossval_results_folds_0_1_2_3_4/PETCT_75d1080946_07282003.nii.gz,/well/papiez/users/hri611/python/nnUnet_raw/Dataset219_PETCT/labelsTr/PETCT_75d1080946_07282003.nii.gz,0.0,3.334193618774414,0.0
399,,0,0,,38720000,0,0,0,/well/papiez/users/hri611/python/nnUNet_results/Dataset219_PETCT/nnUNetTrainer_1500epochs__nnUNetPlans__3d_fullres/crossval_results_folds_0_1_2_3_4/PETCT_75d5e740f0_07112002.nii.gz,/well/papiez/users/hri611/python/nnUnet_raw/Dataset219_PETCT/labelsTr/PETCT_75d5e740f0_07112002.nii.gz,,0.0,0.0
400,0.0,0,105,0.0,52159895,0,105,0,/well/papiez/users/hri611/python/nnUNet_results/Dataset219_PETCT/nnUNetTrainer_1500epochs__nnUNetPlans__3d_fullres/crossval_results_folds_0_1_2_3_4/PETCT_75e42ff05f_09212002.nii.gz,/well/papiez/users/hri611/python/nnUnet_raw/Dataset219_PETCT/labelsTr/PETCT_75e42ff05f_09212002.nii.gz,0.0,1.306307201385498,0.0
401,0.04131455399061033,4734,1392,0.02109300095877277,45433742,132,1524,4866,/well/papiez/users/hri611/python/nnUNet_results/Dataset219_PETCT/nnUNetTrainer_1500epochs__nnUNetPlans__3d_fullres/crossval_results_folds_0_1_2_3_4/PETCT_760c77b289_01202002.nii.gz,/well/papiez/users/hri611/python/nnUnet_raw/Dataset219_PETCT/labelsTr/PETCT_760c77b289_01202002.nii.gz,0.04131455399061033,17.268137100219725,58.311065265655515
402,0.0,0,1587,0.0,45438413,0,1587,0,/well/papiez/users/hri611/python/nnUNet_results/Dataset219_PETCT/nnUNetTrainer_1500epochs__nnUNetPlans__3d_fullres/crossval_results_folds_0_1_2_3_4/PETCT_777fa0ba88_04072003.nii.gz,/well/papiez/users/hri611/python/nnUnet_raw/Dataset219_PETCT/labelsTr/PETCT_777fa0ba88_04072003.nii.gz,0.0,19.743900272369384,0.0
403,0.0,0,96,0.0,45439904,0,96,0,/well/papiez/users/hri611/python/nnUNet_results/Dataset219_PETCT/nnUNetTrainer_1500epochs__nnUNetPlans__3d_fullres/crossval_results_folds_0_1_2_3_4/PETCT_777fa0ba88_11042002.nii.gz,/well/papiez/users/hri611/python/nnUnet_raw/Dataset219_PETCT/labelsTr/PETCT_777fa0ba88_11042002.nii.gz,0.0,1.1943380126953125,0.0
404,0.2106951871657754,141,1335,0.1177525403466826,97278327,197,1532,338,/well/papiez/users/hri611/python/nnUNet_results/Dataset219_PETCT/nnUNetTrainer_1500epochs__nnUNetPlans__3d_fullres/crossval_results_folds_0_1_2_3_4/PETCT_7785c10e91_12152006.nii.gz,/well/papiez/users/hri611/python/nnUnet_raw/Dataset219_PETCT/labelsTr/PETCT_7785c10e91_12152006.nii.gz,0.2106951871657754,16.384824611663817,0.0
405,0.7634951456310679,506,103,0.617462311557789,45438408,983,1086,1489,/well/papiez/users/hri611/python/nnUNet_results/Dataset219_PETCT/nnUNetTrainer_1500epochs__nnUNetPlans__3d_fullres/crossval_results_folds_0_1_2_3_4/PETCT_77bceab232_11212002.nii.gz,/well/papiez/users/hri611/python/nnUnet_raw/Dataset219_PETCT/labelsTr/PETCT_77bceab232_11212002.nii.gz,0.7634951456310679,1.2814251594543458,2.2145017318725584
406,0.0,0,1015,0.0,52958985,0,1015,0,/well/papiez/users/hri611/python/nnUNet_results/Dataset219_PETCT/nnUNetTrainer_1500epochs__nnUNetPlans__3d_fullres/crossval_results_folds_0_1_2_3_4/PETCT_78355d1d4f_01232006.nii.gz,/well/papiez/users/hri611/python/nnUnet_raw/Dataset219_PETCT/labelsTr/PETCT_78355d1d4f_01232006.nii.gz,0.0,12.627636280059814,0.0
407,0.0,0,10,0.0,52159990,0,10,0,/well/papiez/users/hri611/python/nnUNet_results/Dataset219_PETCT/nnUNetTrainer_1500epochs__nnUNetPlans__3d_fullres/crossval_results_folds_0_1_2_3_4/PETCT_78b89bc739_11082004.nii.gz,/well/papiez/users/hri611/python/nnUnet_raw/Dataset219_PETCT/labelsTr/PETCT_78b89bc739_11082004.nii.gz,0.0,0.12441020965576172,0.0
408,0.7474967645255772,6,3701,0.5968022623450077,45430806,5487,9188,5493,/well/papiez/users/hri611/python/nnUNet_results/Dataset219_PETCT/nnUNetTrainer_1500epochs__nnUNetPlans__3d_fullres/crossval_results_folds_0_1_2_3_4/PETCT_790246c76c_02072004.nii.gz,/well/papiez/users/hri611/python/nnUnet_raw/Dataset219_PETCT/labelsTr/PETCT_790246c76c_02072004.nii.gz,0.7474967645255772,7.253115222930908,0.0
409,0.895847154040069,54,2301,0.8113434270608026,72147517,10128,12429,10182,/well/papiez/users/hri611/python/nnUNet_results/Dataset219_PETCT/nnUNetTrainer_1500epochs__nnUNetPlans__3d_fullres/crossval_results_folds_0_1_2_3_4/PETCT_791ec15924_04162001.nii.gz,/well/papiez/users/hri611/python/nnUnet_raw/Dataset219_PETCT/labelsTr/PETCT_791ec15924_04162001.nii.gz,0.895847154040069,3.6701011848449707,0.49764083862304687
410,0.0,0,141,0.0,31999859,0,141,0,/well/papiez/users/hri611/python/nnUNet_results/Dataset219_PETCT/nnUNetTrainer_1500epochs__nnUNetPlans__3d_fullres/crossval_results_folds_0_1_2_3_4/PETCT_792d7b6ad0_04042005.nii.gz,/well/papiez/users/hri611/python/nnUnet_raw/Dataset219_PETCT/labelsTr/PETCT_792d7b6ad0_04042005.nii.gz,0.0,1.7541839561462402,0.0
411,0.6428935303107488,7878,534,0.47372372372372373,45424016,7572,8106,15450,/well/papiez/users/hri611/python/nnUNet_results/Dataset219_PETCT/nnUNetTrainer_1500epochs__nnUNetPlans__3d_fullres/crossval_results_folds_0_1_2_3_4/PETCT_7948aa0e26_08102001.nii.gz,/well/papiez/users/hri611/python/nnUnet_raw/Dataset219_PETCT/labelsTr/PETCT_7948aa0e26_08102001.nii.gz,0.6428935303107488,0.0,38.094406196594235
412,0.8831908831908832,58,24,0.7908163265306123,52159608,310,334,368,/well/papiez/users/hri611/python/nnUNet_results/Dataset219_PETCT/nnUNetTrainer_1500epochs__nnUNetPlans__3d_fullres/crossval_results_folds_0_1_2_3_4/PETCT_7958ce0f7c_08312003.nii.gz,/well/papiez/users/hri611/python/nnUnet_raw/Dataset219_PETCT/labelsTr/PETCT_7958ce0f7c_08312003.nii.gz,0.8831908831908832,0.26126144027709963,0.0
413,,0,0,,45440000,0,0,0,/well/papiez/users/hri611/python/nnUNet_results/Dataset219_PETCT/nnUNetTrainer_1500epochs__nnUNetPlans__3d_fullres/crossval_results_folds_0_1_2_3_4/PETCT_7978e9fe62_03232003.nii.gz,/well/papiez/users/hri611/python/nnUnet_raw/Dataset219_PETCT/labelsTr/PETCT_7978e9fe62_03232003.nii.gz,,0.0,0.0
414,0.0,0,121,0.0,49119879,0,121,0,/well/papiez/users/hri611/python/nnUNet_results/Dataset219_PETCT/nnUNetTrainer_1500epochs__nnUNetPlans__3d_fullres/crossval_results_folds_0_1_2_3_4/PETCT_7a262070a9_11252005.nii.gz,/well/papiez/users/hri611/python/nnUnet_raw/Dataset219_PETCT/labelsTr/PETCT_7a262070a9_11252005.nii.gz,0.0,1.5053635368347167,0.0
415,,0,0,,46240000,0,0,0,/well/papiez/users/hri611/python/nnUNet_results/Dataset219_PETCT/nnUNetTrainer_1500epochs__nnUNetPlans__3d_fullres/crossval_results_folds_0_1_2_3_4/PETCT_7a3a27371a_04132006.nii.gz,/well/papiez/users/hri611/python/nnUnet_raw/Dataset219_PETCT/labelsTr/PETCT_7a3a27371a_04132006.nii.gz,,0.0,0.0
416,0.7129027237354085,8399,824,0.5538841056399342,45419326,11451,12275,19850,/well/papiez/users/hri611/python/nnUNet_results/Dataset219_PETCT/nnUNetTrainer_1500epochs__nnUNetPlans__3d_fullres/crossval_results_folds_0_1_2_3_4/PETCT_7a77b26403_10202000.nii.gz,/well/papiez/users/hri611/python/nnUnet_raw/Dataset219_PETCT/labelsTr/PETCT_7a77b26403_10202000.nii.gz,0.7129027237354085,0.435435733795166,12.764487510681152
417,0.7509251352120695,5154,96,0.6011850501367365,52146836,7914,8010,13068,/well/papiez/users/hri611/python/nnUNet_results/Dataset219_PETCT/nnUNetTrainer_1500epochs__nnUNetPlans__3d_fullres/crossval_results_folds_0_1_2_3_4/PETCT_7a8a062ed5_03122005.nii.gz,/well/papiez/users/hri611/python/nnUnet_raw/Dataset219_PETCT/labelsTr/PETCT_7a8a062ed5_03122005.nii.gz,0.7509251352120695,0.12441020965576172,0.012441020965576172
418,0.0,0,285,0.0,43519715,0,285,0,/well/papiez/users/hri611/python/nnUNet_results/Dataset219_PETCT/nnUNetTrainer_1500epochs__nnUNetPlans__3d_fullres/crossval_results_folds_0_1_2_3_4/PETCT_7abe274c10_09212006.nii.gz,/well/papiez/users/hri611/python/nnUnet_raw/Dataset219_PETCT/labelsTr/PETCT_7abe274c10_09212006.nii.gz,0.0,3.545690975189209,0.0
419,0.8450956830532489,7534,1103,0.7317451936515824,45407803,23560,24663,31094,/well/papiez/users/hri611/python/nnUNet_results/Dataset219_PETCT/nnUNetTrainer_1500epochs__nnUNetPlans__3d_fullres/crossval_results_folds_0_1_2_3_4/PETCT_7b42056ee3_10132002.nii.gz,/well/papiez/users/hri611/python/nnUnet_raw/Dataset219_PETCT/labelsTr/PETCT_7b42056ee3_10132002.nii.gz,0.8450956830532489,0.04976408386230469,18.26341877746582
420,0.0,0,34,0.0,92319966,0,34,0,/well/papiez/users/hri611/python/nnUNet_results/Dataset219_PETCT/nnUNetTrainer_1500epochs__nnUNetPlans__3d_fullres/crossval_results_folds_0_1_2_3_4/PETCT_7b477e7e0d_06192003.nii.gz,/well/papiez/users/hri611/python/nnUnet_raw/Dataset219_PETCT/labelsTr/PETCT_7b477e7e0d_06192003.nii.gz,0.0,0.42299471282958984,0.0
421,0.9061470124659693,2698,1232,0.8283992664396123,99017098,18972,20204,21670,/well/papiez/users/hri611/python/nnUNet_results/Dataset219_PETCT/nnUNetTrainer_1500epochs__nnUNetPlans__3d_fullres/crossval_results_folds_0_1_2_3_4/PETCT_7b477e7e0d_07262002.nii.gz,/well/papiez/users/hri611/python/nnUnet_raw/Dataset219_PETCT/labelsTr/PETCT_7b477e7e0d_07262002.nii.gz,0.9061470124659693,3.545690975189209,5.150582679748535
422,,0,0,,52160000,0,0,0,/well/papiez/users/hri611/python/nnUNet_results/Dataset219_PETCT/nnUNetTrainer_1500epochs__nnUNetPlans__3d_fullres/crossval_results_folds_0_1_2_3_4/PETCT_7b9d625330_11172002.nii.gz,/well/papiez/users/hri611/python/nnUnet_raw/Dataset219_PETCT/labelsTr/PETCT_7b9d625330_11172002.nii.gz,,0.0,0.0
423,0.0,0,45,0.0,99039955,0,45,0,/well/papiez/users/hri611/python/nnUNet_results/Dataset219_PETCT/nnUNetTrainer_1500epochs__nnUNetPlans__3d_fullres/crossval_results_folds_0_1_2_3_4/PETCT_7c1e6175e0_01302005.nii.gz,/well/papiez/users/hri611/python/nnUnet_raw/Dataset219_PETCT/labelsTr/PETCT_7c1e6175e0_01302005.nii.gz,0.0,0.5598459434509278,0.0
424,0.0,0,7782,0.0,52152218,0,7782,0,/well/papiez/users/hri611/python/nnUNet_results/Dataset219_PETCT/nnUNetTrainer_1500epochs__nnUNetPlans__3d_fullres/crossval_results_folds_0_1_2_3_4/PETCT_7c96c4626d_06302003.nii.gz,/well/papiez/users/hri611/python/nnUnet_raw/Dataset219_PETCT/labelsTr/PETCT_7c96c4626d_06302003.nii.gz,0.0,96.81602515411377,0.0
425,0.8910133843212237,16,98,0.803448275862069,89279420,466,564,482,/well/papiez/users/hri611/python/nnUNet_results/Dataset219_PETCT/nnUNetTrainer_1500epochs__nnUNetPlans__3d_fullres/crossval_results_folds_0_1_2_3_4/PETCT_7ce196485f_01192006.nii.gz,/well/papiez/users/hri611/python/nnUnet_raw/Dataset219_PETCT/labelsTr/PETCT_7ce196485f_01192006.nii.gz,0.8910133843212237,0.32346654510498046,0.0
426,0.6352923515724687,1072,3787,0.46551534484655155,92150909,4232,8019,5304,/well/papiez/users/hri611/python/nnUNet_results/Dataset219_PETCT/nnUNetTrainer_1500epochs__nnUNetPlans__3d_fullres/crossval_results_folds_0_1_2_3_4/PETCT_7cfd708a53_06172005.nii.gz,/well/papiez/users/hri611/python/nnUnet_raw/Dataset219_PETCT/labelsTr/PETCT_7cfd708a53_06172005.nii.gz,0.6352923515724687,41.32907164764404,2.052768459320068
427,0.11800699300699301,1705,313,0.06270320483046911,52157847,135,448,1840,/well/papiez/users/hri611/python/nnUNet_results/Dataset219_PETCT/nnUNetTrainer_1500epochs__nnUNetPlans__3d_fullres/crossval_results_folds_0_1_2_3_4/PETCT_7d01eb835d_03312002.nii.gz,/well/papiez/users/hri611/python/nnUnet_raw/Dataset219_PETCT/labelsTr/PETCT_7d01eb835d_03312002.nii.gz,0.11800699300699301,3.471044849395752,21.211940746307373
428,0.0,0,2,0.0,52159998,0,2,0,/well/papiez/users/hri611/python/nnUNet_results/Dataset219_PETCT/nnUNetTrainer_1500epochs__nnUNetPlans__3d_fullres/crossval_results_folds_0_1_2_3_4/PETCT_7d8aa1e94d_10042002.nii.gz,/well/papiez/users/hri611/python/nnUnet_raw/Dataset219_PETCT/labelsTr/PETCT_7d8aa1e94d_10042002.nii.gz,0.0,0.024882041931152343,0.0
429,0.8248581026294451,2842,182,0.7019221291276491,52149855,7121,7303,9963,/well/papiez/users/hri611/python/nnUNet_results/Dataset219_PETCT/nnUNetTrainer_1500epochs__nnUNetPlans__3d_fullres/crossval_results_folds_0_1_2_3_4/PETCT_7d97f7a102_04212002.nii.gz,/well/papiez/users/hri611/python/nnUnet_raw/Dataset219_PETCT/labelsTr/PETCT_7d97f7a102_04212002.nii.gz,0.8248581026294451,0.037323062896728515,0.0
430,0.0,0,4,0.0,46239996,0,4,0,/well/papiez/users/hri611/python/nnUNet_results/Dataset219_PETCT/nnUNetTrainer_1500epochs__nnUNetPlans__3d_fullres/crossval_results_folds_0_1_2_3_4/PETCT_7e56b0b62c_05272006.nii.gz,/well/papiez/users/hri611/python/nnUnet_raw/Dataset219_PETCT/labelsTr/PETCT_7e56b0b62c_05272006.nii.gz,0.0,0.04976408386230469,0.0
431,0.8351370344342938,455,718,0.7169401544401545,52155856,2971,3689,3426,/well/papiez/users/hri611/python/nnUNet_results/Dataset219_PETCT/nnUNetTrainer_1500epochs__nnUNetPlans__3d_fullres/crossval_results_folds_0_1_2_3_4/PETCT_7e5729ea40_02212003.nii.gz,/well/papiez/users/hri611/python/nnUnet_raw/Dataset219_PETCT/labelsTr/PETCT_7e5729ea40_02212003.nii.gz,0.8351370344342938,0.7589022789001465,0.0
432,0.8236259228876128,16,629,0.700139470013947,52157849,1506,2135,1522,/well/papiez/users/hri611/python/nnUNet_results/Dataset219_PETCT/nnUNetTrainer_1500epochs__nnUNetPlans__3d_fullres/crossval_results_folds_0_1_2_3_4/PETCT_7ed037687a_01272003.nii.gz,/well/papiez/users/hri611/python/nnUnet_raw/Dataset219_PETCT/labelsTr/PETCT_7ed037687a_01272003.nii.gz,0.8236259228876128,0.2861434822082519,0.0
433,0.0,0,145,0.0,51039855,0,145,0,/well/papiez/users/hri611/python/nnUNet_results/Dataset219_PETCT/nnUNetTrainer_1500epochs__nnUNetPlans__3d_fullres/crossval_results_folds_0_1_2_3_4/PETCT_7ee7610b9e_01212006.nii.gz,/well/papiez/users/hri611/python/nnUnet_raw/Dataset219_PETCT/labelsTr/PETCT_7ee7610b9e_01212006.nii.gz,0.0,1.8039480400085448,0.0
434,0.0,0,1923,0.0,52158077,0,1923,0,/well/papiez/users/hri611/python/nnUNet_results/Dataset219_PETCT/nnUNetTrainer_1500epochs__nnUNetPlans__3d_fullres/crossval_results_folds_0_1_2_3_4/PETCT_7ef5343426_05122005.nii.gz,/well/papiez/users/hri611/python/nnUnet_raw/Dataset219_PETCT/labelsTr/PETCT_7ef5343426_05122005.nii.gz,0.0,23.924083316802978,0.0
435,0.23581923005393343,446,3663,0.13367067257010332,99035257,634,4297,1080,/well/papiez/users/hri611/python/nnUNet_results/Dataset219_PETCT/nnUNetTrainer_1500epochs__nnUNetPlans__3d_fullres/crossval_results_folds_0_1_2_3_4/PETCT_7f2a604e03_05052002.nii.gz,/well/papiez/users/hri611/python/nnUnet_raw/Dataset219_PETCT/labelsTr/PETCT_7f2a604e03_05052002.nii.gz,0.23581923005393343,43.48136827468872,1.7541839561462402
436,0.8985507246376812,306,58,0.8157894736842105,45438024,1612,1670,1918,/well/papiez/users/hri611/python/nnUNet_results/Dataset219_PETCT/nnUNetTrainer_1500epochs__nnUNetPlans__3d_fullres/crossval_results_folds_0_1_2_3_4/PETCT_7faf36a152_06142002.nii.gz,/well/papiez/users/hri611/python/nnUnet_raw/Dataset219_PETCT/labelsTr/PETCT_7faf36a152_06142002.nii.gz,0.8985507246376812,0.0,0.0
437,0.0,0,6,0.0,45439994,0,6,0,/well/papiez/users/hri611/python/nnUNet_results/Dataset219_PETCT/nnUNetTrainer_1500epochs__nnUNetPlans__3d_fullres/crossval_results_folds_0_1_2_3_4/PETCT_7faf36a152_11272005.nii.gz,/well/papiez/users/hri611/python/nnUnet_raw/Dataset219_PETCT/labelsTr/PETCT_7faf36a152_11272005.nii.gz,0.0,0.07464612579345703,0.0
438,0.5879314393050011,512,2998,0.4163618224143665,85593986,2504,5502,3016,/well/papiez/users/hri611/python/nnUNet_results/Dataset219_PETCT/nnUNetTrainer_1500epochs__nnUNetPlans__3d_fullres/crossval_results_folds_0_1_2_3_4/PETCT_7fbb39290e_08152002.nii.gz,/well/papiez/users/hri611/python/nnUnet_raw/Dataset219_PETCT/labelsTr/PETCT_7fbb39290e_08152002.nii.gz,0.5879314393050011,33.939105194091795,0.0
439,0.8750218799229826,813,615,0.7778123541310098,45433573,4999,5614,5812,/well/papiez/users/hri611/python/nnUNet_results/Dataset219_PETCT/nnUNetTrainer_1500epochs__nnUNetPlans__3d_fullres/crossval_results_folds_0_1_2_3_4/PETCT_802f19931c_06302002.nii.gz,/well/papiez/users/hri611/python/nnUnet_raw/Dataset219_PETCT/labelsTr/PETCT_802f19931c_06302002.nii.gz,0.8750218799229826,0.0,0.0
440,,0,0,,38720000,0,0,0,/well/papiez/users/hri611/python/nnUNet_results/Dataset219_PETCT/nnUNetTrainer_1500epochs__nnUNetPlans__3d_fullres/crossval_results_folds_0_1_2_3_4/PETCT_80b8393c44_07222002.nii.gz,/well/papiez/users/hri611/python/nnUnet_raw/Dataset219_PETCT/labelsTr/PETCT_80b8393c44_07222002.nii.gz,,0.0,0.0
441,0.7720564119383404,267,428,0.6287393162393162,52158128,1177,1605,1444,/well/papiez/users/hri611/python/nnUNet_results/Dataset219_PETCT/nnUNetTrainer_1500epochs__nnUNetPlans__3d_fullres/crossval_results_folds_0_1_2_3_4/PETCT_80ccbdadf9_05062002.nii.gz,/well/papiez/users/hri611/python/nnUnet_raw/Dataset219_PETCT/labelsTr/PETCT_80ccbdadf9_05062002.nii.gz,0.7720564119383404,3.4337217864990235,2.1522966270446777
442,0.8580756570071771,3234,2026,0.7514295165634894,52138839,15901,17927,19135,/well/papiez/users/hri611/python/nnUNet_results/Dataset219_PETCT/nnUNetTrainer_1500epochs__nnUNetPlans__3d_fullres/crossval_results_folds_0_1_2_3_4/PETCT_80d7e682f7_02112005.nii.gz,/well/papiez/users/hri611/python/nnUnet_raw/Dataset219_PETCT/labelsTr/PETCT_80d7e682f7_02112005.nii.gz,0.8580756570071771,0.49764083862304687,0.19905633544921875
443,,0,0,,50560000,0,0,0,/well/papiez/users/hri611/python/nnUNet_results/Dataset219_PETCT/nnUNetTrainer_1500epochs__nnUNetPlans__3d_fullres/crossval_results_folds_0_1_2_3_4/PETCT_80f21e1ed0_11122006.nii.gz,/well/papiez/users/hri611/python/nnUnet_raw/Dataset219_PETCT/labelsTr/PETCT_80f21e1ed0_11122006.nii.gz,,0.0,0.0
444,0.0,0,5267,0.0,92314733,0,5267,0,/well/papiez/users/hri611/python/nnUNet_results/Dataset219_PETCT/nnUNetTrainer_1500epochs__nnUNetPlans__3d_fullres/crossval_results_folds_0_1_2_3_4/PETCT_80f7760f65_05022005.nii.gz,/well/papiez/users/hri611/python/nnUnet_raw/Dataset219_PETCT/labelsTr/PETCT_80f7760f65_05022005.nii.gz,0.0,65.5268574256897,0.0
445,0.0,0,1185,0.0,92318815,0,1185,0,/well/papiez/users/hri611/python/nnUNet_results/Dataset219_PETCT/nnUNetTrainer_1500epochs__nnUNetPlans__3d_fullres/crossval_results_folds_0_1_2_3_4/PETCT_80f7760f65_11142005.nii.gz,/well/papiez/users/hri611/python/nnUnet_raw/Dataset219_PETCT/labelsTr/PETCT_80f7760f65_11142005.nii.gz,0.0,14.742609844207763,0.0
446,,0,0,,49920000,0,0,0,/well/papiez/users/hri611/python/nnUNet_results/Dataset219_PETCT/nnUNetTrainer_1500epochs__nnUNetPlans__3d_fullres/crossval_results_folds_0_1_2_3_4/PETCT_81debf13a1_03092006.nii.gz,/well/papiez/users/hri611/python/nnUnet_raw/Dataset219_PETCT/labelsTr/PETCT_81debf13a1_03092006.nii.gz,,0.0,0.0
447,0.7789302420174904,42,3219,0.6379080612924717,52150994,5745,8964,5787,/well/papiez/users/hri611/python/nnUNet_results/Dataset219_PETCT/nnUNetTrainer_1500epochs__nnUNetPlans__3d_fullres/crossval_results_folds_0_1_2_3_4/PETCT_82137245b0_01262002.nii.gz,/well/papiez/users/hri611/python/nnUnet_raw/Dataset219_PETCT/labelsTr/PETCT_82137245b0_01262002.nii.gz,0.7789302420174904,1.4182763900756836,0.012441020965576172
448,0.0,0,62,0.0,52159938,0,62,0,/well/papiez/users/hri611/python/nnUNet_results/Dataset219_PETCT/nnUNetTrainer_1500epochs__nnUNetPlans__3d_fullres/crossval_results_folds_0_1_2_3_4/PETCT_8311aeddb9_11132003.nii.gz,/well/papiez/users/hri611/python/nnUnet_raw/Dataset219_PETCT/labelsTr/PETCT_8311aeddb9_11132003.nii.gz,0.0,0.7713432998657226,0.0
449,0.0,0,308,0.0,47519692,0,308,0,/well/papiez/users/hri611/python/nnUNet_results/Dataset219_PETCT/nnUNetTrainer_1500epochs__nnUNetPlans__3d_fullres/crossval_results_folds_0_1_2_3_4/PETCT_8311aeddb9_12162005.nii.gz,/well/papiez/users/hri611/python/nnUnet_raw/Dataset219_PETCT/labelsTr/PETCT_8311aeddb9_12162005.nii.gz,0.0,3.831834457397461,0.0
450,,0,0,,47200000,0,0,0,/well/papiez/users/hri611/python/nnUNet_results/Dataset219_PETCT/nnUNetTrainer_1500epochs__nnUNetPlans__3d_fullres/crossval_results_folds_0_1_2_3_4/PETCT_83e4c5b578_03112006.nii.gz,/well/papiez/users/hri611/python/nnUnet_raw/Dataset219_PETCT/labelsTr/PETCT_83e4c5b578_03112006.nii.gz,,0.0,0.0
451,0.0,0,38,0.0,52159962,0,38,0,/well/papiez/users/hri611/python/nnUNet_results/Dataset219_PETCT/nnUNetTrainer_1500epochs__nnUNetPlans__3d_fullres/crossval_results_folds_0_1_2_3_4/PETCT_846c1af245_12062002.nii.gz,/well/papiez/users/hri611/python/nnUnet_raw/Dataset219_PETCT/labelsTr/PETCT_846c1af245_12062002.nii.gz,0.0,0.4727587966918945,0.0
452,0.7909971789525329,1710,1698,0.654255858780562,51990143,6449,8147,8159,/well/papiez/users/hri611/python/nnUNet_results/Dataset219_PETCT/nnUNetTrainer_1500epochs__nnUNetPlans__3d_fullres/crossval_results_folds_0_1_2_3_4/PETCT_84e7715ed9_01042002.nii.gz,/well/papiez/users/hri611/python/nnUnet_raw/Dataset219_PETCT/labelsTr/PETCT_84e7715ed9_01042002.nii.gz,0.7909971789525329,18.88546982574463,0.0
453,,0,0,,47360000,0,0,0,/well/papiez/users/hri611/python/nnUNet_results/Dataset219_PETCT/nnUNetTrainer_1500epochs__nnUNetPlans__3d_fullres/crossval_results_folds_0_1_2_3_4/PETCT_855c7fca12_07272006.nii.gz,/well/papiez/users/hri611/python/nnUnet_raw/Dataset219_PETCT/labelsTr/PETCT_855c7fca12_07272006.nii.gz,,0.0,0.0
454,0.0,0,452,0.0,46879548,0,452,0,/well/papiez/users/hri611/python/nnUNet_results/Dataset219_PETCT/nnUNetTrainer_1500epochs__nnUNetPlans__3d_fullres/crossval_results_folds_0_1_2_3_4/PETCT_85b69fed1c_01212006.nii.gz,/well/papiez/users/hri611/python/nnUnet_raw/Dataset219_PETCT/labelsTr/PETCT_85b69fed1c_01212006.nii.gz,0.0,5.623341476440429,0.0
455,0.0,0,25,0.0,53599975,0,25,0,/well/papiez/users/hri611/python/nnUNet_results/Dataset219_PETCT/nnUNetTrainer_1500epochs__nnUNetPlans__3d_fullres/crossval_results_folds_0_1_2_3_4/PETCT_86153b2974_03192006.nii.gz,/well/papiez/users/hri611/python/nnUnet_raw/Dataset219_PETCT/labelsTr/PETCT_86153b2974_03192006.nii.gz,0.0,0.3110255241394043,0.0
456,0.0,0,106,0.0,65439894,0,106,0,/well/papiez/users/hri611/python/nnUNet_results/Dataset219_PETCT/nnUNetTrainer_1500epochs__nnUNetPlans__3d_fullres/crossval_results_folds_0_1_2_3_4/PETCT_86153b2974_04032005.nii.gz,/well/papiez/users/hri611/python/nnUnet_raw/Dataset219_PETCT/labelsTr/PETCT_86153b2974_04032005.nii.gz,0.0,1.3187482223510743,0.0
457,0.8823529411764706,869,779,0.7894736842105263,58872172,6180,6959,7049,/well/papiez/users/hri611/python/nnUNet_results/Dataset219_PETCT/nnUNetTrainer_1500epochs__nnUNetPlans__3d_fullres/crossval_results_folds_0_1_2_3_4/PETCT_86153b2974_06052003.nii.gz,/well/papiez/users/hri611/python/nnUnet_raw/Dataset219_PETCT/labelsTr/PETCT_86153b2974_06052003.nii.gz,0.8823529411764706,1.6546557884216309,0.012441020965576172
458,0.0,0,631,0.0,53119369,0,631,0,/well/papiez/users/hri611/python/nnUNet_results/Dataset219_PETCT/nnUNetTrainer_1500epochs__nnUNetPlans__3d_fullres/crossval_results_folds_0_1_2_3_4/PETCT_86153b2974_10022005.nii.gz,/well/papiez/users/hri611/python/nnUnet_raw/Dataset219_PETCT/labelsTr/PETCT_86153b2974_10022005.nii.gz,0.0,7.850284229278564,0.0
459,,0,0,,52960000,0,0,0,/well/papiez/users/hri611/python/nnUNet_results/Dataset219_PETCT/nnUNetTrainer_1500epochs__nnUNetPlans__3d_fullres/crossval_results_folds_0_1_2_3_4/PETCT_86153b2974_10062006.nii.gz,/well/papiez/users/hri611/python/nnUnet_raw/Dataset219_PETCT/labelsTr/PETCT_86153b2974_10062006.nii.gz,,0.0,0.0
460,0.8619971870604782,94,2359,0.7574649001384219,45429886,7661,10020,7755,/well/papiez/users/hri611/python/nnUNet_results/Dataset219_PETCT/nnUNetTrainer_1500epochs__nnUNetPlans__3d_fullres/crossval_results_folds_0_1_2_3_4/PETCT_86e54ea60a_03182002.nii.gz,/well/papiez/users/hri611/python/nnUnet_raw/Dataset219_PETCT/labelsTr/PETCT_86e54ea60a_03182002.nii.gz,0.8619971870604782,4.217506107330323,0.721579216003418
461,0.30442583732057416,0,2326,0.17954144620811288,45437165,509,2835,509,/well/papiez/users/hri611/python/nnUNet_results/Dataset219_PETCT/nnUNetTrainer_1500epochs__nnUNetPlans__3d_fullres/crossval_results_folds_0_1_2_3_4/PETCT_870181d7fd_10312004.nii.gz,/well/papiez/users/hri611/python/nnUnet_raw/Dataset219_PETCT/labelsTr/PETCT_870181d7fd_10312004.nii.gz,0.30442583732057416,25.591180126190185,0.0
462,,0,0,,87200000,0,0,0,/well/papiez/users/hri611/python/nnUNet_results/Dataset219_PETCT/nnUNetTrainer_1500epochs__nnUNetPlans__3d_fullres/crossval_results_folds_0_1_2_3_4/PETCT_87afc291ec_01262006.nii.gz,/well/papiez/users/hri611/python/nnUnet_raw/Dataset219_PETCT/labelsTr/PETCT_87afc291ec_01262006.nii.gz,,0.0,0.0
463,0.0,0,578,0.0,85599422,0,578,0,/well/papiez/users/hri611/python/nnUNet_results/Dataset219_PETCT/nnUNetTrainer_1500epochs__nnUNetPlans__3d_fullres/crossval_results_folds_0_1_2_3_4/PETCT_87afc291ec_07202003.nii.gz,/well/papiez/users/hri611/python/nnUnet_raw/Dataset219_PETCT/labelsTr/PETCT_87afc291ec_07202003.nii.gz,0.0,7.1909101181030275,0.0
464,0.0,0,39,0.0,43679961,0,39,0,/well/papiez/users/hri611/python/nnUNet_results/Dataset219_PETCT/nnUNetTrainer_1500epochs__nnUNetPlans__3d_fullres/crossval_results_folds_0_1_2_3_4/PETCT_8838c53a63_05222005.nii.gz,/well/papiez/users/hri611/python/nnUnet_raw/Dataset219_PETCT/labelsTr/PETCT_8838c53a63_05222005.nii.gz,0.0,0.48519981765747067,0.0
465,0.8351050385810499,10186,905,0.7168929957116602,52120824,28085,28990,38271,/well/papiez/users/hri611/python/nnUNet_results/Dataset219_PETCT/nnUNetTrainer_1500epochs__nnUNetPlans__3d_fullres/crossval_results_folds_0_1_2_3_4/PETCT_88bcc970b3_02282002.nii.gz,/well/papiez/users/hri611/python/nnUnet_raw/Dataset219_PETCT/labelsTr/PETCT_88bcc970b3_02282002.nii.gz,0.8351050385810499,0.0,18.773500637054443
466,0.2760511882998172,49,743,0.16012725344644752,92319057,151,894,200,/well/papiez/users/hri611/python/nnUNet_results/Dataset219_PETCT/nnUNetTrainer_1500epochs__nnUNetPlans__3d_fullres/crossval_results_folds_0_1_2_3_4/PETCT_89065bc4ab_02202004.nii.gz,/well/papiez/users/hri611/python/nnUnet_raw/Dataset219_PETCT/labelsTr/PETCT_89065bc4ab_02202004.nii.gz,0.2760511882998172,8.323043025970458,0.0
467,0.7809700611739476,7505,47240,0.640648794832747,58727656,97599,144839,105104,/well/papiez/users/hri611/python/nnUNet_results/Dataset219_PETCT/nnUNetTrainer_1500epochs__nnUNetPlans__3d_fullres/crossval_results_folds_0_1_2_3_4/PETCT_8a52353a72_02172003.nii.gz,/well/papiez/users/hri611/python/nnUnet_raw/Dataset219_PETCT/labelsTr/PETCT_8a52353a72_02172003.nii.gz,0.7809700611739476,19.096967182159425,50.1746375541687
468,0.8339565527065527,2897,833,0.7152019546461021,45426903,9367,10200,12264,/well/papiez/users/hri611/python/nnUNet_results/Dataset219_PETCT/nnUNetTrainer_1500epochs__nnUNetPlans__3d_fullres/crossval_results_folds_0_1_2_3_4/PETCT_8aa48809ea_04162001.nii.gz,/well/papiez/users/hri611/python/nnUnet_raw/Dataset219_PETCT/labelsTr/PETCT_8aa48809ea_04162001.nii.gz,0.8339565527065527,8.882888969421387,0.04976408386230469
469,0.0,0,21,0.0,40639979,0,21,0,/well/papiez/users/hri611/python/nnUNet_results/Dataset219_PETCT/nnUNetTrainer_1500epochs__nnUNetPlans__3d_fullres/crossval_results_folds_0_1_2_3_4/PETCT_8af3757198_12032006.nii.gz,/well/papiez/users/hri611/python/nnUnet_raw/Dataset219_PETCT/labelsTr/PETCT_8af3757198_12032006.nii.gz,0.0,0.26126144027709963,0.0
470,0.0,0,58,0.0,92799942,0,58,0,/well/papiez/users/hri611/python/nnUNet_results/Dataset219_PETCT/nnUNetTrainer_1500epochs__nnUNetPlans__3d_fullres/crossval_results_folds_0_1_2_3_4/PETCT_8b14e6a819_01292006.nii.gz,/well/papiez/users/hri611/python/nnUnet_raw/Dataset219_PETCT/labelsTr/PETCT_8b14e6a819_01292006.nii.gz,0.0,0.721579216003418,0.0
471,0.0,0,1966,0.0,99038034,0,1966,0,/well/papiez/users/hri611/python/nnUNet_results/Dataset219_PETCT/nnUNetTrainer_1500epochs__nnUNetPlans__3d_fullres/crossval_results_folds_0_1_2_3_4/PETCT_8b40e356dc_06182007.nii.gz,/well/papiez/users/hri611/python/nnUnet_raw/Dataset219_PETCT/labelsTr/PETCT_8b40e356dc_06182007.nii.gz,0.0,24.459047218322752,0.0
472,,0,0,,44800000,0,0,0,/well/papiez/users/hri611/python/nnUNet_results/Dataset219_PETCT/nnUNetTrainer_1500epochs__nnUNetPlans__3d_fullres/crossval_results_folds_0_1_2_3_4/PETCT_8b714a64e7_05172007.nii.gz,/well/papiez/users/hri611/python/nnUnet_raw/Dataset219_PETCT/labelsTr/PETCT_8b714a64e7_05172007.nii.gz,,0.0,0.0
473,,0,0,,38720000,0,0,0,/well/papiez/users/hri611/python/nnUNet_results/Dataset219_PETCT/nnUNetTrainer_1500epochs__nnUNetPlans__3d_fullres/crossval_results_folds_0_1_2_3_4/PETCT_8b73608326_04042003.nii.gz,/well/papiez/users/hri611/python/nnUnet_raw/Dataset219_PETCT/labelsTr/PETCT_8b73608326_04042003.nii.gz,,0.0,0.0
474,0.8642850270980983,357,8107,0.7610052237752365,52124585,26951,35058,27308,/well/papiez/users/hri611/python/nnUNet_results/Dataset219_PETCT/nnUNetTrainer_1500epochs__nnUNetPlans__3d_fullres/crossval_results_folds_0_1_2_3_4/PETCT_8b74860ce6_03102005.nii.gz,/well/papiez/users/hri611/python/nnUnet_raw/Dataset219_PETCT/labelsTr/PETCT_8b74860ce6_03102005.nii.gz,0.8642850270980983,2.612614402770996,0.07464612579345703
475,,0,0,,45440000,0,0,0,/well/papiez/users/hri611/python/nnUNet_results/Dataset219_PETCT/nnUNetTrainer_1500epochs__nnUNetPlans__3d_fullres/crossval_results_folds_0_1_2_3_4/PETCT_8bebb676bf_12202002.nii.gz,/well/papiez/users/hri611/python/nnUnet_raw/Dataset219_PETCT/labelsTr/PETCT_8bebb676bf_12202002.nii.gz,,0.0,0.0
476,0.0,0,10475,0.0,49269525,0,10475,0,/well/papiez/users/hri611/python/nnUNet_results/Dataset219_PETCT/nnUNetTrainer_1500epochs__nnUNetPlans__3d_fullres/crossval_results_folds_0_1_2_3_4/PETCT_8bf08c9a42_06092006.nii.gz,/well/papiez/users/hri611/python/nnUnet_raw/Dataset219_PETCT/labelsTr/PETCT_8bf08c9a42_06092006.nii.gz,0.0,130.3196946144104,0.0
477,0.0,0,765,0.0,49919235,0,765,0,/well/papiez/users/hri611/python/nnUNet_results/Dataset219_PETCT/nnUNetTrainer_1500epochs__nnUNetPlans__3d_fullres/crossval_results_folds_0_1_2_3_4/PETCT_8c5d99b459_05042007.nii.gz,/well/papiez/users/hri611/python/nnUnet_raw/Dataset219_PETCT/labelsTr/PETCT_8c5d99b459_05042007.nii.gz,0.0,9.517381038665771,0.0
478,0.8741972043823196,123,210,0.776510067114094,52158510,1157,1367,1280,/well/papiez/users/hri611/python/nnUNet_results/Dataset219_PETCT/nnUNetTrainer_1500epochs__nnUNetPlans__3d_fullres/crossval_results_folds_0_1_2_3_4/PETCT_8c8cd2699c_01182004.nii.gz,/well/papiez/users/hri611/python/nnUnet_raw/Dataset219_PETCT/labelsTr/PETCT_8c8cd2699c_01182004.nii.gz,0.8741972043823196,0.8086663627624512,0.0
479,0.8245458874753384,1407,8909,0.7014700775552726,52125444,24240,33149,25647,/well/papiez/users/hri611/python/nnUNet_results/Dataset219_PETCT/nnUNetTrainer_1500epochs__nnUNetPlans__3d_fullres/crossval_results_folds_0_1_2_3_4/PETCT_8de6953d23_01192001.nii.gz,/well/papiez/users/hri611/python/nnUnet_raw/Dataset219_PETCT/labelsTr/PETCT_8de6953d23_01192001.nii.gz,0.8245458874753384,1.6919788513183593,0.024882041931152343
480,0.6644444444444444,73,531,0.49750415973377704,52158798,598,1129,671,/well/papiez/users/hri611/python/nnUNet_results/Dataset219_PETCT/nnUNetTrainer_1500epochs__nnUNetPlans__3d_fullres/crossval_results_folds_0_1_2_3_4/PETCT_8e02f36295_11082004.nii.gz,/well/papiez/users/hri611/python/nnUnet_raw/Dataset219_PETCT/labelsTr/PETCT_8e02f36295_11082004.nii.gz,0.6644444444444444,2.985845031738281,0.2737024612426758
481,0.7770700636942676,0,105,0.6354166666666666,52159712,183,288,183,/well/papiez/users/hri611/python/nnUNet_results/Dataset219_PETCT/nnUNetTrainer_1500epochs__nnUNetPlans__3d_fullres/crossval_results_folds_0_1_2_3_4/PETCT_8e905366fe_04272001.nii.gz,/well/papiez/users/hri611/python/nnUnet_raw/Dataset219_PETCT/labelsTr/PETCT_8e905366fe_04272001.nii.gz,0.7770700636942676,0.0,0.0
482,0.0,0,8902,0.0,52151098,0,8902,0,/well/papiez/users/hri611/python/nnUNet_results/Dataset219_PETCT/nnUNetTrainer_1500epochs__nnUNetPlans__3d_fullres/crossval_results_folds_0_1_2_3_4/PETCT_8eb3998417_07032004.nii.gz,/well/papiez/users/hri611/python/nnUnet_raw/Dataset219_PETCT/labelsTr/PETCT_8eb3998417_07032004.nii.gz,0.0,110.74996863555909,0.0
483,0.7795628476594963,41935,1300,0.6387570602586812,52040316,76449,77749,118384,/well/papiez/users/hri611/python/nnUNet_results/Dataset219_PETCT/nnUNetTrainer_1500epochs__nnUNetPlans__3d_fullres/crossval_results_folds_0_1_2_3_4/PETCT_8ec13728df_10141999.nii.gz,/well/papiez/users/hri611/python/nnUnet_raw/Dataset219_PETCT/labelsTr/PETCT_8ec13728df_10141999.nii.gz,0.7795628476594963,0.0,131.2030071029663
484,,0,0,,52160000,0,0,0,/well/papiez/users/hri611/python/nnUNet_results/Dataset219_PETCT/nnUNetTrainer_1500epochs__nnUNetPlans__3d_fullres/crossval_results_folds_0_1_2_3_4/PETCT_8f2878df50_02212003.nii.gz,/well/papiez/users/hri611/python/nnUnet_raw/Dataset219_PETCT/labelsTr/PETCT_8f2878df50_02212003.nii.gz,,0.0,0.0
485,0.7041373926619828,333,425,0.5433734939759036,52158340,902,1327,1235,/well/papiez/users/hri611/python/nnUNet_results/Dataset219_PETCT/nnUNetTrainer_1500epochs__nnUNetPlans__3d_fullres/crossval_results_folds_0_1_2_3_4/PETCT_8f2878df50_08222002.nii.gz,/well/papiez/users/hri611/python/nnUnet_raw/Dataset219_PETCT/labelsTr/PETCT_8f2878df50_08222002.nii.gz,0.7041373926619828,3.682542205810547,0.037323062896728515
486,,0,0,,37760000,0,0,0,/well/papiez/users/hri611/python/nnUNet_results/Dataset219_PETCT/nnUNetTrainer_1500epochs__nnUNetPlans__3d_fullres/crossval_results_folds_0_1_2_3_4/PETCT_8fea5f0537_09262005.nii.gz,/well/papiez/users/hri611/python/nnUnet_raw/Dataset219_PETCT/labelsTr/PETCT_8fea5f0537_09262005.nii.gz,,0.0,0.0
487,0.691064848351233,3719,6090,0.5279595765158807,52139220,10971,17061,14690,/well/papiez/users/hri611/python/nnUNet_results/Dataset219_PETCT/nnUNetTrainer_1500epochs__nnUNetPlans__3d_fullres/crossval_results_folds_0_1_2_3_4/PETCT_901573a747_05132005.nii.gz,/well/papiez/users/hri611/python/nnUnet_raw/Dataset219_PETCT/labelsTr/PETCT_901573a747_05132005.nii.gz,0.691064848351233,23.836996170043946,0.9206355514526368
488,,0,0,,45440000,0,0,0,/well/papiez/users/hri611/python/nnUNet_results/Dataset219_PETCT/nnUNetTrainer_1500epochs__nnUNetPlans__3d_fullres/crossval_results_folds_0_1_2_3_4/PETCT_90d668ed29_06072003.nii.gz,/well/papiez/users/hri611/python/nnUnet_raw/Dataset219_PETCT/labelsTr/PETCT_90d668ed29_06072003.nii.gz,,0.0,0.0
489,0.9019264448336253,1546,1366,0.8213716108452951,52143698,13390,14756,14936,/well/papiez/users/hri611/python/nnUNet_results/Dataset219_PETCT/nnUNetTrainer_1500epochs__nnUNetPlans__3d_fullres/crossval_results_folds_0_1_2_3_4/PETCT_90ea6a6aaf_07272001.nii.gz,/well/papiez/users/hri611/python/nnUnet_raw/Dataset219_PETCT/labelsTr/PETCT_90ea6a6aaf_07272001.nii.gz,0.9019264448336253,4.1553010025024415,0.19905633544921875
490,0.577304964539007,58,538,0.4057826520438684,90078997,407,945,465,/well/papiez/users/hri611/python/nnUNet_results/Dataset219_PETCT/nnUNetTrainer_1500epochs__nnUNetPlans__3d_fullres/crossval_results_folds_0_1_2_3_4/PETCT_912a25778f_05172007.nii.gz,/well/papiez/users/hri611/python/nnUnet_raw/Dataset219_PETCT/labelsTr/PETCT_912a25778f_05172007.nii.gz,0.577304964539007,6.357361713409424,0.0
491,0.5814977973568282,35,155,0.40993788819875776,47999678,132,287,167,/well/papiez/users/hri611/python/nnUNet_results/Dataset219_PETCT/nnUNetTrainer_1500epochs__nnUNetPlans__3d_fullres/crossval_results_folds_0_1_2_3_4/PETCT_91cfa804b0_09222006.nii.gz,/well/papiez/users/hri611/python/nnUnet_raw/Dataset219_PETCT/labelsTr/PETCT_91cfa804b0_09222006.nii.gz,0.5814977973568282,1.9159172286987305,0.23637939834594726
492,0.0,0,1156,0.0,49918844,0,1156,0,/well/papiez/users/hri611/python/nnUNet_results/Dataset219_PETCT/nnUNetTrainer_1500epochs__nnUNetPlans__3d_fullres/crossval_results_folds_0_1_2_3_4/PETCT_92c3de23f5_10082005.nii.gz,/well/papiez/users/hri611/python/nnUnet_raw/Dataset219_PETCT/labelsTr/PETCT_92c3de23f5_10082005.nii.gz,0.0,14.381820236206055,0.0
493,0.76238723204679,67460,1442,0.6160143558535213,45260561,110537,111979,177997,/well/papiez/users/hri611/python/nnUNet_results/Dataset219_PETCT/nnUNetTrainer_1500epochs__nnUNetPlans__3d_fullres/crossval_results_folds_0_1_2_3_4/PETCT_92c5c944a5_07152002.nii.gz,/well/papiez/users/hri611/python/nnUnet_raw/Dataset219_PETCT/labelsTr/PETCT_92c5c944a5_07152002.nii.gz,0.76238723204679,0.0,5.722869644165039
494,0.0,0,2,0.0,52159998,0,2,0,/well/papiez/users/hri611/python/nnUNet_results/Dataset219_PETCT/nnUNetTrainer_1500epochs__nnUNetPlans__3d_fullres/crossval_results_folds_0_1_2_3_4/PETCT_93132553f6_08122002.nii.gz,/well/papiez/users/hri611/python/nnUnet_raw/Dataset219_PETCT/labelsTr/PETCT_93132553f6_08122002.nii.gz,0.0,0.024882041931152343,0.0
495,0.7529665587918015,15,1359,0.6038062283737025,52156532,2094,3453,2109,/well/papiez/users/hri611/python/nnUNet_results/Dataset219_PETCT/nnUNetTrainer_1500epochs__nnUNetPlans__3d_fullres/crossval_results_folds_0_1_2_3_4/PETCT_93bea242d1_07252002.nii.gz,/well/papiez/users/hri611/python/nnUnet_raw/Dataset219_PETCT/labelsTr/PETCT_93bea242d1_07252002.nii.gz,0.7529665587918015,0.21149735641479492,0.0
496,0.8161648177496038,5,227,0.6894243641231593,49759253,515,742,520,/well/papiez/users/hri611/python/nnUNet_results/Dataset219_PETCT/nnUNetTrainer_1500epochs__nnUNetPlans__3d_fullres/crossval_results_folds_0_1_2_3_4/PETCT_94962fe878_06012007.nii.gz,/well/papiez/users/hri611/python/nnUnet_raw/Dataset219_PETCT/labelsTr/PETCT_94962fe878_06012007.nii.gz,0.8161648177496038,2.4757631721496582,0.0
497,0.7561728395061729,2780,1486,0.607940446650124,52149119,6615,8101,9395,/well/papiez/users/hri611/python/nnUNet_results/Dataset219_PETCT/nnUNetTrainer_1500epochs__nnUNetPlans__3d_fullres/crossval_results_folds_0_1_2_3_4/PETCT_94986389d4_11112002.nii.gz,/well/papiez/users/hri611/python/nnUnet_raw/Dataset219_PETCT/labelsTr/PETCT_94986389d4_11112002.nii.gz,0.7561728395061729,11.14715478515625,10.276283317565918
498,0.29850746268656714,64,30,0.17543859649122806,102719886,20,50,84,/well/papiez/users/hri611/python/nnUNet_results/Dataset219_PETCT/nnUNetTrainer_1500epochs__nnUNetPlans__3d_fullres/crossval_results_folds_0_1_2_3_4/PETCT_94cc0dac49_03092007.nii.gz,/well/papiez/users/hri611/python/nnUnet_raw/Dataset219_PETCT/labelsTr/PETCT_94cc0dac49_03092007.nii.gz,0.29850746268656714,0.37323062896728515,0.0
499,0.0,0,21,0.0,50879979,0,21,0,/well/papiez/users/hri611/python/nnUNet_results/Dataset219_PETCT/nnUNetTrainer_1500epochs__nnUNetPlans__3d_fullres/crossval_results_folds_0_1_2_3_4/PETCT_94cc0dac49_03102006.nii.gz,/well/papiez/users/hri611/python/nnUnet_raw/Dataset219_PETCT/labelsTr/PETCT_94cc0dac49_03102006.nii.gz,0.0,0.26126144027709963,0.0
500,0.7569786535303776,1449,31,0.6089828269484808,100956215,2305,2336,3754,/well/papiez/users/hri611/python/nnUNet_results/Dataset219_PETCT/nnUNetTrainer_1500epochs__nnUNetPlans__3d_fullres/crossval_results_folds_0_1_2_3_4/PETCT_9521502dbb_05172007.nii.gz,/well/papiez/users/hri611/python/nnUnet_raw/Dataset219_PETCT/labelsTr/PETCT_9521502dbb_05172007.nii.gz,0.7569786535303776,0.0,0.024882041931152343
501,0.0,0,36,0.0,45439964,0,36,0,/well/papiez/users/hri611/python/nnUNet_results/Dataset219_PETCT/nnUNetTrainer_1500epochs__nnUNetPlans__3d_fullres/crossval_results_folds_0_1_2_3_4/PETCT_956520090b_11012003.nii.gz,/well/papiez/users/hri611/python/nnUnet_raw/Dataset219_PETCT/labelsTr/PETCT_956520090b_11012003.nii.gz,0.0,0.4478767547607422,0.0
502,0.17834394904458598,102,156,0.0979020979020979,85599714,28,184,130,/well/papiez/users/hri611/python/nnUNet_results/Dataset219_PETCT/nnUNetTrainer_1500epochs__nnUNetPlans__3d_fullres/crossval_results_folds_0_1_2_3_4/PETCT_95efdaba3c_10112003.nii.gz,/well/papiez/users/hri611/python/nnUnet_raw/Dataset219_PETCT/labelsTr/PETCT_95efdaba3c_10112003.nii.gz,0.17834394904458598,1.8288300819396972,1.2689841384887695
503,0.0,0,1,0.0,58879999,0,1,0,/well/papiez/users/hri611/python/nnUNet_results/Dataset219_PETCT/nnUNetTrainer_1500epochs__nnUNetPlans__3d_fullres/crossval_results_folds_0_1_2_3_4/PETCT_960c5f4262_01162003.nii.gz,/well/papiez/users/hri611/python/nnUnet_raw/Dataset219_PETCT/labelsTr/PETCT_960c5f4262_01162003.nii.gz,0.0,0.012441020965576172,0.0
504,0.0,0,89,0.0,52159911,0,89,0,/well/papiez/users/hri611/python/nnUNet_results/Dataset219_PETCT/nnUNetTrainer_1500epochs__nnUNetPlans__3d_fullres/crossval_results_folds_0_1_2_3_4/PETCT_960c5f4262_02252005.nii.gz,/well/papiez/users/hri611/python/nnUnet_raw/Dataset219_PETCT/labelsTr/PETCT_960c5f4262_02252005.nii.gz,0.0,1.1072508659362792,0.0
505,0.9117327539380772,425,225,0.837783878213127,45435993,3357,3582,3782,/well/papiez/users/hri611/python/nnUNet_results/Dataset219_PETCT/nnUNetTrainer_1500epochs__nnUNetPlans__3d_fullres/crossval_results_folds_0_1_2_3_4/PETCT_963a71819a_10292001.nii.gz,/well/papiez/users/hri611/python/nnUnet_raw/Dataset219_PETCT/labelsTr/PETCT_963a71819a_10292001.nii.gz,0.9117327539380772,0.0,0.0
506,0.0,0,8,0.0,46079992,0,8,0,/well/papiez/users/hri611/python/nnUNet_results/Dataset219_PETCT/nnUNetTrainer_1500epochs__nnUNetPlans__3d_fullres/crossval_results_folds_0_1_2_3_4/PETCT_96e7a3ab28_06142007.nii.gz,/well/papiez/users/hri611/python/nnUnet_raw/Dataset219_PETCT/labelsTr/PETCT_96e7a3ab28_06142007.nii.gz,0.0,0.09952816772460937,0.0
507,0.9349537182797053,3396,1769,0.8778526664301762,45397715,37120,38889,40516,/well/papiez/users/hri611/python/nnUNet_results/Dataset219_PETCT/nnUNetTrainer_1500epochs__nnUNetPlans__3d_fullres/crossval_results_folds_0_1_2_3_4/PETCT_97320b0b58_04172005.nii.gz,/well/papiez/users/hri611/python/nnUnet_raw/Dataset219_PETCT/labelsTr/PETCT_97320b0b58_04172005.nii.gz,0.9349537182797053,2.8116707382202146,1.6795378303527833
508,0.0,0,3925,0.0,42876075,0,3925,0,/well/papiez/users/hri611/python/nnUNet_results/Dataset219_PETCT/nnUNetTrainer_1500epochs__nnUNetPlans__3d_fullres/crossval_results_folds_0_1_2_3_4/PETCT_97320b0b58_07282005.nii.gz,/well/papiez/users/hri611/python/nnUnet_raw/Dataset219_PETCT/labelsTr/PETCT_97320b0b58_07282005.nii.gz,0.0,48.83100728988647,0.0
509,0.8977521443359953,3300,3614,0.8144739313601846,45402733,30353,33967,33653,/well/papiez/users/hri611/python/nnUNet_results/Dataset219_PETCT/nnUNetTrainer_1500epochs__nnUNetPlans__3d_fullres/crossval_results_folds_0_1_2_3_4/PETCT_9775598501_05042001.nii.gz,/well/papiez/users/hri611/python/nnUnet_raw/Dataset219_PETCT/labelsTr/PETCT_9775598501_05042001.nii.gz,0.8977521443359953,2.537968276977539,4.93908532333374
510,0.9508196721311475,17,1,0.90625,45439808,174,175,191,/well/papiez/users/hri611/python/nnUNet_results/Dataset219_PETCT/nnUNetTrainer_1500epochs__nnUNetPlans__3d_fullres/crossval_results_folds_0_1_2_3_4/PETCT_978c395243_01132005.nii.gz,/well/papiez/users/hri611/python/nnUnet_raw/Dataset219_PETCT/labelsTr/PETCT_978c395243_01132005.nii.gz,0.9508196721311475,0.0,0.0
511,0.9032513877874703,180,64,0.8235719450469993,88158617,1139,1203,1319,/well/papiez/users/hri611/python/nnUNet_results/Dataset219_PETCT/nnUNetTrainer_1500epochs__nnUNetPlans__3d_fullres/crossval_results_folds_0_1_2_3_4/PETCT_979f9c3dba_06222006.nii.gz,/well/papiez/users/hri611/python/nnUnet_raw/Dataset219_PETCT/labelsTr/PETCT_979f9c3dba_06222006.nii.gz,0.9032513877874703,0.0,0.0
512,0.8758025199986267,12357,2113,0.7790468628319259,52094511,51019,53132,63376,/well/papiez/users/hri611/python/nnUNet_results/Dataset219_PETCT/nnUNetTrainer_1500epochs__nnUNetPlans__3d_fullres/crossval_results_folds_0_1_2_3_4/PETCT_983a76fd43_11012001.nii.gz,/well/papiez/users/hri611/python/nnUnet_raw/Dataset219_PETCT/labelsTr/PETCT_983a76fd43_11012001.nii.gz,0.8758025199986267,2.463322151184082,7.290438285827636
513,0.0,0,156,0.0,52159844,0,156,0,/well/papiez/users/hri611/python/nnUNet_results/Dataset219_PETCT/nnUNetTrainer_1500epochs__nnUNetPlans__3d_fullres/crossval_results_folds_0_1_2_3_4/PETCT_9860ffe82d_11192004.nii.gz,/well/papiez/users/hri611/python/nnUnet_raw/Dataset219_PETCT/labelsTr/PETCT_9860ffe82d_11192004.nii.gz,0.0,1.9407992706298827,0.0
514,0.6182495344506518,34,376,0.4474393530997305,52159258,332,708,366,/well/papiez/users/hri611/python/nnUNet_results/Dataset219_PETCT/nnUNetTrainer_1500epochs__nnUNetPlans__3d_fullres/crossval_results_folds_0_1_2_3_4/PETCT_987c8a1160_01222005.nii.gz,/well/papiez/users/hri611/python/nnUnet_raw/Dataset219_PETCT/labelsTr/PETCT_987c8a1160_01222005.nii.gz,0.6182495344506518,4.5907367362976075,0.0
515,0.9289085665542873,7050,1701,0.8672542208333965,45374077,57172,58873,64222,/well/papiez/users/hri611/python/nnUNet_results/Dataset219_PETCT/nnUNetTrainer_1500epochs__nnUNetPlans__3d_fullres/crossval_results_folds_0_1_2_3_4/PETCT_98c6af8b90_05262003.nii.gz,/well/papiez/users/hri611/python/nnUnet_raw/Dataset219_PETCT/labelsTr/PETCT_98c6af8b90_05262003.nii.gz,0.9289085665542873,0.6469330902099609,0.0
516,0.0,0,459,0.0,52159541,0,459,0,/well/papiez/users/hri611/python/nnUNet_results/Dataset219_PETCT/nnUNetTrainer_1500epochs__nnUNetPlans__3d_fullres/crossval_results_folds_0_1_2_3_4/PETCT_98cd91d44e_09062003.nii.gz,/well/papiez/users/hri611/python/nnUnet_raw/Dataset219_PETCT/labelsTr/PETCT_98cd91d44e_09062003.nii.gz,0.0,5.710428623199463,0.0
517,0.0,0,313,0.0,58879687,0,313,0,/well/papiez/users/hri611/python/nnUNet_results/Dataset219_PETCT/nnUNetTrainer_1500epochs__nnUNetPlans__3d_fullres/crossval_results_folds_0_1_2_3_4/PETCT_9902caa7ec_08132006.nii.gz,/well/papiez/users/hri611/python/nnUnet_raw/Dataset219_PETCT/labelsTr/PETCT_9902caa7ec_08132006.nii.gz,0.0,3.8940395622253416,0.0
518,0.0,0,4916,0.0,94235084,0,4916,0,/well/papiez/users/hri611/python/nnUNet_results/Dataset219_PETCT/nnUNetTrainer_1500epochs__nnUNetPlans__3d_fullres/crossval_results_folds_0_1_2_3_4/PETCT_993d40ea7e_12252005.nii.gz,/well/papiez/users/hri611/python/nnUnet_raw/Dataset219_PETCT/labelsTr/PETCT_993d40ea7e_12252005.nii.gz,0.0,61.16005906677246,0.0
519,0.0,0,239,0.0,47359761,0,239,0,/well/papiez/users/hri611/python/nnUNet_results/Dataset219_PETCT/nnUNetTrainer_1500epochs__nnUNetPlans__3d_fullres/crossval_results_folds_0_1_2_3_4/PETCT_997d4ef9a7_07222005.nii.gz,/well/papiez/users/hri611/python/nnUnet_raw/Dataset219_PETCT/labelsTr/PETCT_997d4ef9a7_07222005.nii.gz,0.0,2.973404010772705,0.0
520,0.7465352704277686,8776,13189,0.5955774046251289,45385688,32347,45536,41123,/well/papiez/users/hri611/python/nnUNet_results/Dataset219_PETCT/nnUNetTrainer_1500epochs__nnUNetPlans__3d_fullres/crossval_results_folds_0_1_2_3_4/PETCT_99a7bfad23_08262000.nii.gz,/well/papiez/users/hri611/python/nnUnet_raw/Dataset219_PETCT/labelsTr/PETCT_99a7bfad23_08262000.nii.gz,0.7465352704277686,2.8116707382202146,0.0
521,,0,0,,48160000,0,0,0,/well/papiez/users/hri611/python/nnUNet_results/Dataset219_PETCT/nnUNetTrainer_1500epochs__nnUNetPlans__3d_fullres/crossval_results_folds_0_1_2_3_4/PETCT_9a2bfe901f_08062005.nii.gz,/well/papiez/users/hri611/python/nnUnet_raw/Dataset219_PETCT/labelsTr/PETCT_9a2bfe901f_08062005.nii.gz,,0.0,0.0
522,0.8361777627576884,252,3626,0.718475499092559,45426225,9897,13523,10149,/well/papiez/users/hri611/python/nnUNet_results/Dataset219_PETCT/nnUNetTrainer_1500epochs__nnUNetPlans__3d_fullres/crossval_results_folds_0_1_2_3_4/PETCT_9a2c6e618a_02142000.nii.gz,/well/papiez/users/hri611/python/nnUnet_raw/Dataset219_PETCT/labelsTr/PETCT_9a2c6e618a_02142000.nii.gz,0.8361777627576884,0.9081945304870606,0.012441020965576172
523,,0,0,,45440000,0,0,0,/well/papiez/users/hri611/python/nnUNet_results/Dataset219_PETCT/nnUNetTrainer_1500epochs__nnUNetPlans__3d_fullres/crossval_results_folds_0_1_2_3_4/PETCT_9a418f3b3a_05112003.nii.gz,/well/papiez/users/hri611/python/nnUnet_raw/Dataset219_PETCT/labelsTr/PETCT_9a418f3b3a_05112003.nii.gz,,0.0,0.0
524,0.9398666092943201,209,909,0.8865550481988839,53590145,8737,9646,8946,/well/papiez/users/hri611/python/nnUNet_results/Dataset219_PETCT/nnUNetTrainer_1500epochs__nnUNetPlans__3d_fullres/crossval_results_folds_0_1_2_3_4/PETCT_9a583160ea_06212007.nii.gz,/well/papiez/users/hri611/python/nnUnet_raw/Dataset219_PETCT/labelsTr/PETCT_9a583160ea_06212007.nii.gz,0.9398666092943201,2.5006452140808104,0.2861434822082519
525,0.0,0,4111,0.0,52155889,0,4111,0,/well/papiez/users/hri611/python/nnUNet_results/Dataset219_PETCT/nnUNetTrainer_1500epochs__nnUNetPlans__3d_fullres/crossval_results_folds_0_1_2_3_4/PETCT_9a66a81ad1_02262005.nii.gz,/well/papiez/users/hri611/python/nnUnet_raw/Dataset219_PETCT/labelsTr/PETCT_9a66a81ad1_02262005.nii.gz,0.0,51.145037189483645,0.0
526,0.0,0,379,0.0,51679621,0,379,0,/well/papiez/users/hri611/python/nnUNet_results/Dataset219_PETCT/nnUNetTrainer_1500epochs__nnUNetPlans__3d_fullres/crossval_results_folds_0_1_2_3_4/PETCT_9a66a81ad1_05132006.nii.gz,/well/papiez/users/hri611/python/nnUnet_raw/Dataset219_PETCT/labelsTr/PETCT_9a66a81ad1_05132006.nii.gz,0.0,4.715146945953369,0.0
527,0.0,0,36,0.0,52959964,0,36,0,/well/papiez/users/hri611/python/nnUNet_results/Dataset219_PETCT/nnUNetTrainer_1500epochs__nnUNetPlans__3d_fullres/crossval_results_folds_0_1_2_3_4/PETCT_9a66a81ad1_10212005.nii.gz,/well/papiez/users/hri611/python/nnUnet_raw/Dataset219_PETCT/labelsTr/PETCT_9a66a81ad1_10212005.nii.gz,0.0,0.4478767547607422,0.0
528,0.0,0,417,0.0,105759583,0,417,0,/well/papiez/users/hri611/python/nnUNet_results/Dataset219_PETCT/nnUNetTrainer_1500epochs__nnUNetPlans__3d_fullres/crossval_results_folds_0_1_2_3_4/PETCT_9a66a81ad1_10312004.nii.gz,/well/papiez/users/hri611/python/nnUnet_raw/Dataset219_PETCT/labelsTr/PETCT_9a66a81ad1_10312004.nii.gz,0.0,5.187905742645263,0.0
529,0.0,0,351,0.0,52159649,0,351,0,/well/papiez/users/hri611/python/nnUNet_results/Dataset219_PETCT/nnUNetTrainer_1500epochs__nnUNetPlans__3d_fullres/crossval_results_folds_0_1_2_3_4/PETCT_9a83943958_08032003.nii.gz,/well/papiez/users/hri611/python/nnUnet_raw/Dataset219_PETCT/labelsTr/PETCT_9a83943958_08032003.nii.gz,0.0,4.3667983589172366,0.0
530,0.7577435030635961,6178,5288,0.6099734675828288,52130602,17932,23220,24110,/well/papiez/users/hri611/python/nnUNet_results/Dataset219_PETCT/nnUNetTrainer_1500epochs__nnUNetPlans__3d_fullres/crossval_results_folds_0_1_2_3_4/PETCT_9aa97cf103_07182004.nii.gz,/well/papiez/users/hri611/python/nnUnet_raw/Dataset219_PETCT/labelsTr/PETCT_9aa97cf103_07182004.nii.gz,0.7577435030635961,31.26428568649292,1.0574867820739746
531,0.7970149253731343,83,189,0.6625310173697271,52159194,534,723,617,/well/papiez/users/hri611/python/nnUNet_results/Dataset219_PETCT/nnUNetTrainer_1500epochs__nnUNetPlans__3d_fullres/crossval_results_folds_0_1_2_3_4/PETCT_9abb9583ec_05302002.nii.gz,/well/papiez/users/hri611/python/nnUnet_raw/Dataset219_PETCT/labelsTr/PETCT_9abb9583ec_05302002.nii.gz,0.7970149253731343,0.26126144027709963,0.0
532,0.0,0,259,0.0,52159741,0,259,0,/well/papiez/users/hri611/python/nnUNet_results/Dataset219_PETCT/nnUNetTrainer_1500epochs__nnUNetPlans__3d_fullres/crossval_results_folds_0_1_2_3_4/PETCT_9ad7dffae6_05222003.nii.gz,/well/papiez/users/hri611/python/nnUnet_raw/Dataset219_PETCT/labelsTr/PETCT_9ad7dffae6_05222003.nii.gz,0.0,3.2222244300842284,0.0
533,0.8214455848599022,9288,3081,0.6969941941647682,52119179,28452,31533,37740,/well/papiez/users/hri611/python/nnUNet_results/Dataset219_PETCT/nnUNetTrainer_1500epochs__nnUNetPlans__3d_fullres/crossval_results_folds_0_1_2_3_4/PETCT_9afd440677_03172003.nii.gz,/well/papiez/users/hri611/python/nnUnet_raw/Dataset219_PETCT/labelsTr/PETCT_9afd440677_03172003.nii.gz,0.8214455848599022,0.0,36.626365722656246
534,,0,0,,52160000,0,0,0,/well/papiez/users/hri611/python/nnUNet_results/Dataset219_PETCT/nnUNetTrainer_1500epochs__nnUNetPlans__3d_fullres/crossval_results_folds_0_1_2_3_4/PETCT_9b1bb2165a_10132002.nii.gz,/well/papiez/users/hri611/python/nnUnet_raw/Dataset219_PETCT/labelsTr/PETCT_9b1bb2165a_10132002.nii.gz,,0.0,0.0
535,0.8622761177363885,11096,1238,0.7578957699479831,45389055,38611,39849,49707,/well/papiez/users/hri611/python/nnUNet_results/Dataset219_PETCT/nnUNetTrainer_1500epochs__nnUNetPlans__3d_fullres/crossval_results_folds_0_1_2_3_4/PETCT_9b982e72cb_09152001.nii.gz,/well/papiez/users/hri611/python/nnUnet_raw/Dataset219_PETCT/labelsTr/PETCT_9b982e72cb_09152001.nii.gz,0.8622761177363885,2.8365527801513672,6.892325614929199
536,0.0,0,246,0.0,45439754,0,246,0,/well/papiez/users/hri611/python/nnUNet_results/Dataset219_PETCT/nnUNetTrainer_1500epochs__nnUNetPlans__3d_fullres/crossval_results_folds_0_1_2_3_4/PETCT_9b9d67b3ff_07122003.nii.gz,/well/papiez/users/hri611/python/nnUnet_raw/Dataset219_PETCT/labelsTr/PETCT_9b9d67b3ff_07122003.nii.gz,0.0,3.060491157531738,0.0
537,,0,0,,54720000,0,0,0,/well/papiez/users/hri611/python/nnUNet_results/Dataset219_PETCT/nnUNetTrainer_1500epochs__nnUNetPlans__3d_fullres/crossval_results_folds_0_1_2_3_4/PETCT_9c36b318e8_11042006.nii.gz,/well/papiez/users/hri611/python/nnUnet_raw/Dataset219_PETCT/labelsTr/PETCT_9c36b318e8_11042006.nii.gz,,0.0,0.0
538,0.0,0,56,0.0,99039944,0,56,0,/well/papiez/users/hri611/python/nnUNet_results/Dataset219_PETCT/nnUNetTrainer_1500epochs__nnUNetPlans__3d_fullres/crossval_results_folds_0_1_2_3_4/PETCT_9c68e484a7_08142003.nii.gz,/well/papiez/users/hri611/python/nnUnet_raw/Dataset219_PETCT/labelsTr/PETCT_9c68e484a7_08142003.nii.gz,0.0,0.6966971740722656,0.0
539,0.9086313042769193,125,2116,0.8325612671846981,45426616,11143,13259,11268,/well/papiez/users/hri611/python/nnUNet_results/Dataset219_PETCT/nnUNetTrainer_1500epochs__nnUNetPlans__3d_fullres/crossval_results_folds_0_1_2_3_4/PETCT_9c8842d12e_01252004.nii.gz,/well/papiez/users/hri611/python/nnUnet_raw/Dataset219_PETCT/labelsTr/PETCT_9c8842d12e_01252004.nii.gz,0.9086313042769193,1.8661531448364257,0.04976408386230469
540,0.7077801216031766,4492,218,0.5477242173996543,52149586,5704,5922,10196,/well/papiez/users/hri611/python/nnUNet_results/Dataset219_PETCT/nnUNetTrainer_1500epochs__nnUNetPlans__3d_fullres/crossval_results_folds_0_1_2_3_4/PETCT_9c9a347388_09092000.nii.gz,/well/papiez/users/hri611/python/nnUnet_raw/Dataset219_PETCT/labelsTr/PETCT_9c9a347388_09092000.nii.gz,0.7077801216031766,0.0,11.694559707641602
541,0.0,0,4,0.0,52159996,0,4,0,/well/papiez/users/hri611/python/nnUNet_results/Dataset219_PETCT/nnUNetTrainer_1500epochs__nnUNetPlans__3d_fullres/crossval_results_folds_0_1_2_3_4/PETCT_9d6e9223cc_11162002.nii.gz,/well/papiez/users/hri611/python/nnUnet_raw/Dataset219_PETCT/labelsTr/PETCT_9d6e9223cc_11162002.nii.gz,0.0,0.04976408386230469,0.0
542,0.0,0,1168,0.0,52158832,0,1168,0,/well/papiez/users/hri611/python/nnUNet_results/Dataset219_PETCT/nnUNetTrainer_1500epochs__nnUNetPlans__3d_fullres/crossval_results_folds_0_1_2_3_4/PETCT_9d97ac5d4d_12122004.nii.gz,/well/papiez/users/hri611/python/nnUnet_raw/Dataset219_PETCT/labelsTr/PETCT_9d97ac5d4d_12122004.nii.gz,0.0,14.531112487792969,0.0
543,0.4726553756621652,13888,248,0.309462165990914,52139529,6335,6583,20223,/well/papiez/users/hri611/python/nnUNet_results/Dataset219_PETCT/nnUNetTrainer_1500epochs__nnUNetPlans__3d_fullres/crossval_results_folds_0_1_2_3_4/PETCT_9da159b835_03232002.nii.gz,/well/papiez/users/hri611/python/nnUnet_raw/Dataset219_PETCT/labelsTr/PETCT_9da159b835_03232002.nii.gz,0.4726553756621652,0.0,74.73321294021606
544,0.0,0,2255,0.0,52157745,0,2255,0,/well/papiez/users/hri611/python/nnUNet_results/Dataset219_PETCT/nnUNetTrainer_1500epochs__nnUNetPlans__3d_fullres/crossval_results_folds_0_1_2_3_4/PETCT_9e864bb710_09142003.nii.gz,/well/papiez/users/hri611/python/nnUnet_raw/Dataset219_PETCT/labelsTr/PETCT_9e864bb710_09142003.nii.gz,0.0,28.05450227737427,0.0
545,0.9510932781269675,2612,1971,0.9067472429088838,52110854,44563,46534,47175,/well/papiez/users/hri611/python/nnUNet_results/Dataset219_PETCT/nnUNetTrainer_1500epochs__nnUNetPlans__3d_fullres/crossval_results_folds_0_1_2_3_4/PETCT_9f206193d3_04072003.nii.gz,/well/papiez/users/hri611/python/nnUnet_raw/Dataset219_PETCT/labelsTr/PETCT_9f206193d3_04072003.nii.gz,0.9510932781269675,1.1818969917297364,0.796225341796875
546,0.0,0,15,0.0,52159985,0,15,0,/well/papiez/users/hri611/python/nnUNet_results/Dataset219_PETCT/nnUNetTrainer_1500epochs__nnUNetPlans__3d_fullres/crossval_results_folds_0_1_2_3_4/PETCT_9f206193d3_08042003.nii.gz,/well/papiez/users/hri611/python/nnUnet_raw/Dataset219_PETCT/labelsTr/PETCT_9f206193d3_08042003.nii.gz,0.0,0.18661531448364257,0.0
547,,0,0,,48160000,0,0,0,/well/papiez/users/hri611/python/nnUNet_results/Dataset219_PETCT/nnUNetTrainer_1500epochs__nnUNetPlans__3d_fullres/crossval_results_folds_0_1_2_3_4/PETCT_9f491f1481_02122006.nii.gz,/well/papiez/users/hri611/python/nnUnet_raw/Dataset219_PETCT/labelsTr/PETCT_9f491f1481_02122006.nii.gz,,0.0,0.0
548,,0,0,,52160000,0,0,0,/well/papiez/users/hri611/python/nnUNet_results/Dataset219_PETCT/nnUNetTrainer_1500epochs__nnUNetPlans__3d_fullres/crossval_results_folds_0_1_2_3_4/PETCT_9f6e8b1b43_11162002.nii.gz,/well/papiez/users/hri611/python/nnUnet_raw/Dataset219_PETCT/labelsTr/PETCT_9f6e8b1b43_11162002.nii.gz,,0.0,0.0
549,0.8300970873786407,39,31,0.7095435684647303,52159759,171,202,210,/well/papiez/users/hri611/python/nnUNet_results/Dataset219_PETCT/nnUNetTrainer_1500epochs__nnUNetPlans__3d_fullres/crossval_results_folds_0_1_2_3_4/PETCT_9f7c68f5ca_12212001.nii.gz,/well/papiez/users/hri611/python/nnUnet_raw/Dataset219_PETCT/labelsTr/PETCT_9f7c68f5ca_12212001.nii.gz,0.8300970873786407,0.0,0.0
550,0.8597979797979798,305,42,0.7540751240255138,49758589,1064,1106,1369,/well/papiez/users/hri611/python/nnUNet_results/Dataset219_PETCT/nnUNetTrainer_1500epochs__nnUNetPlans__3d_fullres/crossval_results_folds_0_1_2_3_4/PETCT_9ffd8409b3_07152005.nii.gz,/well/papiez/users/hri611/python/nnUnet_raw/Dataset219_PETCT/labelsTr/PETCT_9ffd8409b3_07152005.nii.gz,0.8597979797979798,0.3110255241394043,1.5426865997314452
551,0.0,0,19,0.0,51039981,0,19,0,/well/papiez/users/hri611/python/nnUNet_results/Dataset219_PETCT/nnUNetTrainer_1500epochs__nnUNetPlans__3d_fullres/crossval_results_folds_0_1_2_3_4/PETCT_a09210d96b_12112005.nii.gz,/well/papiez/users/hri611/python/nnUnet_raw/Dataset219_PETCT/labelsTr/PETCT_a09210d96b_12112005.nii.gz,0.0,0.23637939834594726,0.0
552,0.9354944156905476,797,1571,0.8788064895849327,52140461,17171,18742,17968,/well/papiez/users/hri611/python/nnUNet_results/Dataset219_PETCT/nnUNetTrainer_1500epochs__nnUNetPlans__3d_fullres/crossval_results_folds_0_1_2_3_4/PETCT_a0c4dc1ef1_01192003.nii.gz,/well/papiez/users/hri611/python/nnUnet_raw/Dataset219_PETCT/labelsTr/PETCT_a0c4dc1ef1_01192003.nii.gz,0.9354944156905476,1.0326047401428222,3.6576601638793944
553,,0,0,,47200000,0,0,0,/well/papiez/users/hri611/python/nnUNet_results/Dataset219_PETCT/nnUNetTrainer_1500epochs__nnUNetPlans__3d_fullres/crossval_results_folds_0_1_2_3_4/PETCT_a19c2a0c65_03052006.nii.gz,/well/papiez/users/hri611/python/nnUnet_raw/Dataset219_PETCT/labelsTr/PETCT_a19c2a0c65_03052006.nii.gz,,0.0,0.0
554,0.5422117200131152,78877,2103,0.37194133569107396,52031063,47957,50060,126834,/well/papiez/users/hri611/python/nnUNet_results/Dataset219_PETCT/nnUNetTrainer_1500epochs__nnUNetPlans__3d_fullres/crossval_results_folds_0_1_2_3_4/PETCT_a19ef8e0d2_12261999.nii.gz,/well/papiez/users/hri611/python/nnUnet_raw/Dataset219_PETCT/labelsTr/PETCT_a19ef8e0d2_12261999.nii.gz,0.5422117200131152,0.9952816772460937,2.251824794769287
555,0.9340232858990944,8,43,0.8762135922330098,105759588,361,404,369,/well/papiez/users/hri611/python/nnUNet_results/Dataset219_PETCT/nnUNetTrainer_1500epochs__nnUNetPlans__3d_fullres/crossval_results_folds_0_1_2_3_4/PETCT_a1bc00ad60_03062003.nii.gz,/well/papiez/users/hri611/python/nnUnet_raw/Dataset219_PETCT/labelsTr/PETCT_a1bc00ad60_03062003.nii.gz,0.9340232858990944,0.0,0.024882041931152343
556,0.0,0,59,0.0,104479941,0,59,0,/well/papiez/users/hri611/python/nnUNet_results/Dataset219_PETCT/nnUNetTrainer_1500epochs__nnUNetPlans__3d_fullres/crossval_results_folds_0_1_2_3_4/PETCT_a1bc00ad60_08102006.nii.gz,/well/papiez/users/hri611/python/nnUnet_raw/Dataset219_PETCT/labelsTr/PETCT_a1bc00ad60_08102006.nii.gz,0.0,0.7340202369689941,0.0
557,0.0,0,11346,0.0,85588654,0,11346,0,/well/papiez/users/hri611/python/nnUNet_results/Dataset219_PETCT/nnUNetTrainer_1500epochs__nnUNetPlans__3d_fullres/crossval_results_folds_0_1_2_3_4/PETCT_a1d93ebc74_09012003.nii.gz,/well/papiez/users/hri611/python/nnUnet_raw/Dataset219_PETCT/labelsTr/PETCT_a1d93ebc74_09012003.nii.gz,0.0,141.15582387542725,0.0
558,0.9304029304029304,107,7,0.8698630136986302,52159124,762,769,869,/well/papiez/users/hri611/python/nnUNet_results/Dataset219_PETCT/nnUNetTrainer_1500epochs__nnUNetPlans__3d_fullres/crossval_results_folds_0_1_2_3_4/PETCT_a1db71e797_03252005.nii.gz,/well/papiez/users/hri611/python/nnUnet_raw/Dataset219_PETCT/labelsTr/PETCT_a1db71e797_03252005.nii.gz,0.9304029304029304,0.037323062896728515,0.0
559,,0,0,,72160000,0,0,0,/well/papiez/users/hri611/python/nnUNet_results/Dataset219_PETCT/nnUNetTrainer_1500epochs__nnUNetPlans__3d_fullres/crossval_results_folds_0_1_2_3_4/PETCT_a21200dcba_03102005.nii.gz,/well/papiez/users/hri611/python/nnUnet_raw/Dataset219_PETCT/labelsTr/PETCT_a21200dcba_03102005.nii.gz,,0.0,0.0
560,0.0,0,9,0.0,91679991,0,9,0,/well/papiez/users/hri611/python/nnUNet_results/Dataset219_PETCT/nnUNetTrainer_1500epochs__nnUNetPlans__3d_fullres/crossval_results_folds_0_1_2_3_4/PETCT_a22ec7f62b_06302007.nii.gz,/well/papiez/users/hri611/python/nnUnet_raw/Dataset219_PETCT/labelsTr/PETCT_a22ec7f62b_06302007.nii.gz,0.0,0.11196918869018554,0.0
561,0.0,0,3394,0.0,52156606,0,3394,0,/well/papiez/users/hri611/python/nnUNet_results/Dataset219_PETCT/nnUNetTrainer_1500epochs__nnUNetPlans__3d_fullres/crossval_results_folds_0_1_2_3_4/PETCT_a25083ff81_08282003.nii.gz,/well/papiez/users/hri611/python/nnUnet_raw/Dataset219_PETCT/labelsTr/PETCT_a25083ff81_08282003.nii.gz,0.0,42.224825157165526,0.0
562,0.0,0,12,0.0,72159988,0,12,0,/well/papiez/users/hri611/python/nnUNet_results/Dataset219_PETCT/nnUNetTrainer_1500epochs__nnUNetPlans__3d_fullres/crossval_results_folds_0_1_2_3_4/PETCT_a2676f03c0_05092003.nii.gz,/well/papiez/users/hri611/python/nnUnet_raw/Dataset219_PETCT/labelsTr/PETCT_a2676f03c0_05092003.nii.gz,0.0,0.14929225158691406,0.0
563,,0,0,,48480000,0,0,0,/well/papiez/users/hri611/python/nnUNet_results/Dataset219_PETCT/nnUNetTrainer_1500epochs__nnUNetPlans__3d_fullres/crossval_results_folds_0_1_2_3_4/PETCT_a29cae0316_06292006.nii.gz,/well/papiez/users/hri611/python/nnUnet_raw/Dataset219_PETCT/labelsTr/PETCT_a29cae0316_06292006.nii.gz,,0.0,0.0
564,0.9551422319474836,41,41,0.9141361256544502,52159045,873,914,914,/well/papiez/users/hri611/python/nnUNet_results/Dataset219_PETCT/nnUNetTrainer_1500epochs__nnUNetPlans__3d_fullres/crossval_results_folds_0_1_2_3_4/PETCT_a2a68bbe97_08212003.nii.gz,/well/papiez/users/hri611/python/nnUnet_raw/Dataset219_PETCT/labelsTr/PETCT_a2a68bbe97_08212003.nii.gz,0.9551422319474836,0.012441020965576172,0.0
565,0.0,0,1665,0.0,52158335,0,1665,0,/well/papiez/users/hri611/python/nnUNet_results/Dataset219_PETCT/nnUNetTrainer_1500epochs__nnUNetPlans__3d_fullres/crossval_results_folds_0_1_2_3_4/PETCT_a37b4bca43_06232002.nii.gz,/well/papiez/users/hri611/python/nnUnet_raw/Dataset219_PETCT/labelsTr/PETCT_a37b4bca43_06232002.nii.gz,0.0,20.714299907684325,0.0
566,0.0,0,5113,0.0,45434887,0,5113,0,/well/papiez/users/hri611/python/nnUNet_results/Dataset219_PETCT/nnUNetTrainer_1500epochs__nnUNetPlans__3d_fullres/crossval_results_folds_0_1_2_3_4/PETCT_a37c4e231f_12132002.nii.gz,/well/papiez/users/hri611/python/nnUnet_raw/Dataset219_PETCT/labelsTr/PETCT_a37c4e231f_12132002.nii.gz,0.0,63.61094019699097,0.0
567,0.8917222880668705,7940,739,0.8046018416372109,45395583,35738,36477,43678,/well/papiez/users/hri611/python/nnUNet_results/Dataset219_PETCT/nnUNetTrainer_1500epochs__nnUNetPlans__3d_fullres/crossval_results_folds_0_1_2_3_4/PETCT_a37da9e85d_03022002.nii.gz,/well/papiez/users/hri611/python/nnUnet_raw/Dataset219_PETCT/labelsTr/PETCT_a37da9e85d_03022002.nii.gz,0.8917222880668705,0.0,6.95453071975708
568,0.8735556015738248,5579,527,0.7754981983969409,52132802,21092,21619,26671,/well/papiez/users/hri611/python/nnUNet_results/Dataset219_PETCT/nnUNetTrainer_1500epochs__nnUNetPlans__3d_fullres/crossval_results_folds_0_1_2_3_4/PETCT_a3df01d3a3_10052002.nii.gz,/well/papiez/users/hri611/python/nnUnet_raw/Dataset219_PETCT/labelsTr/PETCT_a3df01d3a3_10052002.nii.gz,0.8735556015738248,0.4478767547607422,6.170746398925781
569,0.40452907874420996,594,4034,0.2535483870967742,52153800,1572,5606,2166,/well/papiez/users/hri611/python/nnUNet_results/Dataset219_PETCT/nnUNetTrainer_1500epochs__nnUNetPlans__3d_fullres/crossval_results_folds_0_1_2_3_4/PETCT_a471649d35_05062002.nii.gz,/well/papiez/users/hri611/python/nnUnet_raw/Dataset219_PETCT/labelsTr/PETCT_a471649d35_05062002.nii.gz,0.40452907874420996,49.00518158340454,0.6469330902099609
570,0.0,0,26,0.0,49119974,0,26,0,/well/papiez/users/hri611/python/nnUNet_results/Dataset219_PETCT/nnUNetTrainer_1500epochs__nnUNetPlans__3d_fullres/crossval_results_folds_0_1_2_3_4/PETCT_a4a66c4fa7_07072006.nii.gz,/well/papiez/users/hri611/python/nnUnet_raw/Dataset219_PETCT/labelsTr/PETCT_a4a66c4fa7_07072006.nii.gz,0.0,0.32346654510498046,0.0
571,0.0,0,794,0.0,49119206,0,794,0,/well/papiez/users/hri611/python/nnUNet_results/Dataset219_PETCT/nnUNetTrainer_1500epochs__nnUNetPlans__3d_fullres/crossval_results_folds_0_1_2_3_4/PETCT_a4cb97ffc7_07112005.nii.gz,/well/papiez/users/hri611/python/nnUnet_raw/Dataset219_PETCT/labelsTr/PETCT_a4cb97ffc7_07112005.nii.gz,0.0,9.87817064666748,0.0
572,0.0,0,21765,0.0,45418235,0,21765,0,/well/papiez/users/hri611/python/nnUNet_results/Dataset219_PETCT/nnUNetTrainer_1500epochs__nnUNetPlans__3d_fullres/crossval_results_folds_0_1_2_3_4/PETCT_a4ccc397a9_11302002.nii.gz,/well/papiez/users/hri611/python/nnUnet_raw/Dataset219_PETCT/labelsTr/PETCT_a4ccc397a9_11302002.nii.gz,0.0,270.77882131576536,0.0
573,0.0,0,103,0.0,50879897,0,103,0,/well/papiez/users/hri611/python/nnUNet_results/Dataset219_PETCT/nnUNetTrainer_1500epochs__nnUNetPlans__3d_fullres/crossval_results_folds_0_1_2_3_4/PETCT_a4cd2b10de_10152005.nii.gz,/well/papiez/users/hri611/python/nnUnet_raw/Dataset219_PETCT/labelsTr/PETCT_a4cd2b10de_10152005.nii.gz,0.0,1.2814251594543458,0.0
574,0.0,0,49,0.0,53119951,0,49,0,/well/papiez/users/hri611/python/nnUNet_results/Dataset219_PETCT/nnUNetTrainer_1500epochs__nnUNetPlans__3d_fullres/crossval_results_folds_0_1_2_3_4/PETCT_a4cd2b10de_10152006.nii.gz,/well/papiez/users/hri611/python/nnUnet_raw/Dataset219_PETCT/labelsTr/PETCT_a4cd2b10de_10152006.nii.gz,0.0,0.6096100273132324,0.0
575,0.7738287560581584,185,95,0.6310935441370223,58879241,479,574,664,/well/papiez/users/hri611/python/nnUNet_results/Dataset219_PETCT/nnUNetTrainer_1500epochs__nnUNetPlans__3d_fullres/crossval_results_folds_0_1_2_3_4/PETCT_a4cd2b10de_12292001.nii.gz,/well/papiez/users/hri611/python/nnUnet_raw/Dataset219_PETCT/labelsTr/PETCT_a4cd2b10de_12292001.nii.gz,0.7738287560581584,0.6718151321411132,0.09952816772460937
576,0.5728679794651751,6034,16264,0.40141204262972807,85722749,14953,31217,20987,/well/papiez/users/hri611/python/nnUNet_results/Dataset219_PETCT/nnUNetTrainer_1500epochs__nnUNetPlans__3d_fullres/crossval_results_folds_0_1_2_3_4/PETCT_a4ff5d0d9d_05302005.nii.gz,/well/papiez/users/hri611/python/nnUnet_raw/Dataset219_PETCT/labelsTr/PETCT_a4ff5d0d9d_05302005.nii.gz,0.5728679794651751,115.19141312026977,32.035628986358645
577,0.0,0,46,0.0,52159954,0,46,0,/well/papiez/users/hri611/python/nnUNet_results/Dataset219_PETCT/nnUNetTrainer_1500epochs__nnUNetPlans__3d_fullres/crossval_results_folds_0_1_2_3_4/PETCT_a57bd6b006_11092002.nii.gz,/well/papiez/users/hri611/python/nnUnet_raw/Dataset219_PETCT/labelsTr/PETCT_a57bd6b006_11092002.nii.gz,0.0,0.5722869644165038,0.0
578,0.9427050053248136,317,1028,0.8916196615632555,92307590,11065,12093,11382,/well/papiez/users/hri611/python/nnUNet_results/Dataset219_PETCT/nnUNetTrainer_1500epochs__nnUNetPlans__3d_fullres/crossval_results_folds_0_1_2_3_4/PETCT_a61d8768d0_03262004.nii.gz,/well/papiez/users/hri611/python/nnUnet_raw/Dataset219_PETCT/labelsTr/PETCT_a61d8768d0_03262004.nii.gz,0.9427050053248136,2.264265815734863,0.3981126708984375
579,0.0,0,3700,0.0,52156300,0,3700,0,/well/papiez/users/hri611/python/nnUNet_results/Dataset219_PETCT/nnUNetTrainer_1500epochs__nnUNetPlans__3d_fullres/crossval_results_folds_0_1_2_3_4/PETCT_a627fc68a1_02142003.nii.gz,/well/papiez/users/hri611/python/nnUnet_raw/Dataset219_PETCT/labelsTr/PETCT_a627fc68a1_02142003.nii.gz,0.0,46.03177757263183,0.0
580,0.2556179775280899,0,1060,0.14653784219001612,99038758,182,1242,182,/well/papiez/users/hri611/python/nnUNet_results/Dataset219_PETCT/nnUNetTrainer_1500epochs__nnUNetPlans__3d_fullres/crossval_results_folds_0_1_2_3_4/PETCT_a86b2dc6ce_10142002.nii.gz,/well/papiez/users/hri611/python/nnUnet_raw/Dataset219_PETCT/labelsTr/PETCT_a86b2dc6ce_10142002.nii.gz,0.2556179775280899,10.94809844970703,0.0
581,0.8837209302325582,17,1083,0.7916666666666666,99034720,4180,5263,4197,/well/papiez/users/hri611/python/nnUNet_results/Dataset219_PETCT/nnUNetTrainer_1500epochs__nnUNetPlans__3d_fullres/crossval_results_folds_0_1_2_3_4/PETCT_a86b3fad40_07182003.nii.gz,/well/papiez/users/hri611/python/nnUnet_raw/Dataset219_PETCT/labelsTr/PETCT_a86b3fad40_07182003.nii.gz,0.8837209302325582,0.4105536918640137,0.0
582,,0,0,,45440000,0,0,0,/well/papiez/users/hri611/python/nnUNet_results/Dataset219_PETCT/nnUNetTrainer_1500epochs__nnUNetPlans__3d_fullres/crossval_results_folds_0_1_2_3_4/PETCT_a87dda9193_01262003.nii.gz,/well/papiez/users/hri611/python/nnUnet_raw/Dataset219_PETCT/labelsTr/PETCT_a87dda9193_01262003.nii.gz,,0.0,0.0
583,0.0,0,226,0.0,52159774,0,226,0,/well/papiez/users/hri611/python/nnUNet_results/Dataset219_PETCT/nnUNetTrainer_1500epochs__nnUNetPlans__3d_fullres/crossval_results_folds_0_1_2_3_4/PETCT_a8a5e96821_03112005.nii.gz,/well/papiez/users/hri611/python/nnUnet_raw/Dataset219_PETCT/labelsTr/PETCT_a8a5e96821_03112005.nii.gz,0.0,2.8116707382202146,0.0
584,0.0,0,160,0.0,46719840,0,160,0,/well/papiez/users/hri611/python/nnUNet_results/Dataset219_PETCT/nnUNetTrainer_1500epochs__nnUNetPlans__3d_fullres/crossval_results_folds_0_1_2_3_4/PETCT_a8a5e96821_09302005.nii.gz,/well/papiez/users/hri611/python/nnUnet_raw/Dataset219_PETCT/labelsTr/PETCT_a8a5e96821_09302005.nii.gz,0.0,1.9905633544921875,0.0
585,0.0,0,326,0.0,52159674,0,326,0,/well/papiez/users/hri611/python/nnUNet_results/Dataset219_PETCT/nnUNetTrainer_1500epochs__nnUNetPlans__3d_fullres/crossval_results_folds_0_1_2_3_4/PETCT_a90955352e_05162003.nii.gz,/well/papiez/users/hri611/python/nnUnet_raw/Dataset219_PETCT/labelsTr/PETCT_a90955352e_05162003.nii.gz,0.0,4.055772834777832,0.0
586,0.0,0,325,0.0,92319675,0,325,0,/well/papiez/users/hri611/python/nnUNet_results/Dataset219_PETCT/nnUNetTrainer_1500epochs__nnUNetPlans__3d_fullres/crossval_results_folds_0_1_2_3_4/PETCT_a933c9af60_09192002.nii.gz,/well/papiez/users/hri611/python/nnUnet_raw/Dataset219_PETCT/labelsTr/PETCT_a933c9af60_09192002.nii.gz,0.0,4.043331813812256,0.0
587,0.8321373220634776,185,12704,0.71253010973325,45395164,31947,44651,32132,/well/papiez/users/hri611/python/nnUNet_results/Dataset219_PETCT/nnUNetTrainer_1500epochs__nnUNetPlans__3d_fullres/crossval_results_folds_0_1_2_3_4/PETCT_aa27cb9156_12142003.nii.gz,/well/papiez/users/hri611/python/nnUnet_raw/Dataset219_PETCT/labelsTr/PETCT_aa27cb9156_12142003.nii.gz,0.8321373220634776,23.84943719100952,0.0
588,0.6739164946816955,3669,439,0.5082006464743206,45431647,4245,4684,7914,/well/papiez/users/hri611/python/nnUNet_results/Dataset219_PETCT/nnUNetTrainer_1500epochs__nnUNetPlans__3d_fullres/crossval_results_folds_0_1_2_3_4/PETCT_ab1fa26e5e_06232001.nii.gz,/well/papiez/users/hri611/python/nnUnet_raw/Dataset219_PETCT/labelsTr/PETCT_ab1fa26e5e_06232001.nii.gz,0.6739164946816955,0.3981126708984375,2.052768459320068
589,0.8537916539543713,1183,3130,0.7448834733230806,105743094,12593,15723,13776,/well/papiez/users/hri611/python/nnUNet_results/Dataset219_PETCT/nnUNetTrainer_1500epochs__nnUNetPlans__3d_fullres/crossval_results_folds_0_1_2_3_4/PETCT_ab953a5230_11032003.nii.gz,/well/papiez/users/hri611/python/nnUnet_raw/Dataset219_PETCT/labelsTr/PETCT_ab953a5230_11032003.nii.gz,0.8537916539543713,10.649513946533203,3.408839744567871
590,0.6696177364294557,8078,729,0.5033273178434469,45422268,8925,9654,17003,/well/papiez/users/hri611/python/nnUNet_results/Dataset219_PETCT/nnUNetTrainer_1500epochs__nnUNetPlans__3d_fullres/crossval_results_folds_0_1_2_3_4/PETCT_ac11b344b6_11032002.nii.gz,/well/papiez/users/hri611/python/nnUnet_raw/Dataset219_PETCT/labelsTr/PETCT_ac11b344b6_11032002.nii.gz,0.6696177364294557,0.0,0.0
591,0.0,0,1319,0.0,45438681,0,1319,0,/well/papiez/users/hri611/python/nnUNet_results/Dataset219_PETCT/nnUNetTrainer_1500epochs__nnUNetPlans__3d_fullres/crossval_results_folds_0_1_2_3_4/PETCT_ac700ab4db_12042004.nii.gz,/well/papiez/users/hri611/python/nnUnet_raw/Dataset219_PETCT/labelsTr/PETCT_ac700ab4db_12042004.nii.gz,0.0,16.40970665359497,0.0
592,0.12460732984293194,1819,6541,0.0664433277498604,45431045,595,7136,2414,/well/papiez/users/hri611/python/nnUNet_results/Dataset219_PETCT/nnUNetTrainer_1500epochs__nnUNetPlans__3d_fullres/crossval_results_folds_0_1_2_3_4/PETCT_ac75e49284_11132004.nii.gz,/well/papiez/users/hri611/python/nnUnet_raw/Dataset219_PETCT/labelsTr/PETCT_ac75e49284_11132004.nii.gz,0.12460732984293194,81.36427711486816,11.08494968032837
593,0.7802736995438341,6161,5303,0.6397121216882995,52128181,20355,25658,26516,/well/papiez/users/hri611/python/nnUNet_results/Dataset219_PETCT/nnUNetTrainer_1500epochs__nnUNetPlans__3d_fullres/crossval_results_folds_0_1_2_3_4/PETCT_ad7c6a4a58_03282003.nii.gz,/well/papiez/users/hri611/python/nnUnet_raw/Dataset219_PETCT/labelsTr/PETCT_ad7c6a4a58_03282003.nii.gz,0.7802736995438341,0.42299471282958984,5.635782497406006
594,0.7441882897656024,26547,5277,0.5925954374375912,52081886,46290,51567,72837,/well/papiez/users/hri611/python/nnUNet_results/Dataset219_PETCT/nnUNetTrainer_1500epochs__nnUNetPlans__3d_fullres/crossval_results_folds_0_1_2_3_4/PETCT_ad7cd4a9d2_10022003.nii.gz,/well/papiez/users/hri611/python/nnUnet_raw/Dataset219_PETCT/labelsTr/PETCT_ad7cd4a9d2_10022003.nii.gz,0.7441882897656024,14.568435550689697,22.568012031555174
595,0.0,0,137,0.0,52799863,0,137,0,/well/papiez/users/hri611/python/nnUNet_results/Dataset219_PETCT/nnUNetTrainer_1500epochs__nnUNetPlans__3d_fullres/crossval_results_folds_0_1_2_3_4/PETCT_ad99263bec_01292006.nii.gz,/well/papiez/users/hri611/python/nnUnet_raw/Dataset219_PETCT/labelsTr/PETCT_ad99263bec_01292006.nii.gz,0.0,1.7044198722839354,0.0
596,0.0,0,226893,0.0,51933107,0,226893,0,/well/papiez/users/hri611/python/nnUNet_results/Dataset219_PETCT/nnUNetTrainer_1500epochs__nnUNetPlans__3d_fullres/crossval_results_folds_0_1_2_3_4/PETCT_adc49adb3d_09222002.nii.gz,/well/papiez/users/hri611/python/nnUnet_raw/Dataset219_PETCT/labelsTr/PETCT_adc49adb3d_09222002.nii.gz,0.0,2822.7805699424744,0.0
597,0.9700267453656737,217,433,0.941797994269341,45428832,10518,10951,10735,/well/papiez/users/hri611/python/nnUNet_results/Dataset219_PETCT/nnUNetTrainer_1500epochs__nnUNetPlans__3d_fullres/crossval_results_folds_0_1_2_3_4/PETCT_ae3074834a_07262003.nii.gz,/well/papiez/users/hri611/python/nnUnet_raw/Dataset219_PETCT/labelsTr/PETCT_ae3074834a_07262003.nii.gz,0.9700267453656737,0.0,0.0
598,,0,0,,52160000,0,0,0,/well/papiez/users/hri611/python/nnUNet_results/Dataset219_PETCT/nnUNetTrainer_1500epochs__nnUNetPlans__3d_fullres/crossval_results_folds_0_1_2_3_4/PETCT_ae46202abb_02282003.nii.gz,/well/papiez/users/hri611/python/nnUnet_raw/Dataset219_PETCT/labelsTr/PETCT_ae46202abb_02282003.nii.gz,,0.0,0.0
599,,0,0,,38720000,0,0,0,/well/papiez/users/hri611/python/nnUNet_results/Dataset219_PETCT/nnUNetTrainer_1500epochs__nnUNetPlans__3d_fullres/crossval_results_folds_0_1_2_3_4/PETCT_ae4dcc5dd3_10082004.nii.gz,/well/papiez/users/hri611/python/nnUnet_raw/Dataset219_PETCT/labelsTr/PETCT_ae4dcc5dd3_10082004.nii.gz,,0.0,0.0
600,0.0,0,97,0.0,52159903,0,97,0,/well/papiez/users/hri611/python/nnUNet_results/Dataset219_PETCT/nnUNetTrainer_1500epochs__nnUNetPlans__3d_fullres/crossval_results_folds_0_1_2_3_4/PETCT_ae6a37a9d6_02102005.nii.gz,/well/papiez/users/hri611/python/nnUnet_raw/Dataset219_PETCT/labelsTr/PETCT_ae6a37a9d6_02102005.nii.gz,0.0,1.2067790336608886,0.0
601,0.0,0,88,0.0,49439912,0,88,0,/well/papiez/users/hri611/python/nnUNet_results/Dataset219_PETCT/nnUNetTrainer_1500epochs__nnUNetPlans__3d_fullres/crossval_results_folds_0_1_2_3_4/PETCT_ae6a37a9d6_02182006.nii.gz,/well/papiez/users/hri611/python/nnUnet_raw/Dataset219_PETCT/labelsTr/PETCT_ae6a37a9d6_02182006.nii.gz,0.0,1.094809844970703,0.0
602,0.0,0,542,0.0,48159458,0,542,0,/well/papiez/users/hri611/python/nnUNet_results/Dataset219_PETCT/nnUNetTrainer_1500epochs__nnUNetPlans__3d_fullres/crossval_results_folds_0_1_2_3_4/PETCT_ae6a37a9d6_08182005.nii.gz,/well/papiez/users/hri611/python/nnUnet_raw/Dataset219_PETCT/labelsTr/PETCT_ae6a37a9d6_08182005.nii.gz,0.0,6.743033363342285,0.0
603,,0,0,,52160000,0,0,0,/well/papiez/users/hri611/python/nnUNet_results/Dataset219_PETCT/nnUNetTrainer_1500epochs__nnUNetPlans__3d_fullres/crossval_results_folds_0_1_2_3_4/PETCT_ae6a37a9d6_09132003.nii.gz,/well/papiez/users/hri611/python/nnUnet_raw/Dataset219_PETCT/labelsTr/PETCT_ae6a37a9d6_09132003.nii.gz,,0.0,0.0
604,0.0,0,44,0.0,52159956,0,44,0,/well/papiez/users/hri611/python/nnUNet_results/Dataset219_PETCT/nnUNetTrainer_1500epochs__nnUNetPlans__3d_fullres/crossval_results_folds_0_1_2_3_4/PETCT_ae6a37a9d6_09152002.nii.gz,/well/papiez/users/hri611/python/nnUnet_raw/Dataset219_PETCT/labelsTr/PETCT_ae6a37a9d6_09152002.nii.gz,0.0,0.5474049224853516,0.0
605,0.2255892255892256,2400,820,0.127134724857685,52156311,469,1289,2869,/well/papiez/users/hri611/python/nnUNet_results/Dataset219_PETCT/nnUNetTrainer_1500epochs__nnUNetPlans__3d_fullres/crossval_results_folds_0_1_2_3_4/PETCT_ae96f738c0_05012003.nii.gz,/well/papiez/users/hri611/python/nnUnet_raw/Dataset219_PETCT/labelsTr/PETCT_ae96f738c0_05012003.nii.gz,0.2255892255892256,10.20163719177246,0.0
606,,0,0,,52160000,0,0,0,/well/papiez/users/hri611/python/nnUNet_results/Dataset219_PETCT/nnUNetTrainer_1500epochs__nnUNetPlans__3d_fullres/crossval_results_folds_0_1_2_3_4/PETCT_ae96f738c0_09112003.nii.gz,/well/papiez/users/hri611/python/nnUnet_raw/Dataset219_PETCT/labelsTr/PETCT_ae96f738c0_09112003.nii.gz,,0.0,0.0
607,0.7994747702119678,274,1864,0.6659375,45433600,4262,6126,4536,/well/papiez/users/hri611/python/nnUNet_results/Dataset219_PETCT/nnUNetTrainer_1500epochs__nnUNetPlans__3d_fullres/crossval_results_folds_0_1_2_3_4/PETCT_aea7906fd2_12162001.nii.gz,/well/papiez/users/hri611/python/nnUnet_raw/Dataset219_PETCT/labelsTr/PETCT_aea7906fd2_12162001.nii.gz,0.7994747702119678,0.6842561531066894,0.2861434822082519
608,0.9424584029559201,912,1533,0.8911785650703222,52137532,20023,21556,20935,/well/papiez/users/hri611/python/nnUNet_results/Dataset219_PETCT/nnUNetTrainer_1500epochs__nnUNetPlans__3d_fullres/crossval_results_folds_0_1_2_3_4/PETCT_aee7d68f86_04152002.nii.gz,/well/papiez/users/hri611/python/nnUnet_raw/Dataset219_PETCT/labelsTr/PETCT_aee7d68f86_04152002.nii.gz,0.9424584029559201,0.0,0.0
609,,0,0,,99040000,0,0,0,/well/papiez/users/hri611/python/nnUNet_results/Dataset219_PETCT/nnUNetTrainer_1500epochs__nnUNetPlans__3d_fullres/crossval_results_folds_0_1_2_3_4/PETCT_af119148fe_02112005.nii.gz,/well/papiez/users/hri611/python/nnUnet_raw/Dataset219_PETCT/labelsTr/PETCT_af119148fe_02112005.nii.gz,,0.0,0.0
610,,0,0,,99040000,0,0,0,/well/papiez/users/hri611/python/nnUNet_results/Dataset219_PETCT/nnUNetTrainer_1500epochs__nnUNetPlans__3d_fullres/crossval_results_folds_0_1_2_3_4/PETCT_af119148fe_10052003.nii.gz,/well/papiez/users/hri611/python/nnUnet_raw/Dataset219_PETCT/labelsTr/PETCT_af119148fe_10052003.nii.gz,,0.0,0.0
611,,0,0,,99040000,0,0,0,/well/papiez/users/hri611/python/nnUNet_results/Dataset219_PETCT/nnUNetTrainer_1500epochs__nnUNetPlans__3d_fullres/crossval_results_folds_0_1_2_3_4/PETCT_af119148fe_12052002.nii.gz,/well/papiez/users/hri611/python/nnUnet_raw/Dataset219_PETCT/labelsTr/PETCT_af119148fe_12052002.nii.gz,,0.0,0.0
612,0.0,0,1560,0.0,45438440,0,1560,0,/well/papiez/users/hri611/python/nnUNet_results/Dataset219_PETCT/nnUNetTrainer_1500epochs__nnUNetPlans__3d_fullres/crossval_results_folds_0_1_2_3_4/PETCT_af547fa618_03112006.nii.gz,/well/papiez/users/hri611/python/nnUnet_raw/Dataset219_PETCT/labelsTr/PETCT_af547fa618_03112006.nii.gz,0.0,19.407992706298828,0.0
613,0.9154824233358265,653,25,0.8441379310344828,99035650,3672,3697,4325,/well/papiez/users/hri611/python/nnUNet_results/Dataset219_PETCT/nnUNetTrainer_1500epochs__nnUNetPlans__3d_fullres/crossval_results_folds_0_1_2_3_4/PETCT_af73b85f2c_06192003.nii.gz,/well/papiez/users/hri611/python/nnUnet_raw/Dataset219_PETCT/labelsTr/PETCT_af73b85f2c_06192003.nii.gz,0.9154824233358265,0.04976408386230469,0.0
614,0.7973032390444086,1851,915,0.6629295637338533,52151794,5440,6355,7291,/well/papiez/users/hri611/python/nnUNet_results/Dataset219_PETCT/nnUNetTrainer_1500epochs__nnUNetPlans__3d_fullres/crossval_results_folds_0_1_2_3_4/PETCT_b04be2846e_11152004.nii.gz,/well/papiez/users/hri611/python/nnUnet_raw/Dataset219_PETCT/labelsTr/PETCT_b04be2846e_11152004.nii.gz,0.7973032390444086,5.536254329681396,0.0
615,,0,0,,49440000,0,0,0,/well/papiez/users/hri611/python/nnUNet_results/Dataset219_PETCT/nnUNetTrainer_1500epochs__nnUNetPlans__3d_fullres/crossval_results_folds_0_1_2_3_4/PETCT_b0e002e974_03112007.nii.gz,/well/papiez/users/hri611/python/nnUnet_raw/Dataset219_PETCT/labelsTr/PETCT_b0e002e974_03112007.nii.gz,,0.0,0.0
616,0.0,0,22,0.0,58879978,0,22,0,/well/papiez/users/hri611/python/nnUNet_results/Dataset219_PETCT/nnUNetTrainer_1500epochs__nnUNetPlans__3d_fullres/crossval_results_folds_0_1_2_3_4/PETCT_b0e002e974_04022005.nii.gz,/well/papiez/users/hri611/python/nnUnet_raw/Dataset219_PETCT/labelsTr/PETCT_b0e002e974_04022005.nii.gz,0.0,0.2737024612426758,0.0
617,,0,0,,52800000,0,0,0,/well/papiez/users/hri611/python/nnUNet_results/Dataset219_PETCT/nnUNetTrainer_1500epochs__nnUNetPlans__3d_fullres/crossval_results_folds_0_1_2_3_4/PETCT_b0e002e974_09232005.nii.gz,/well/papiez/users/hri611/python/nnUnet_raw/Dataset219_PETCT/labelsTr/PETCT_b0e002e974_09232005.nii.gz,,0.0,0.0
618,0.861810261374637,920,222,0.7571762704656602,52155297,3561,3783,4481,/well/papiez/users/hri611/python/nnUNet_results/Dataset219_PETCT/nnUNetTrainer_1500epochs__nnUNetPlans__3d_fullres/crossval_results_folds_0_1_2_3_4/PETCT_b1aa7ce13e_03092003.nii.gz,/well/papiez/users/hri611/python/nnUnet_raw/Dataset219_PETCT/labelsTr/PETCT_b1aa7ce13e_03092003.nii.gz,0.861810261374637,0.09952816772460937,2.749465633392334
619,0.0,0,1519,0.0,50078481,0,1519,0,/well/papiez/users/hri611/python/nnUNet_results/Dataset219_PETCT/nnUNetTrainer_1500epochs__nnUNetPlans__3d_fullres/crossval_results_folds_0_1_2_3_4/PETCT_b1d6679284_05282007.nii.gz,/well/papiez/users/hri611/python/nnUnet_raw/Dataset219_PETCT/labelsTr/PETCT_b1d6679284_05282007.nii.gz,0.0,18.897910846710204,0.0
620,0.0,0,1298,0.0,45438702,0,1298,0,/well/papiez/users/hri611/python/nnUNet_results/Dataset219_PETCT/nnUNetTrainer_1500epochs__nnUNetPlans__3d_fullres/crossval_results_folds_0_1_2_3_4/PETCT_b1de3d4248_11202003.nii.gz,/well/papiez/users/hri611/python/nnUnet_raw/Dataset219_PETCT/labelsTr/PETCT_b1de3d4248_11202003.nii.gz,0.0,16.14844521331787,0.0
621,0.7235630753918886,7027,1861,0.5668615984405458,52139480,11632,13493,18659,/well/papiez/users/hri611/python/nnUNet_results/Dataset219_PETCT/nnUNetTrainer_1500epochs__nnUNetPlans__3d_fullres/crossval_results_folds_0_1_2_3_4/PETCT_b258dfa7c2_12152002.nii.gz,/well/papiez/users/hri611/python/nnUnet_raw/Dataset219_PETCT/labelsTr/PETCT_b258dfa7c2_12152002.nii.gz,0.7235630753918886,2.3762350044250486,14.779932907104492
622,0.0,0,18,0.0,45439982,0,18,0,/well/papiez/users/hri611/python/nnUNet_results/Dataset219_PETCT/nnUNetTrainer_1500epochs__nnUNetPlans__3d_fullres/crossval_results_folds_0_1_2_3_4/PETCT_b2f82ed4b9_04172003.nii.gz,/well/papiez/users/hri611/python/nnUnet_raw/Dataset219_PETCT/labelsTr/PETCT_b2f82ed4b9_04172003.nii.gz,0.0,0.2239383773803711,0.0
623,0.8687336759625917,5252,980,0.7679302897147539,45413146,20622,21602,25874,/well/papiez/users/hri611/python/nnUNet_results/Dataset219_PETCT/nnUNetTrainer_1500epochs__nnUNetPlans__3d_fullres/crossval_results_folds_0_1_2_3_4/PETCT_b2f82ed4b9_11112002.nii.gz,/well/papiez/users/hri611/python/nnUnet_raw/Dataset219_PETCT/labelsTr/PETCT_b2f82ed4b9_11112002.nii.gz,0.8687336759625917,3.0231680946350097,4.404121421813965
624,0.7209151562626618,5377,15287,0.5636179333938716,45392647,26689,41976,32066,/well/papiez/users/hri611/python/nnUNet_results/Dataset219_PETCT/nnUNetTrainer_1500epochs__nnUNetPlans__3d_fullres/crossval_results_folds_0_1_2_3_4/PETCT_b327726c24_08272000.nii.gz,/well/papiez/users/hri611/python/nnUnet_raw/Dataset219_PETCT/labelsTr/PETCT_b327726c24_08272000.nii.gz,0.7209151562626618,33.50366946029663,0.012441020965576172
625,0.6265929852261193,8764,1169,0.4562325505009033,52141733,8334,9503,17098,/well/papiez/users/hri611/python/nnUNet_results/Dataset219_PETCT/nnUNetTrainer_1500epochs__nnUNetPlans__3d_fullres/crossval_results_folds_0_1_2_3_4/PETCT_b3d4773f85_11042000.nii.gz,/well/papiez/users/hri611/python/nnUnet_raw/Dataset219_PETCT/labelsTr/PETCT_b3d4773f85_11042000.nii.gz,0.6265929852261193,4.242388149261474,13.087954055786133
626,,0,0,,52160000,0,0,0,/well/papiez/users/hri611/python/nnUNet_results/Dataset219_PETCT/nnUNetTrainer_1500epochs__nnUNetPlans__3d_fullres/crossval_results_folds_0_1_2_3_4/PETCT_b3e923029c_07192003.nii.gz,/well/papiez/users/hri611/python/nnUnet_raw/Dataset219_PETCT/labelsTr/PETCT_b3e923029c_07192003.nii.gz,,0.0,0.0
627,0.0,0,273,0.0,52159727,0,273,0,/well/papiez/users/hri611/python/nnUNet_results/Dataset219_PETCT/nnUNetTrainer_1500epochs__nnUNetPlans__3d_fullres/crossval_results_folds_0_1_2_3_4/PETCT_b3e923029c_11212003.nii.gz,/well/papiez/users/hri611/python/nnUnet_raw/Dataset219_PETCT/labelsTr/PETCT_b3e923029c_11212003.nii.gz,0.0,3.396398723602295,0.0
628,0.7555555555555555,0,99,0.6071428571428571,58879748,153,252,153,/well/papiez/users/hri611/python/nnUNet_results/Dataset219_PETCT/nnUNetTrainer_1500epochs__nnUNetPlans__3d_fullres/crossval_results_folds_0_1_2_3_4/PETCT_b41bc7c1e5_03122005.nii.gz,/well/papiez/users/hri611/python/nnUnet_raw/Dataset219_PETCT/labelsTr/PETCT_b41bc7c1e5_03122005.nii.gz,0.7555555555555555,0.11196918869018554,0.0
629,0.0,0,10,0.0,59199990,0,10,0,/well/papiez/users/hri611/python/nnUNet_results/Dataset219_PETCT/nnUNetTrainer_1500epochs__nnUNetPlans__3d_fullres/crossval_results_folds_0_1_2_3_4/PETCT_b41bc7c1e5_08062006.nii.gz,/well/papiez/users/hri611/python/nnUnet_raw/Dataset219_PETCT/labelsTr/PETCT_b41bc7c1e5_08062006.nii.gz,0.0,0.12441020965576172,0.0
630,0.0,0,575,0.0,58879425,0,575,0,/well/papiez/users/hri611/python/nnUNet_results/Dataset219_PETCT/nnUNetTrainer_1500epochs__nnUNetPlans__3d_fullres/crossval_results_folds_0_1_2_3_4/PETCT_b41bc7c1e5_11052006.nii.gz,/well/papiez/users/hri611/python/nnUnet_raw/Dataset219_PETCT/labelsTr/PETCT_b41bc7c1e5_11052006.nii.gz,0.0,7.153587055206299,0.0
631,,0,0,,45120000,0,0,0,/well/papiez/users/hri611/python/nnUNet_results/Dataset219_PETCT/nnUNetTrainer_1500epochs__nnUNetPlans__3d_fullres/crossval_results_folds_0_1_2_3_4/PETCT_b4247b8ecd_05272007.nii.gz,/well/papiez/users/hri611/python/nnUnet_raw/Dataset219_PETCT/labelsTr/PETCT_b4247b8ecd_05272007.nii.gz,,0.0,0.0
632,0.0,0,220,0.0,45119780,0,220,0,/well/papiez/users/hri611/python/nnUNet_results/Dataset219_PETCT/nnUNetTrainer_1500epochs__nnUNetPlans__3d_fullres/crossval_results_folds_0_1_2_3_4/PETCT_b4247b8ecd_10202006.nii.gz,/well/papiez/users/hri611/python/nnUnet_raw/Dataset219_PETCT/labelsTr/PETCT_b4247b8ecd_10202006.nii.gz,0.0,2.7370246124267577,0.0
633,0.0,0,4092,0.0,52155908,0,4092,0,/well/papiez/users/hri611/python/nnUNet_results/Dataset219_PETCT/nnUNetTrainer_1500epochs__nnUNetPlans__3d_fullres/crossval_results_folds_0_1_2_3_4/PETCT_b42adab18e_09052003.nii.gz,/well/papiez/users/hri611/python/nnUnet_raw/Dataset219_PETCT/labelsTr/PETCT_b42adab18e_09052003.nii.gz,0.0,50.90865779113769,0.0
634,0.0,0,110,0.0,52159890,0,110,0,/well/papiez/users/hri611/python/nnUNet_results/Dataset219_PETCT/nnUNetTrainer_1500epochs__nnUNetPlans__3d_fullres/crossval_results_folds_0_1_2_3_4/PETCT_b4e5c1047c_10102004.nii.gz,/well/papiez/users/hri611/python/nnUnet_raw/Dataset219_PETCT/labelsTr/PETCT_b4e5c1047c_10102004.nii.gz,0.0,1.3685123062133788,0.0
635,0.8526672311600338,90,4086,0.7431734317343174,52143740,12084,16170,12174,/well/papiez/users/hri611/python/nnUNet_results/Dataset219_PETCT/nnUNetTrainer_1500epochs__nnUNetPlans__3d_fullres/crossval_results_folds_0_1_2_3_4/PETCT_b509ace2a2_05272002.nii.gz,/well/papiez/users/hri611/python/nnUnet_raw/Dataset219_PETCT/labelsTr/PETCT_b509ace2a2_05272002.nii.gz,0.8526672311600338,3.682542205810547,0.5349639015197754
636,0.2948157401623985,0,1129,0.1728937728937729,52158635,236,1365,236,/well/papiez/users/hri611/python/nnUNet_results/Dataset219_PETCT/nnUNetTrainer_1500epochs__nnUNetPlans__3d_fullres/crossval_results_folds_0_1_2_3_4/PETCT_b510436d83_11102002.nii.gz,/well/papiez/users/hri611/python/nnUnet_raw/Dataset219_PETCT/labelsTr/PETCT_b510436d83_11102002.nii.gz,0.2948157401623985,13.199923244476318,0.0
637,0.0,137,0,0.0,45439863,0,0,137,/well/papiez/users/hri611/python/nnUNet_results/Dataset219_PETCT/nnUNetTrainer_1500epochs__nnUNetPlans__3d_fullres/crossval_results_folds_0_1_2_3_4/PETCT_b510436d83_11142003.nii.gz,/well/papiez/users/hri611/python/nnUnet_raw/Dataset219_PETCT/labelsTr/PETCT_b510436d83_11142003.nii.gz,0.0,0.0,1.7044198722839354
638,0.8378440631118277,4135,1497,0.7209394509959369,52139818,14550,16047,18685,/well/papiez/users/hri611/python/nnUNet_results/Dataset219_PETCT/nnUNetTrainer_1500epochs__nnUNetPlans__3d_fullres/crossval_results_folds_0_1_2_3_4/PETCT_b52920038c_06072003.nii.gz,/well/papiez/users/hri611/python/nnUnet_raw/Dataset219_PETCT/labelsTr/PETCT_b52920038c_06072003.nii.gz,0.8378440631118277,0.0,2.625055423736572
639,0.7182670225311899,1380,12237,0.5603874092009685,52129025,17358,29595,18738,/well/papiez/users/hri611/python/nnUNet_results/Dataset219_PETCT/nnUNetTrainer_1500epochs__nnUNetPlans__3d_fullres/crossval_results_folds_0_1_2_3_4/PETCT_b53ba7c6bf_11212003.nii.gz,/well/papiez/users/hri611/python/nnUnet_raw/Dataset219_PETCT/labelsTr/PETCT_b53ba7c6bf_11212003.nii.gz,0.7182670225311899,53.794974655151364,7.054058887481689
640,0.0,0,1,0.0,55519999,0,1,0,/well/papiez/users/hri611/python/nnUNet_results/Dataset219_PETCT/nnUNetTrainer_1500epochs__nnUNetPlans__3d_fullres/crossval_results_folds_0_1_2_3_4/PETCT_b57e1c1f5f_06252006.nii.gz,/well/papiez/users/hri611/python/nnUnet_raw/Dataset219_PETCT/labelsTr/PETCT_b57e1c1f5f_06252006.nii.gz,0.0,0.012441020965576172,0.0
641,0.9490291262135923,53,31,0.9030023094688222,52799134,782,813,835,/well/papiez/users/hri611/python/nnUNet_results/Dataset219_PETCT/nnUNetTrainer_1500epochs__nnUNetPlans__3d_fullres/crossval_results_folds_0_1_2_3_4/PETCT_b5923963ac_02172007.nii.gz,/well/papiez/users/hri611/python/nnUnet_raw/Dataset219_PETCT/labelsTr/PETCT_b5923963ac_02172007.nii.gz,0.9490291262135923,0.14929225158691406,0.0
642,0.0,0,78,0.0,52959922,0,78,0,/well/papiez/users/hri611/python/nnUNet_results/Dataset219_PETCT/nnUNetTrainer_1500epochs__nnUNetPlans__3d_fullres/crossval_results_folds_0_1_2_3_4/PETCT_b5923963ac_06022007.nii.gz,/well/papiez/users/hri611/python/nnUnet_raw/Dataset219_PETCT/labelsTr/PETCT_b5923963ac_06022007.nii.gz,0.0,0.9703996353149413,0.0
643,0.0,0,6,0.0,38719994,0,6,0,/well/papiez/users/hri611/python/nnUNet_results/Dataset219_PETCT/nnUNetTrainer_1500epochs__nnUNetPlans__3d_fullres/crossval_results_folds_0_1_2_3_4/PETCT_b621742469_11042004.nii.gz,/well/papiez/users/hri611/python/nnUnet_raw/Dataset219_PETCT/labelsTr/PETCT_b621742469_11042004.nii.gz,0.0,0.07464612579345703,0.0
644,0.0,0,26,0.0,52159974,0,26,0,/well/papiez/users/hri611/python/nnUNet_results/Dataset219_PETCT/nnUNetTrainer_1500epochs__nnUNetPlans__3d_fullres/crossval_results_folds_0_1_2_3_4/PETCT_b62864161e_07282002.nii.gz,/well/papiez/users/hri611/python/nnUnet_raw/Dataset219_PETCT/labelsTr/PETCT_b62864161e_07282002.nii.gz,0.0,0.32346654510498046,0.0
645,0.0,0,289,0.0,94239711,0,289,0,/well/papiez/users/hri611/python/nnUNet_results/Dataset219_PETCT/nnUNetTrainer_1500epochs__nnUNetPlans__3d_fullres/crossval_results_folds_0_1_2_3_4/PETCT_b663adb148_06212007.nii.gz,/well/papiez/users/hri611/python/nnUnet_raw/Dataset219_PETCT/labelsTr/PETCT_b663adb148_06212007.nii.gz,0.0,3.5954550590515137,0.0
646,0.0,0,36,0.0,52159964,0,36,0,/well/papiez/users/hri611/python/nnUNet_results/Dataset219_PETCT/nnUNetTrainer_1500epochs__nnUNetPlans__3d_fullres/crossval_results_folds_0_1_2_3_4/PETCT_b66ba83594_03132003.nii.gz,/well/papiez/users/hri611/python/nnUnet_raw/Dataset219_PETCT/labelsTr/PETCT_b66ba83594_03132003.nii.gz,0.0,0.4478767547607422,0.0
647,0.7594600575348528,30,1057,0.6122012129860863,49437197,1716,2773,1746,/well/papiez/users/hri611/python/nnUNet_results/Dataset219_PETCT/nnUNetTrainer_1500epochs__nnUNetPlans__3d_fullres/crossval_results_folds_0_1_2_3_4/PETCT_b6a1ee33ef_10242005.nii.gz,/well/papiez/users/hri611/python/nnUnet_raw/Dataset219_PETCT/labelsTr/PETCT_b6a1ee33ef_10242005.nii.gz,0.7594600575348528,3.981126708984375,0.0
648,0.4174454828660436,741,7,0.2637795275590551,52158984,268,275,1009,/well/papiez/users/hri611/python/nnUNet_results/Dataset219_PETCT/nnUNetTrainer_1500epochs__nnUNetPlans__3d_fullres/crossval_results_folds_0_1_2_3_4/PETCT_b6a3c72db6_07132002.nii.gz,/well/papiez/users/hri611/python/nnUnet_raw/Dataset219_PETCT/labelsTr/PETCT_b6a3c72db6_07132002.nii.gz,0.4174454828660436,0.04976408386230469,7.825402187347412
649,0.8799141949589538,10497,1147,0.7855774896876841,45385696,42660,43807,53157,/well/papiez/users/hri611/python/nnUNet_results/Dataset219_PETCT/nnUNetTrainer_1500epochs__nnUNetPlans__3d_fullres/crossval_results_folds_0_1_2_3_4/PETCT_b6fc20942c_12282001.nii.gz,/well/papiez/users/hri611/python/nnUnet_raw/Dataset219_PETCT/labelsTr/PETCT_b6fc20942c_12282001.nii.gz,0.8799141949589538,0.4603177757263184,0.58472798538208
650,,0,0,,46880000,0,0,0,/well/papiez/users/hri611/python/nnUNet_results/Dataset219_PETCT/nnUNetTrainer_1500epochs__nnUNetPlans__3d_fullres/crossval_results_folds_0_1_2_3_4/PETCT_b79961f3f6_07072007.nii.gz,/well/papiez/users/hri611/python/nnUnet_raw/Dataset219_PETCT/labelsTr/PETCT_b79961f3f6_07072007.nii.gz,,0.0,0.0
651,0.8935063760513702,600,4110,0.8075115452204831,52135531,19759,23869,20359,/well/papiez/users/hri611/python/nnUNet_results/Dataset219_PETCT/nnUNetTrainer_1500epochs__nnUNetPlans__3d_fullres/crossval_results_folds_0_1_2_3_4/PETCT_b7c1533a39_02122005.nii.gz,/well/papiez/users/hri611/python/nnUnet_raw/Dataset219_PETCT/labelsTr/PETCT_b7c1533a39_02122005.nii.gz,0.8935063760513702,16.02403500366211,2.0154453964233396
652,0.8006817726087828,2778,1198,0.6676141113526166,38708038,7986,9184,10764,/well/papiez/users/hri611/python/nnUNet_results/Dataset219_PETCT/nnUNetTrainer_1500epochs__nnUNetPlans__3d_fullres/crossval_results_folds_0_1_2_3_4/PETCT_b899150306_08112002.nii.gz,/well/papiez/users/hri611/python/nnUnet_raw/Dataset219_PETCT/labelsTr/PETCT_b899150306_08112002.nii.gz,0.8006817726087828,1.7541839561462402,8.58430446624756
653,0.0,0,103,0.0,52159897,0,103,0,/well/papiez/users/hri611/python/nnUNet_results/Dataset219_PETCT/nnUNetTrainer_1500epochs__nnUNetPlans__3d_fullres/crossval_results_folds_0_1_2_3_4/PETCT_b926177c87_10102004.nii.gz,/well/papiez/users/hri611/python/nnUnet_raw/Dataset219_PETCT/labelsTr/PETCT_b926177c87_10102004.nii.gz,0.0,1.2814251594543458,0.0
654,,0,0,,44320000,0,0,0,/well/papiez/users/hri611/python/nnUNet_results/Dataset219_PETCT/nnUNetTrainer_1500epochs__nnUNetPlans__3d_fullres/crossval_results_folds_0_1_2_3_4/PETCT_b92d7f441e_03222007.nii.gz,/well/papiez/users/hri611/python/nnUnet_raw/Dataset219_PETCT/labelsTr/PETCT_b92d7f441e_03222007.nii.gz,,0.0,0.0
655,0.8688721511590156,4637,3441,0.7681467236876094,52125159,26763,30204,31400,/well/papiez/users/hri611/python/nnUNet_results/Dataset219_PETCT/nnUNetTrainer_1500epochs__nnUNetPlans__3d_fullres/crossval_results_folds_0_1_2_3_4/PETCT_ba717a1f22_03282003.nii.gz,/well/papiez/users/hri611/python/nnUnet_raw/Dataset219_PETCT/labelsTr/PETCT_ba717a1f22_03282003.nii.gz,0.8688721511590156,0.11196918869018554,7.228233180999756
656,0.0,0,292,0.0,51519708,0,292,0,/well/papiez/users/hri611/python/nnUNet_results/Dataset219_PETCT/nnUNetTrainer_1500epochs__nnUNetPlans__3d_fullres/crossval_results_folds_0_1_2_3_4/PETCT_ba81e4b04b_12022005.nii.gz,/well/papiez/users/hri611/python/nnUnet_raw/Dataset219_PETCT/labelsTr/PETCT_ba81e4b04b_12022005.nii.gz,0.0,3.6327781219482422,0.0
657,0.8505586592178771,736,548,0.7399756986634265,52155062,3654,4202,4390,/well/papiez/users/hri611/python/nnUNet_results/Dataset219_PETCT/nnUNetTrainer_1500epochs__nnUNetPlans__3d_fullres/crossval_results_folds_0_1_2_3_4/PETCT_bacc741e2c_01282002.nii.gz,/well/papiez/users/hri611/python/nnUnet_raw/Dataset219_PETCT/labelsTr/PETCT_bacc741e2c_01282002.nii.gz,0.8505586592178771,0.09952816772460937,0.0
658,0.2843076923076923,2234,1255,0.16571018651362984,52155818,693,1948,2927,/well/papiez/users/hri611/python/nnUNet_results/Dataset219_PETCT/nnUNetTrainer_1500epochs__nnUNetPlans__3d_fullres/crossval_results_folds_0_1_2_3_4/PETCT_bb45bfcffd_01032003.nii.gz,/well/papiez/users/hri611/python/nnUnet_raw/Dataset219_PETCT/labelsTr/PETCT_bb45bfcffd_01032003.nii.gz,0.2843076923076923,7.489494621276855,27.793240837097166
659,,0,0,,48000000,0,0,0,/well/papiez/users/hri611/python/nnUNet_results/Dataset219_PETCT/nnUNetTrainer_1500epochs__nnUNetPlans__3d_fullres/crossval_results_folds_0_1_2_3_4/PETCT_bb564e29d2_05052006.nii.gz,/well/papiez/users/hri611/python/nnUnet_raw/Dataset219_PETCT/labelsTr/PETCT_bb564e29d2_05052006.nii.gz,,0.0,0.0
660,,0,0,,52160000,0,0,0,/well/papiez/users/hri611/python/nnUNet_results/Dataset219_PETCT/nnUNetTrainer_1500epochs__nnUNetPlans__3d_fullres/crossval_results_folds_0_1_2_3_4/PETCT_bbb2df1e31_01292005.nii.gz,/well/papiez/users/hri611/python/nnUnet_raw/Dataset219_PETCT/labelsTr/PETCT_bbb2df1e31_01292005.nii.gz,,0.0,0.0
661,0.746748440308766,2922,1868,0.5958488018899764,52148148,7062,8930,9984,/well/papiez/users/hri611/python/nnUNet_results/Dataset219_PETCT/nnUNetTrainer_1500epochs__nnUNetPlans__3d_fullres/crossval_results_folds_0_1_2_3_4/PETCT_bbb83facb4_08232001.nii.gz,/well/papiez/users/hri611/python/nnUnet_raw/Dataset219_PETCT/labelsTr/PETCT_bbb83facb4_08232001.nii.gz,0.746748440308766,18.611767364501954,0.0
662,0.8087333632421115,0,1279,0.6788852623650514,92316017,2704,3983,2704,/well/papiez/users/hri611/python/nnUNet_results/Dataset219_PETCT/nnUNetTrainer_1500epochs__nnUNetPlans__3d_fullres/crossval_results_folds_0_1_2_3_4/PETCT_bc80d06f97_02182002.nii.gz,/well/papiez/users/hri611/python/nnUnet_raw/Dataset219_PETCT/labelsTr/PETCT_bc80d06f97_02182002.nii.gz,0.8087333632421115,1.891035186767578,0.0
663,0.92959927140255,2135,957,0.8684591168212371,45416494,20414,21371,22549,/well/papiez/users/hri611/python/nnUNet_results/Dataset219_PETCT/nnUNetTrainer_1500epochs__nnUNetPlans__3d_fullres/crossval_results_folds_0_1_2_3_4/PETCT_bca97006e4_05062001.nii.gz,/well/papiez/users/hri611/python/nnUnet_raw/Dataset219_PETCT/labelsTr/PETCT_bca97006e4_05062001.nii.gz,0.92959927140255,0.4727587966918945,0.0
664,0.6541274817136886,556,106,0.4860248447204969,45438712,626,732,1182,/well/papiez/users/hri611/python/nnUNet_results/Dataset219_PETCT/nnUNetTrainer_1500epochs__nnUNetPlans__3d_fullres/crossval_results_folds_0_1_2_3_4/PETCT_bd52fdf529_12032000.nii.gz,/well/papiez/users/hri611/python/nnUnet_raw/Dataset219_PETCT/labelsTr/PETCT_bd52fdf529_12032000.nii.gz,0.6541274817136886,0.8459894256591797,3.8940395622253416
665,0.8457912457912458,30,886,0.7327887981330222,52156572,2512,3398,2542,/well/papiez/users/hri611/python/nnUNet_results/Dataset219_PETCT/nnUNetTrainer_1500epochs__nnUNetPlans__3d_fullres/crossval_results_folds_0_1_2_3_4/PETCT_bd7603e9df_05062005.nii.gz,/well/papiez/users/hri611/python/nnUnet_raw/Dataset219_PETCT/labelsTr/PETCT_bd7603e9df_05062005.nii.gz,0.8457912457912458,0.0,0.0
666,0.0,0,1886,0.0,45438114,0,1886,0,/well/papiez/users/hri611/python/nnUNet_results/Dataset219_PETCT/nnUNetTrainer_1500epochs__nnUNetPlans__3d_fullres/crossval_results_folds_0_1_2_3_4/PETCT_bd76c8d299_10252002.nii.gz,/well/papiez/users/hri611/python/nnUnet_raw/Dataset219_PETCT/labelsTr/PETCT_bd76c8d299_10252002.nii.gz,0.0,23.46376554107666,0.0
667,0.8386837881219904,2577,639,0.7221838286109191,45428424,8360,8999,10937,/well/papiez/users/hri611/python/nnUNet_results/Dataset219_PETCT/nnUNetTrainer_1500epochs__nnUNetPlans__3d_fullres/crossval_results_folds_0_1_2_3_4/PETCT_bd7c02faa9_05042002.nii.gz,/well/papiez/users/hri611/python/nnUnet_raw/Dataset219_PETCT/labelsTr/PETCT_bd7c02faa9_05042002.nii.gz,0.8386837881219904,0.3981126708984375,3.3839577026367187
668,0.0,0,3514,0.0,50396486,0,3514,0,/well/papiez/users/hri611/python/nnUNet_results/Dataset219_PETCT/nnUNetTrainer_1500epochs__nnUNetPlans__3d_fullres/crossval_results_folds_0_1_2_3_4/PETCT_be0d3c767e_05292006.nii.gz,/well/papiez/users/hri611/python/nnUnet_raw/Dataset219_PETCT/labelsTr/PETCT_be0d3c767e_05292006.nii.gz,0.0,43.717747673034665,0.0
669,0.8363342099939308,540,1078,0.7187065368567455,45434248,4134,5212,4674,/well/papiez/users/hri611/python/nnUNet_results/Dataset219_PETCT/nnUNetTrainer_1500epochs__nnUNetPlans__3d_fullres/crossval_results_folds_0_1_2_3_4/PETCT_be3e55a32f_04052001.nii.gz,/well/papiez/users/hri611/python/nnUnet_raw/Dataset219_PETCT/labelsTr/PETCT_be3e55a32f_04052001.nii.gz,0.8363342099939308,1.1321329078674316,0.012441020965576172
670,0.0,0,871,0.0,51679129,0,871,0,/well/papiez/users/hri611/python/nnUNet_results/Dataset219_PETCT/nnUNetTrainer_1500epochs__nnUNetPlans__3d_fullres/crossval_results_folds_0_1_2_3_4/PETCT_bef465b4ad_05042007.nii.gz,/well/papiez/users/hri611/python/nnUnet_raw/Dataset219_PETCT/labelsTr/PETCT_bef465b4ad_05042007.nii.gz,0.0,10.836129261016845,0.0
671,0.39423230293170003,18604,385,0.24551017164653527,45414832,6179,6564,24783,/well/papiez/users/hri611/python/nnUNet_results/Dataset219_PETCT/nnUNetTrainer_1500epochs__nnUNetPlans__3d_fullres/crossval_results_folds_0_1_2_3_4/PETCT_bf178a41b2_06082002.nii.gz,/well/papiez/users/hri611/python/nnUnet_raw/Dataset219_PETCT/labelsTr/PETCT_bf178a41b2_06082002.nii.gz,0.39423230293170003,0.1368512306213379,51.99102661514282
672,0.8442154415908542,1477,458,0.7304263025912511,45432822,5243,5701,6720,/well/papiez/users/hri611/python/nnUNet_results/Dataset219_PETCT/nnUNetTrainer_1500epochs__nnUNetPlans__3d_fullres/crossval_results_folds_0_1_2_3_4/PETCT_bf7652bccc_11252002.nii.gz,/well/papiez/users/hri611/python/nnUnet_raw/Dataset219_PETCT/labelsTr/PETCT_bf7652bccc_11252002.nii.gz,0.8442154415908542,2.6499374656677244,7.315320327758789
673,0.8640157093765342,89,465,0.7605877268798618,46237686,1760,2225,1849,/well/papiez/users/hri611/python/nnUNet_results/Dataset219_PETCT/nnUNetTrainer_1500epochs__nnUNetPlans__3d_fullres/crossval_results_folds_0_1_2_3_4/PETCT_bfd89440db_02052006.nii.gz,/well/papiez/users/hri611/python/nnUnet_raw/Dataset219_PETCT/labelsTr/PETCT_bfd89440db_02052006.nii.gz,0.8640157093765342,1.9407992706298827,0.5474049224853516
674,,0,0,,47360000,0,0,0,/well/papiez/users/hri611/python/nnUNet_results/Dataset219_PETCT/nnUNetTrainer_1500epochs__nnUNetPlans__3d_fullres/crossval_results_folds_0_1_2_3_4/PETCT_bfd89440db_03112007.nii.gz,/well/papiez/users/hri611/python/nnUnet_raw/Dataset219_PETCT/labelsTr/PETCT_bfd89440db_03112007.nii.gz,,0.0,0.0
675,0.0,0,32,0.0,48159968,0,32,0,/well/papiez/users/hri611/python/nnUNet_results/Dataset219_PETCT/nnUNetTrainer_1500epochs__nnUNetPlans__3d_fullres/crossval_results_folds_0_1_2_3_4/PETCT_c018b45a49_11262006.nii.gz,/well/papiez/users/hri611/python/nnUnet_raw/Dataset219_PETCT/labelsTr/PETCT_c018b45a49_11262006.nii.gz,0.0,0.3981126708984375,0.0
676,0.0,0,744,0.0,52799256,0,744,0,/well/papiez/users/hri611/python/nnUNet_results/Dataset219_PETCT/nnUNetTrainer_1500epochs__nnUNetPlans__3d_fullres/crossval_results_folds_0_1_2_3_4/PETCT_c08293f2b2_07132006.nii.gz,/well/papiez/users/hri611/python/nnUnet_raw/Dataset219_PETCT/labelsTr/PETCT_c08293f2b2_07132006.nii.gz,0.0,9.256119598388672,0.0
677,,0,0,,50400000,0,0,0,/well/papiez/users/hri611/python/nnUNet_results/Dataset219_PETCT/nnUNetTrainer_1500epochs__nnUNetPlans__3d_fullres/crossval_results_folds_0_1_2_3_4/PETCT_c094a24c03_01292006.nii.gz,/well/papiez/users/hri611/python/nnUnet_raw/Dataset219_PETCT/labelsTr/PETCT_c094a24c03_01292006.nii.gz,,0.0,0.0
678,0.0,0,19,0.0,52159981,0,19,0,/well/papiez/users/hri611/python/nnUNet_results/Dataset219_PETCT/nnUNetTrainer_1500epochs__nnUNetPlans__3d_fullres/crossval_results_folds_0_1_2_3_4/PETCT_c094a24c03_03042007.nii.gz,/well/papiez/users/hri611/python/nnUnet_raw/Dataset219_PETCT/labelsTr/PETCT_c094a24c03_03042007.nii.gz,0.0,0.23637939834594726,0.0
679,0.0,0,2717,0.0,52157283,0,2717,0,/well/papiez/users/hri611/python/nnUNet_results/Dataset219_PETCT/nnUNetTrainer_1500epochs__nnUNetPlans__3d_fullres/crossval_results_folds_0_1_2_3_4/PETCT_c10f48b173_11272004.nii.gz,/well/papiez/users/hri611/python/nnUnet_raw/Dataset219_PETCT/labelsTr/PETCT_c10f48b173_11272004.nii.gz,0.0,33.802253963470456,0.0
680,0.7690517742873764,151,246,0.6247637051039697,45438942,661,907,812,/well/papiez/users/hri611/python/nnUNet_results/Dataset219_PETCT/nnUNetTrainer_1500epochs__nnUNetPlans__3d_fullres/crossval_results_folds_0_1_2_3_4/PETCT_c16c13211c_10262003.nii.gz,/well/papiez/users/hri611/python/nnUnet_raw/Dataset219_PETCT/labelsTr/PETCT_c16c13211c_10262003.nii.gz,0.7690517742873764,0.3359075660705566,0.6096100273132324
681,0.886426175129104,90,2923,0.7960192268634486,72145229,11758,14681,11848,/well/papiez/users/hri611/python/nnUNet_results/Dataset219_PETCT/nnUNetTrainer_1500epochs__nnUNetPlans__3d_fullres/crossval_results_folds_0_1_2_3_4/PETCT_c16d325d12_02152003.nii.gz,/well/papiez/users/hri611/python/nnUnet_raw/Dataset219_PETCT/labelsTr/PETCT_c16d325d12_02152003.nii.gz,0.886426175129104,0.5971690063476562,0.024882041931152343
682,,0,0,,51040000,0,0,0,/well/papiez/users/hri611/python/nnUNet_results/Dataset219_PETCT/nnUNetTrainer_1500epochs__nnUNetPlans__3d_fullres/crossval_results_folds_0_1_2_3_4/PETCT_c1c9e78e0e_05142007.nii.gz,/well/papiez/users/hri611/python/nnUnet_raw/Dataset219_PETCT/labelsTr/PETCT_c1c9e78e0e_05142007.nii.gz,,0.0,0.0
683,0.0,0,4,0.0,45439996,0,4,0,/well/papiez/users/hri611/python/nnUNet_results/Dataset219_PETCT/nnUNetTrainer_1500epochs__nnUNetPlans__3d_fullres/crossval_results_folds_0_1_2_3_4/PETCT_c227131152_10262003.nii.gz,/well/papiez/users/hri611/python/nnUnet_raw/Dataset219_PETCT/labelsTr/PETCT_c227131152_10262003.nii.gz,0.0,0.04976408386230469,0.0
684,0.9244283324037925,20,522,0.8594762768991444,92316143,3315,3837,3335,/well/papiez/users/hri611/python/nnUNet_results/Dataset219_PETCT/nnUNetTrainer_1500epochs__nnUNetPlans__3d_fullres/crossval_results_folds_0_1_2_3_4/PETCT_c252d734a0_08092003.nii.gz,/well/papiez/users/hri611/python/nnUnet_raw/Dataset219_PETCT/labelsTr/PETCT_c252d734a0_08092003.nii.gz,0.9244283324037925,1.9283582496643066,0.0
685,0.6513031264630911,12926,480,0.4829129059631258,52134074,12520,13000,25446,/well/papiez/users/hri611/python/nnUNet_results/Dataset219_PETCT/nnUNetTrainer_1500epochs__nnUNetPlans__3d_fullres/crossval_results_folds_0_1_2_3_4/PETCT_c29aba73da_08232002.nii.gz,/well/papiez/users/hri611/python/nnUnet_raw/Dataset219_PETCT/labelsTr/PETCT_c29aba73da_08232002.nii.gz,0.6513031264630911,0.21149735641479492,15.86230173110962
686,0.8642342398149869,5265,1310,0.7609264780743219,52132498,20927,22237,26192,/well/papiez/users/hri611/python/nnUNet_results/Dataset219_PETCT/nnUNetTrainer_1500epochs__nnUNetPlans__3d_fullres/crossval_results_folds_0_1_2_3_4/PETCT_c2a51a65c6_09152002.nii.gz,/well/papiez/users/hri611/python/nnUnet_raw/Dataset219_PETCT/labelsTr/PETCT_c2a51a65c6_09152002.nii.gz,0.8642342398149869,0.04976408386230469,0.024882041931152343
687,0.0,0,778,0.0,72159222,0,778,0,/well/papiez/users/hri611/python/nnUNet_results/Dataset219_PETCT/nnUNetTrainer_1500epochs__nnUNetPlans__3d_fullres/crossval_results_folds_0_1_2_3_4/PETCT_c2b776974a_05092005.nii.gz,/well/papiez/users/hri611/python/nnUnet_raw/Dataset219_PETCT/labelsTr/PETCT_c2b776974a_05092005.nii.gz,0.0,9.679114311218262,0.0
688,,0,0,,38720000,0,0,0,/well/papiez/users/hri611/python/nnUNet_results/Dataset219_PETCT/nnUNetTrainer_1500epochs__nnUNetPlans__3d_fullres/crossval_results_folds_0_1_2_3_4/PETCT_c2ffda4725_04112003.nii.gz,/well/papiez/users/hri611/python/nnUnet_raw/Dataset219_PETCT/labelsTr/PETCT_c2ffda4725_04112003.nii.gz,,0.0,0.0
689,0.0,0,3072,0.0,38716928,0,3072,0,/well/papiez/users/hri611/python/nnUNet_results/Dataset219_PETCT/nnUNetTrainer_1500epochs__nnUNetPlans__3d_fullres/crossval_results_folds_0_1_2_3_4/PETCT_c2ffda4725_09192003.nii.gz,/well/papiez/users/hri611/python/nnUnet_raw/Dataset219_PETCT/labelsTr/PETCT_c2ffda4725_09192003.nii.gz,0.0,38.21881640625,0.0
690,0.0,0,5367,0.0,65434633,0,5367,0,/well/papiez/users/hri611/python/nnUNet_results/Dataset219_PETCT/nnUNetTrainer_1500epochs__nnUNetPlans__3d_fullres/crossval_results_folds_0_1_2_3_4/PETCT_c32e1daf9b_02022003.nii.gz,/well/papiez/users/hri611/python/nnUnet_raw/Dataset219_PETCT/labelsTr/PETCT_c32e1daf9b_02022003.nii.gz,0.0,66.77095952224731,0.0
691,0.0,0,65,0.0,41759935,0,65,0,/well/papiez/users/hri611/python/nnUNet_results/Dataset219_PETCT/nnUNetTrainer_1500epochs__nnUNetPlans__3d_fullres/crossval_results_folds_0_1_2_3_4/PETCT_c38b168f1a_04152006.nii.gz,/well/papiez/users/hri611/python/nnUnet_raw/Dataset219_PETCT/labelsTr/PETCT_c38b168f1a_04152006.nii.gz,0.0,0.8086663627624512,0.0
692,0.0,0,22,0.0,58879978,0,22,0,/well/papiez/users/hri611/python/nnUNet_results/Dataset219_PETCT/nnUNetTrainer_1500epochs__nnUNetPlans__3d_fullres/crossval_results_folds_0_1_2_3_4/PETCT_c395306306_08242002.nii.gz,/well/papiez/users/hri611/python/nnUnet_raw/Dataset219_PETCT/labelsTr/PETCT_c395306306_08242002.nii.gz,0.0,0.2737024612426758,0.0
693,0.8491874076599614,322,1005,0.7379024293896899,51194937,3736,4741,4058,/well/papiez/users/hri611/python/nnUNet_results/Dataset219_PETCT/nnUNetTrainer_1500epochs__nnUNetPlans__3d_fullres/crossval_results_folds_0_1_2_3_4/PETCT_c3cc732d95_07212005.nii.gz,/well/papiez/users/hri611/python/nnUnet_raw/Dataset219_PETCT/labelsTr/PETCT_c3cc732d95_07212005.nii.gz,0.8491874076599614,0.14929225158691406,0.3359075660705566
694,0.8065620445378436,3587,2120,0.6758307299062766,52142395,11898,14018,15485,/well/papiez/users/hri611/python/nnUNet_results/Dataset219_PETCT/nnUNetTrainer_1500epochs__nnUNetPlans__3d_fullres/crossval_results_folds_0_1_2_3_4/PETCT_c4a686881e_04231999.nii.gz,/well/papiez/users/hri611/python/nnUnet_raw/Dataset219_PETCT/labelsTr/PETCT_c4a686881e_04231999.nii.gz,0.8065620445378436,0.16173327255249023,11.532826435089111
695,0.9114279405734473,2737,2879,0.8372692764625771,52125489,28895,31774,31632,/well/papiez/users/hri611/python/nnUNet_results/Dataset219_PETCT/nnUNetTrainer_1500epochs__nnUNetPlans__3d_fullres/crossval_results_folds_0_1_2_3_4/PETCT_c517c47bed_02062003.nii.gz,/well/papiez/users/hri611/python/nnUnet_raw/Dataset219_PETCT/labelsTr/PETCT_c517c47bed_02062003.nii.gz,0.9114279405734473,0.5722869644165038,0.0
696,0.3571179951270449,1818,29,0.2173728813559322,45437640,513,542,2331,/well/papiez/users/hri611/python/nnUNet_results/Dataset219_PETCT/nnUNetTrainer_1500epochs__nnUNetPlans__3d_fullres/crossval_results_folds_0_1_2_3_4/PETCT_c58477f3b4_12072002.nii.gz,/well/papiez/users/hri611/python/nnUnet_raw/Dataset219_PETCT/labelsTr/PETCT_c58477f3b4_12072002.nii.gz,0.3571179951270449,0.0,16.90734749221802
697,0.0,0,402,0.0,65439598,0,402,0,/well/papiez/users/hri611/python/nnUNet_results/Dataset219_PETCT/nnUNetTrainer_1500epochs__nnUNetPlans__3d_fullres/crossval_results_folds_0_1_2_3_4/PETCT_c596a50286_05162003.nii.gz,/well/papiez/users/hri611/python/nnUnet_raw/Dataset219_PETCT/labelsTr/PETCT_c596a50286_05162003.nii.gz,0.0,5.001290428161621,0.0
698,0.0,0,27,0.0,43679973,0,27,0,/well/papiez/users/hri611/python/nnUNet_results/Dataset219_PETCT/nnUNetTrainer_1500epochs__nnUNetPlans__3d_fullres/crossval_results_folds_0_1_2_3_4/PETCT_c5a143a604_08122006.nii.gz,/well/papiez/users/hri611/python/nnUnet_raw/Dataset219_PETCT/labelsTr/PETCT_c5a143a604_08122006.nii.gz,0.0,0.3359075660705566,0.0
699,,0,0,,42880000,0,0,0,/well/papiez/users/hri611/python/nnUNet_results/Dataset219_PETCT/nnUNetTrainer_1500epochs__nnUNetPlans__3d_fullres/crossval_results_folds_0_1_2_3_4/PETCT_c6730783de_01052006.nii.gz,/well/papiez/users/hri611/python/nnUnet_raw/Dataset219_PETCT/labelsTr/PETCT_c6730783de_01052006.nii.gz,,0.0,0.0
700,0.6247453483634389,4336,1190,0.4542761208769504,52149874,4600,5790,8936,/well/papiez/users/hri611/python/nnUNet_results/Dataset219_PETCT/nnUNetTrainer_1500epochs__nnUNetPlans__3d_fullres/crossval_results_folds_0_1_2_3_4/PETCT_c73c2685c0_02012001.nii.gz,/well/papiez/users/hri611/python/nnUnet_raw/Dataset219_PETCT/labelsTr/PETCT_c73c2685c0_02012001.nii.gz,0.6247453483634389,0.49764083862304687,3.0729321784973145
701,0.0,0,50,0.0,45439950,0,50,0,/well/papiez/users/hri611/python/nnUNet_results/Dataset219_PETCT/nnUNetTrainer_1500epochs__nnUNetPlans__3d_fullres/crossval_results_folds_0_1_2_3_4/PETCT_c787334539_01052003.nii.gz,/well/papiez/users/hri611/python/nnUnet_raw/Dataset219_PETCT/labelsTr/PETCT_c787334539_01052003.nii.gz,0.0,0.6220510482788086,0.0
702,0.9241466498103666,642,318,0.8589894242068156,45433192,5848,6166,6490,/well/papiez/users/hri611/python/nnUNet_results/Dataset219_PETCT/nnUNetTrainer_1500epochs__nnUNetPlans__3d_fullres/crossval_results_folds_0_1_2_3_4/PETCT_c799ccc2f6_08262002.nii.gz,/well/papiez/users/hri611/python/nnUnet_raw/Dataset219_PETCT/labelsTr/PETCT_c799ccc2f6_08262002.nii.gz,0.9241466498103666,0.0,0.0
703,0.0,0,253,0.0,45439747,0,253,0,/well/papiez/users/hri611/python/nnUNet_results/Dataset219_PETCT/nnUNetTrainer_1500epochs__nnUNetPlans__3d_fullres/crossval_results_folds_0_1_2_3_4/PETCT_c7fd7e3e30_11132003.nii.gz,/well/papiez/users/hri611/python/nnUnet_raw/Dataset219_PETCT/labelsTr/PETCT_c7fd7e3e30_11132003.nii.gz,0.0,3.1475783042907715,0.0
704,0.0,0,14,0.0,52159986,0,14,0,/well/papiez/users/hri611/python/nnUNet_results/Dataset219_PETCT/nnUNetTrainer_1500epochs__nnUNetPlans__3d_fullres/crossval_results_folds_0_1_2_3_4/PETCT_c852dfc0a5_07262002.nii.gz,/well/papiez/users/hri611/python/nnUnet_raw/Dataset219_PETCT/labelsTr/PETCT_c852dfc0a5_07262002.nii.gz,0.0,0.1741742935180664,0.0
705,0.8715927750410509,368,23,0.7724097788125728,52158282,1327,1350,1695,/well/papiez/users/hri611/python/nnUNet_results/Dataset219_PETCT/nnUNetTrainer_1500epochs__nnUNetPlans__3d_fullres/crossval_results_folds_0_1_2_3_4/PETCT_c898e2abcb_12102004.nii.gz,/well/papiez/users/hri611/python/nnUnet_raw/Dataset219_PETCT/labelsTr/PETCT_c898e2abcb_12102004.nii.gz,0.8715927750410509,0.0,0.14929225158691406
706,0.0,0,27,0.0,52159973,0,27,0,/well/papiez/users/hri611/python/nnUNet_results/Dataset219_PETCT/nnUNetTrainer_1500epochs__nnUNetPlans__3d_fullres/crossval_results_folds_0_1_2_3_4/PETCT_c9f1b9980f_09152003.nii.gz,/well/papiez/users/hri611/python/nnUnet_raw/Dataset219_PETCT/labelsTr/PETCT_c9f1b9980f_09152003.nii.gz,0.0,0.3359075660705566,0.0
707,0.0,0,42,0.0,45439958,0,42,0,/well/papiez/users/hri611/python/nnUNet_results/Dataset219_PETCT/nnUNetTrainer_1500epochs__nnUNetPlans__3d_fullres/crossval_results_folds_0_1_2_3_4/PETCT_ca16242e89_09132002.nii.gz,/well/papiez/users/hri611/python/nnUnet_raw/Dataset219_PETCT/labelsTr/PETCT_ca16242e89_09132002.nii.gz,0.0,0.5225228805541993,0.0
708,,0,0,,45440000,0,0,0,/well/papiez/users/hri611/python/nnUNet_results/Dataset219_PETCT/nnUNetTrainer_1500epochs__nnUNetPlans__3d_fullres/crossval_results_folds_0_1_2_3_4/PETCT_ca16242e89_09182003.nii.gz,/well/papiez/users/hri611/python/nnUnet_raw/Dataset219_PETCT/labelsTr/PETCT_ca16242e89_09182003.nii.gz,,0.0,0.0
709,0.0,0,2315,0.0,45437685,0,2315,0,/well/papiez/users/hri611/python/nnUNet_results/Dataset219_PETCT/nnUNetTrainer_1500epochs__nnUNetPlans__3d_fullres/crossval_results_folds_0_1_2_3_4/PETCT_ca29501275_11042004.nii.gz,/well/papiez/users/hri611/python/nnUnet_raw/Dataset219_PETCT/labelsTr/PETCT_ca29501275_11042004.nii.gz,0.0,28.80096353530884,0.0
710,0.867354255143125,3893,917,0.7657771717958707,52139464,15726,16643,19619,/well/papiez/users/hri611/python/nnUNet_results/Dataset219_PETCT/nnUNetTrainer_1500epochs__nnUNetPlans__3d_fullres/crossval_results_folds_0_1_2_3_4/PETCT_ca47fe5e7d_09012003.nii.gz,/well/papiez/users/hri611/python/nnUnet_raw/Dataset219_PETCT/labelsTr/PETCT_ca47fe5e7d_09012003.nii.gz,0.867354255143125,8.44745323562622,0.9081945304870606
711,0.0,0,174,0.0,38719826,0,174,0,/well/papiez/users/hri611/python/nnUNet_results/Dataset219_PETCT/nnUNetTrainer_1500epochs__nnUNetPlans__3d_fullres/crossval_results_folds_0_1_2_3_4/PETCT_ca5406d339_12092004.nii.gz,/well/papiez/users/hri611/python/nnUnet_raw/Dataset219_PETCT/labelsTr/PETCT_ca5406d339_12092004.nii.gz,0.0,2.164737648010254,0.0
712,0.6859950114966593,83921,3070,0.5220642368169481,51977986,95023,98093,178944,/well/papiez/users/hri611/python/nnUNet_results/Dataset219_PETCT/nnUNetTrainer_1500epochs__nnUNetPlans__3d_fullres/crossval_results_folds_0_1_2_3_4/PETCT_ca58410fad_05232003.nii.gz,/well/papiez/users/hri611/python/nnUnet_raw/Dataset219_PETCT/labelsTr/PETCT_ca58410fad_05232003.nii.gz,0.6859950114966593,2.4259990882873534,31.338931812286376
713,0.0,0,7539,0.0,52152461,0,7539,0,/well/papiez/users/hri611/python/nnUNet_results/Dataset219_PETCT/nnUNetTrainer_1500epochs__nnUNetPlans__3d_fullres/crossval_results_folds_0_1_2_3_4/PETCT_ca62984a81_08072003.nii.gz,/well/papiez/users/hri611/python/nnUnet_raw/Dataset219_PETCT/labelsTr/PETCT_ca62984a81_08072003.nii.gz,0.0,93.79285705947876,0.0
714,0.0,0,65,0.0,52159935,0,65,0,/well/papiez/users/hri611/python/nnUNet_results/Dataset219_PETCT/nnUNetTrainer_1500epochs__nnUNetPlans__3d_fullres/crossval_results_folds_0_1_2_3_4/PETCT_ca9570a0eb_09282002.nii.gz,/well/papiez/users/hri611/python/nnUnet_raw/Dataset219_PETCT/labelsTr/PETCT_ca9570a0eb_09282002.nii.gz,0.0,0.8086663627624512,0.0
715,0.9104804510927815,1351,570,0.8356715141146279,85588310,9769,10339,11120,/well/papiez/users/hri611/python/nnUNet_results/Dataset219_PETCT/nnUNetTrainer_1500epochs__nnUNetPlans__3d_fullres/crossval_results_folds_0_1_2_3_4/PETCT_caae8d63f0_01262004.nii.gz,/well/papiez/users/hri611/python/nnUnet_raw/Dataset219_PETCT/labelsTr/PETCT_caae8d63f0_01262004.nii.gz,0.9104804510927815,1.4058353691101073,0.42299471282958984
716,0.665314401622718,1,164,0.49848024316109424,101439671,164,328,165,/well/papiez/users/hri611/python/nnUNet_results/Dataset219_PETCT/nnUNetTrainer_1500epochs__nnUNetPlans__3d_fullres/crossval_results_folds_0_1_2_3_4/PETCT_cab58c1fee_03192007.nii.gz,/well/papiez/users/hri611/python/nnUnet_raw/Dataset219_PETCT/labelsTr/PETCT_cab58c1fee_03192007.nii.gz,0.665314401622718,0.8833124885559082,0.0
717,0.4273075788852846,3812,72,0.27170448153009563,45434667,1449,1521,5261,/well/papiez/users/hri611/python/nnUNet_results/Dataset219_PETCT/nnUNetTrainer_1500epochs__nnUNetPlans__3d_fullres/crossval_results_folds_0_1_2_3_4/PETCT_cb1f5e74ab_06142001.nii.gz,/well/papiez/users/hri611/python/nnUnet_raw/Dataset219_PETCT/labelsTr/PETCT_cb1f5e74ab_06142001.nii.gz,0.4273075788852846,0.0,1.157014949798584
718,,0,0,,91040000,0,0,0,/well/papiez/users/hri611/python/nnUNet_results/Dataset219_PETCT/nnUNetTrainer_1500epochs__nnUNetPlans__3d_fullres/crossval_results_folds_0_1_2_3_4/PETCT_cb240e6f0f_04192007.nii.gz,/well/papiez/users/hri611/python/nnUnet_raw/Dataset219_PETCT/labelsTr/PETCT_cb240e6f0f_04192007.nii.gz,,0.0,0.0
719,0.8128990451504698,7364,2453,0.6847766753363517,48128857,21326,23779,28690,/well/papiez/users/hri611/python/nnUNet_results/Dataset219_PETCT/nnUNetTrainer_1500epochs__nnUNetPlans__3d_fullres/crossval_results_folds_0_1_2_3_4/PETCT_cbbc9e2879_01162006.nii.gz,/well/papiez/users/hri611/python/nnUnet_raw/Dataset219_PETCT/labelsTr/PETCT_cbbc9e2879_01162006.nii.gz,0.8128990451504698,1.6919788513183593,2.2269427528381347
720,0.0,0,4,0.0,47199996,0,4,0,/well/papiez/users/hri611/python/nnUNet_results/Dataset219_PETCT/nnUNetTrainer_1500epochs__nnUNetPlans__3d_fullres/crossval_results_folds_0_1_2_3_4/PETCT_cbbc9e2879_03312006.nii.gz,/well/papiez/users/hri611/python/nnUnet_raw/Dataset219_PETCT/labelsTr/PETCT_cbbc9e2879_03312006.nii.gz,0.0,0.04976408386230469,0.0
721,0.0,0,172,0.0,46879828,0,172,0,/well/papiez/users/hri611/python/nnUNet_results/Dataset219_PETCT/nnUNetTrainer_1500epochs__nnUNetPlans__3d_fullres/crossval_results_folds_0_1_2_3_4/PETCT_cbbc9e2879_06282007.nii.gz,/well/papiez/users/hri611/python/nnUnet_raw/Dataset219_PETCT/labelsTr/PETCT_cbbc9e2879_06282007.nii.gz,0.0,2.1398556060791014,0.0
722,0.0,0,31,0.0,46239969,0,31,0,/well/papiez/users/hri611/python/nnUNet_results/Dataset219_PETCT/nnUNetTrainer_1500epochs__nnUNetPlans__3d_fullres/crossval_results_folds_0_1_2_3_4/PETCT_cbbc9e2879_08062006.nii.gz,/well/papiez/users/hri611/python/nnUnet_raw/Dataset219_PETCT/labelsTr/PETCT_cbbc9e2879_08062006.nii.gz,0.0,0.3856716499328613,0.0
723,0.0,0,4642,0.0,45435358,0,4642,0,/well/papiez/users/hri611/python/nnUNet_results/Dataset219_PETCT/nnUNetTrainer_1500epochs__nnUNetPlans__3d_fullres/crossval_results_folds_0_1_2_3_4/PETCT_cc1698663a_10152004.nii.gz,/well/papiez/users/hri611/python/nnUnet_raw/Dataset219_PETCT/labelsTr/PETCT_cc1698663a_10152004.nii.gz,0.0,57.75121932220459,0.0
724,0.0,0,3146,0.0,45436854,0,3146,0,/well/papiez/users/hri611/python/nnUNet_results/Dataset219_PETCT/nnUNetTrainer_1500epochs__nnUNetPlans__3d_fullres/crossval_results_folds_0_1_2_3_4/PETCT_cc7cb73213_12182004.nii.gz,/well/papiez/users/hri611/python/nnUnet_raw/Dataset219_PETCT/labelsTr/PETCT_cc7cb73213_12182004.nii.gz,0.0,39.13945195770263,0.0
725,0.0,0,344,0.0,44159656,0,344,0,/well/papiez/users/hri611/python/nnUNet_results/Dataset219_PETCT/nnUNetTrainer_1500epochs__nnUNetPlans__3d_fullres/crossval_results_folds_0_1_2_3_4/PETCT_ccb9c375b2_10012005.nii.gz,/well/papiez/users/hri611/python/nnUnet_raw/Dataset219_PETCT/labelsTr/PETCT_ccb9c375b2_10012005.nii.gz,0.0,4.279711212158203,0.0
726,0.0,0,9626,0.0,50870374,0,9626,0,/well/papiez/users/hri611/python/nnUNet_results/Dataset219_PETCT/nnUNetTrainer_1500epochs__nnUNetPlans__3d_fullres/crossval_results_folds_0_1_2_3_4/PETCT_ccd8f5ff71_10292006.nii.gz,/well/papiez/users/hri611/python/nnUnet_raw/Dataset219_PETCT/labelsTr/PETCT_ccd8f5ff71_10292006.nii.gz,0.0,119.75726781463622,0.0
727,0.8570289309290683,4,3223,0.7498255678734785,52147101,9672,12895,9676,/well/papiez/users/hri611/python/nnUNet_results/Dataset219_PETCT/nnUNetTrainer_1500epochs__nnUNetPlans__3d_fullres/crossval_results_folds_0_1_2_3_4/PETCT_cd2ef932b5_04272003.nii.gz,/well/papiez/users/hri611/python/nnUnet_raw/Dataset219_PETCT/labelsTr/PETCT_cd2ef932b5_04272003.nii.gz,0.8570289309290683,5.623341476440429,0.04976408386230469
728,0.0,0,2,0.0,52159998,0,2,0,/well/papiez/users/hri611/python/nnUNet_results/Dataset219_PETCT/nnUNetTrainer_1500epochs__nnUNetPlans__3d_fullres/crossval_results_folds_0_1_2_3_4/PETCT_cd50f3fec4_12012002.nii.gz,/well/papiez/users/hri611/python/nnUnet_raw/Dataset219_PETCT/labelsTr/PETCT_cd50f3fec4_12012002.nii.gz,0.0,0.024882041931152343,0.0
729,0.0,0,177,0.0,54399823,0,177,0,/well/papiez/users/hri611/python/nnUNet_results/Dataset219_PETCT/nnUNetTrainer_1500epochs__nnUNetPlans__3d_fullres/crossval_results_folds_0_1_2_3_4/PETCT_cd9bdca46b_10052006.nii.gz,/well/papiez/users/hri611/python/nnUnet_raw/Dataset219_PETCT/labelsTr/PETCT_cd9bdca46b_10052006.nii.gz,0.0,2.2020607109069825,0.0
730,0.05990602975724354,4780,22,0.03087790110998991,92315045,153,175,4933,/well/papiez/users/hri611/python/nnUNet_results/Dataset219_PETCT/nnUNetTrainer_1500epochs__nnUNetPlans__3d_fullres/crossval_results_folds_0_1_2_3_4/PETCT_cdd237e9b3_04162005.nii.gz,/well/papiez/users/hri611/python/nnUnet_raw/Dataset219_PETCT/labelsTr/PETCT_cdd237e9b3_04162005.nii.gz,0.05990602975724354,0.0,55.43718942260742
731,0.0,0,3813,0.0,52156187,0,3813,0,/well/papiez/users/hri611/python/nnUNet_results/Dataset219_PETCT/nnUNetTrainer_1500epochs__nnUNetPlans__3d_fullres/crossval_results_folds_0_1_2_3_4/PETCT_ce0ffef966_05112003.nii.gz,/well/papiez/users/hri611/python/nnUnet_raw/Dataset219_PETCT/labelsTr/PETCT_ce0ffef966_05112003.nii.gz,0.0,47.43761294174194,0.0
732,0.7780857819666347,3029,1374,0.6367761095528791,72147878,7719,9093,10748,/well/papiez/users/hri611/python/nnUNet_results/Dataset219_PETCT/nnUNetTrainer_1500epochs__nnUNetPlans__3d_fullres/crossval_results_folds_0_1_2_3_4/PETCT_cf20ad1656_02182005.nii.gz,/well/papiez/users/hri611/python/nnUnet_raw/Dataset219_PETCT/labelsTr/PETCT_cf20ad1656_02182005.nii.gz,0.7780857819666347,0.09952816772460937,4.055772834777832
733,0.0,0,243,0.0,89759757,0,243,0,/well/papiez/users/hri611/python/nnUNet_results/Dataset219_PETCT/nnUNetTrainer_1500epochs__nnUNetPlans__3d_fullres/crossval_results_folds_0_1_2_3_4/PETCT_cf3725edf0_10072005.nii.gz,/well/papiez/users/hri611/python/nnUnet_raw/Dataset219_PETCT/labelsTr/PETCT_cf3725edf0_10072005.nii.gz,0.0,3.0231680946350097,0.0
734,,0,0,,38720000,0,0,0,/well/papiez/users/hri611/python/nnUNet_results/Dataset219_PETCT/nnUNetTrainer_1500epochs__nnUNetPlans__3d_fullres/crossval_results_folds_0_1_2_3_4/PETCT_d0086487f4_04102003.nii.gz,/well/papiez/users/hri611/python/nnUnet_raw/Dataset219_PETCT/labelsTr/PETCT_d0086487f4_04102003.nii.gz,,0.0,0.0
735,0.0,0,72,0.0,45439928,0,72,0,/well/papiez/users/hri611/python/nnUNet_results/Dataset219_PETCT/nnUNetTrainer_1500epochs__nnUNetPlans__3d_fullres/crossval_results_folds_0_1_2_3_4/PETCT_d098458d29_08012003.nii.gz,/well/papiez/users/hri611/python/nnUnet_raw/Dataset219_PETCT/labelsTr/PETCT_d098458d29_08012003.nii.gz,0.0,0.8957535095214844,0.0
736,0.0,0,49,0.0,58879951,0,49,0,/well/papiez/users/hri611/python/nnUNet_results/Dataset219_PETCT/nnUNetTrainer_1500epochs__nnUNetPlans__3d_fullres/crossval_results_folds_0_1_2_3_4/PETCT_d0ea6c975f_10112002.nii.gz,/well/papiez/users/hri611/python/nnUnet_raw/Dataset219_PETCT/labelsTr/PETCT_d0ea6c975f_10112002.nii.gz,0.0,0.6096100273132324,0.0
737,0.0,0,569,0.0,52159431,0,569,0,/well/papiez/users/hri611/python/nnUNet_results/Dataset219_PETCT/nnUNetTrainer_1500epochs__nnUNetPlans__3d_fullres/crossval_results_folds_0_1_2_3_4/PETCT_d103e57f0e_12122002.nii.gz,/well/papiez/users/hri611/python/nnUnet_raw/Dataset219_PETCT/labelsTr/PETCT_d103e57f0e_12122002.nii.gz,0.0,7.078940929412842,0.0
738,0.4411872480762184,2982,68,0.2830277385989657,52155746,1204,1272,4186,/well/papiez/users/hri611/python/nnUNet_results/Dataset219_PETCT/nnUNetTrainer_1500epochs__nnUNetPlans__3d_fullres/crossval_results_folds_0_1_2_3_4/PETCT_d1c8141930_06142002.nii.gz,/well/papiez/users/hri611/python/nnUnet_raw/Dataset219_PETCT/labelsTr/PETCT_d1c8141930_06142002.nii.gz,0.4411872480762184,0.6096100273132324,18.97255697250366
739,,0,0,,49920000,0,0,0,/well/papiez/users/hri611/python/nnUNet_results/Dataset219_PETCT/nnUNetTrainer_1500epochs__nnUNetPlans__3d_fullres/crossval_results_folds_0_1_2_3_4/PETCT_d1f456d229_09012006.nii.gz,/well/papiez/users/hri611/python/nnUnet_raw/Dataset219_PETCT/labelsTr/PETCT_d1f456d229_09012006.nii.gz,,0.0,0.0
740,0.6474608678281466,9762,14945,0.478700284840173,46672605,22688,37633,32450,/well/papiez/users/hri611/python/nnUNet_results/Dataset219_PETCT/nnUNetTrainer_1500epochs__nnUNetPlans__3d_fullres/crossval_results_folds_0_1_2_3_4/PETCT_d206b891ee_10272005.nii.gz,/well/papiez/users/hri611/python/nnUnet_raw/Dataset219_PETCT/labelsTr/PETCT_d206b891ee_10272005.nii.gz,0.6474608678281466,109.00822570037842,5.68554658126831
741,0.0,0,307,0.0,92319693,0,307,0,/well/papiez/users/hri611/python/nnUNet_results/Dataset219_PETCT/nnUNetTrainer_1500epochs__nnUNetPlans__3d_fullres/crossval_results_folds_0_1_2_3_4/PETCT_d27451634d_03122005.nii.gz,/well/papiez/users/hri611/python/nnUnet_raw/Dataset219_PETCT/labelsTr/PETCT_d27451634d_03122005.nii.gz,0.0,3.8193934364318847,0.0
742,0.0,0,1,0.0,52159999,0,1,0,/well/papiez/users/hri611/python/nnUNet_results/Dataset219_PETCT/nnUNetTrainer_1500epochs__nnUNetPlans__3d_fullres/crossval_results_folds_0_1_2_3_4/PETCT_d31a5688a2_09212003.nii.gz,/well/papiez/users/hri611/python/nnUnet_raw/Dataset219_PETCT/labelsTr/PETCT_d31a5688a2_09212003.nii.gz,0.0,0.012441020965576172,0.0
743,0.8208229637756785,483,19604,0.6960981587666611,52093903,46010,65614,46493,/well/papiez/users/hri611/python/nnUNet_results/Dataset219_PETCT/nnUNetTrainer_1500epochs__nnUNetPlans__3d_fullres/crossval_results_folds_0_1_2_3_4/PETCT_d31c9ebd93_07212003.nii.gz,/well/papiez/users/hri611/python/nnUnet_raw/Dataset219_PETCT/labelsTr/PETCT_d31c9ebd93_07212003.nii.gz,0.8208229637756785,0.32346654510498046,0.49764083862304687
744,0.0,0,9,0.0,45439991,0,9,0,/well/papiez/users/hri611/python/nnUNet_results/Dataset219_PETCT/nnUNetTrainer_1500epochs__nnUNetPlans__3d_fullres/crossval_results_folds_0_1_2_3_4/PETCT_d3208ff062_03142003.nii.gz,/well/papiez/users/hri611/python/nnUnet_raw/Dataset219_PETCT/labelsTr/PETCT_d3208ff062_03142003.nii.gz,0.0,0.11196918869018554,0.0
745,0.0,0,443,0.0,51679557,0,443,0,/well/papiez/users/hri611/python/nnUNet_results/Dataset219_PETCT/nnUNetTrainer_1500epochs__nnUNetPlans__3d_fullres/crossval_results_folds_0_1_2_3_4/PETCT_d325897ff4_05102007.nii.gz,/well/papiez/users/hri611/python/nnUnet_raw/Dataset219_PETCT/labelsTr/PETCT_d325897ff4_05102007.nii.gz,0.0,5.511372287750244,0.0
746,0.0,0,609,0.0,52479391,0,609,0,/well/papiez/users/hri611/python/nnUNet_results/Dataset219_PETCT/nnUNetTrainer_1500epochs__nnUNetPlans__3d_fullres/crossval_results_folds_0_1_2_3_4/PETCT_d325897ff4_07152005.nii.gz,/well/papiez/users/hri611/python/nnUnet_raw/Dataset219_PETCT/labelsTr/PETCT_d325897ff4_07152005.nii.gz,0.0,7.576581768035888,0.0
747,0.0,0,10,0.0,50879990,0,10,0,/well/papiez/users/hri611/python/nnUNet_results/Dataset219_PETCT/nnUNetTrainer_1500epochs__nnUNetPlans__3d_fullres/crossval_results_folds_0_1_2_3_4/PETCT_d325897ff4_11122005.nii.gz,/well/papiez/users/hri611/python/nnUnet_raw/Dataset219_PETCT/labelsTr/PETCT_d325897ff4_11122005.nii.gz,0.0,0.12441020965576172,0.0
748,0.0,0,12,0.0,52159988,0,12,0,/well/papiez/users/hri611/python/nnUNet_results/Dataset219_PETCT/nnUNetTrainer_1500epochs__nnUNetPlans__3d_fullres/crossval_results_folds_0_1_2_3_4/PETCT_d32cf972af_03132003.nii.gz,/well/papiez/users/hri611/python/nnUnet_raw/Dataset219_PETCT/labelsTr/PETCT_d32cf972af_03132003.nii.gz,0.0,0.14929225158691406,0.0
749,0.45019607843137255,2625,179,0.29048582995951416,45436048,1148,1327,3773,/well/papiez/users/hri611/python/nnUNet_results/Dataset219_PETCT/nnUNetTrainer_1500epochs__nnUNetPlans__3d_fullres/crossval_results_folds_0_1_2_3_4/PETCT_d393ab6c7b_09222002.nii.gz,/well/papiez/users/hri611/python/nnUnet_raw/Dataset219_PETCT/labelsTr/PETCT_d393ab6c7b_09222002.nii.gz,0.45019607843137255,2.0652094802856444,0.0
750,,0,0,,48480000,0,0,0,/well/papiez/users/hri611/python/nnUNet_results/Dataset219_PETCT/nnUNetTrainer_1500epochs__nnUNetPlans__3d_fullres/crossval_results_folds_0_1_2_3_4/PETCT_d3d3b7d4ff_08312006.nii.gz,/well/papiez/users/hri611/python/nnUnet_raw/Dataset219_PETCT/labelsTr/PETCT_d3d3b7d4ff_08312006.nii.gz,,0.0,0.0
751,0.8675001886744987,2803,2464,0.7660047092274201,52137491,17242,19706,20045,/well/papiez/users/hri611/python/nnUNet_results/Dataset219_PETCT/nnUNetTrainer_1500epochs__nnUNetPlans__3d_fullres/crossval_results_folds_0_1_2_3_4/PETCT_d3d61785e6_10192001.nii.gz,/well/papiez/users/hri611/python/nnUnet_raw/Dataset219_PETCT/labelsTr/PETCT_d3d61785e6_10192001.nii.gz,0.8675001886744987,1.3809533271789551,19.880751502990723
752,0.6556564220350724,17048,1842,0.4877149210826056,72123126,17984,19826,35032,/well/papiez/users/hri611/python/nnUNet_results/Dataset219_PETCT/nnUNetTrainer_1500epochs__nnUNetPlans__3d_fullres/crossval_results_folds_0_1_2_3_4/PETCT_d3dac0d1cd_08092003.nii.gz,/well/papiez/users/hri611/python/nnUnet_raw/Dataset219_PETCT/labelsTr/PETCT_d3dac0d1cd_08092003.nii.gz,0.6556564220350724,1.1445739288330077,0.012441020965576172
753,0.0,0,11,0.0,45439989,0,11,0,/well/papiez/users/hri611/python/nnUNet_results/Dataset219_PETCT/nnUNetTrainer_1500epochs__nnUNetPlans__3d_fullres/crossval_results_folds_0_1_2_3_4/PETCT_d3f13dff4b_08242003.nii.gz,/well/papiez/users/hri611/python/nnUnet_raw/Dataset219_PETCT/labelsTr/PETCT_d3f13dff4b_08242003.nii.gz,0.0,0.1368512306213379,0.0
754,0.7466500897914077,3425,243,0.595723575443624,52150927,5405,5648,8830,/well/papiez/users/hri611/python/nnUNet_results/Dataset219_PETCT/nnUNetTrainer_1500epochs__nnUNetPlans__3d_fullres/crossval_results_folds_0_1_2_3_4/PETCT_d40a16781a_09132003.nii.gz,/well/papiez/users/hri611/python/nnUnet_raw/Dataset219_PETCT/labelsTr/PETCT_d40a16781a_09132003.nii.gz,0.7466500897914077,0.721579216003418,0.012441020965576172
755,0.7422087688236526,7008,6533,0.5900889992129321,45406966,19493,26026,26501,/well/papiez/users/hri611/python/nnUNet_results/Dataset219_PETCT/nnUNetTrainer_1500epochs__nnUNetPlans__3d_fullres/crossval_results_folds_0_1_2_3_4/PETCT_d4112bc7ba_01292001.nii.gz,/well/papiez/users/hri611/python/nnUnet_raw/Dataset219_PETCT/labelsTr/PETCT_d4112bc7ba_01292001.nii.gz,0.7422087688236526,54.28017447280884,26.113703006744384
756,0.7151254920002045,5289,284,0.5565722469764481,52147432,6995,7279,12284,/well/papiez/users/hri611/python/nnUNet_results/Dataset219_PETCT/nnUNetTrainer_1500epochs__nnUNetPlans__3d_fullres/crossval_results_folds_0_1_2_3_4/PETCT_d46f0109f8_09092000.nii.gz,/well/papiez/users/hri611/python/nnUnet_raw/Dataset219_PETCT/labelsTr/PETCT_d46f0109f8_09092000.nii.gz,0.7151254920002045,0.1368512306213379,37.124006561279295
757,0.0,0,133,0.0,45439867,0,133,0,/well/papiez/users/hri611/python/nnUNet_results/Dataset219_PETCT/nnUNetTrainer_1500epochs__nnUNetPlans__3d_fullres/crossval_results_folds_0_1_2_3_4/PETCT_d472033d3b_09282002.nii.gz,/well/papiez/users/hri611/python/nnUnet_raw/Dataset219_PETCT/labelsTr/PETCT_d472033d3b_09282002.nii.gz,0.0,1.6546557884216309,0.0
758,,0,0,,50080000,0,0,0,/well/papiez/users/hri611/python/nnUNet_results/Dataset219_PETCT/nnUNetTrainer_1500epochs__nnUNetPlans__3d_fullres/crossval_results_folds_0_1_2_3_4/PETCT_d4a08e4bde_03162006.nii.gz,/well/papiez/users/hri611/python/nnUnet_raw/Dataset219_PETCT/labelsTr/PETCT_d4a08e4bde_03162006.nii.gz,,0.0,0.0
759,0.6791383438900046,63524,2938,0.5141631152274505,45303201,70337,73275,133861,/well/papiez/users/hri611/python/nnUNet_results/Dataset219_PETCT/nnUNetTrainer_1500epochs__nnUNetPlans__3d_fullres/crossval_results_folds_0_1_2_3_4/PETCT_d4b2ff9721_12162001.nii.gz,/well/papiez/users/hri611/python/nnUnet_raw/Dataset219_PETCT/labelsTr/PETCT_d4b2ff9721_12162001.nii.gz,0.6791383438900046,1.530245578765869,166.759445022583
760,0.0,0,295,0.0,49759705,0,295,0,/well/papiez/users/hri611/python/nnUNet_results/Dataset219_PETCT/nnUNetTrainer_1500epochs__nnUNetPlans__3d_fullres/crossval_results_folds_0_1_2_3_4/PETCT_d4d3d7dfc1_09122005.nii.gz,/well/papiez/users/hri611/python/nnUnet_raw/Dataset219_PETCT/labelsTr/PETCT_d4d3d7dfc1_09122005.nii.gz,0.0,3.6701011848449707,0.0
761,0.46048575080833143,2104,5071,0.29911106769561396,91829763,3062,8133,5166,/well/papiez/users/hri611/python/nnUNet_results/Dataset219_PETCT/nnUNetTrainer_1500epochs__nnUNetPlans__3d_fullres/crossval_results_folds_0_1_2_3_4/PETCT_d4f3375362_05272005.nii.gz,/well/papiez/users/hri611/python/nnUnet_raw/Dataset219_PETCT/labelsTr/PETCT_d4f3375362_05272005.nii.gz,0.46048575080833143,60.562890060424806,1.1818969917297364
762,0.914119498354871,785,1016,0.8418232917618127,75188614,9585,10601,10370,/well/papiez/users/hri611/python/nnUNet_results/Dataset219_PETCT/nnUNetTrainer_1500epochs__nnUNetPlans__3d_fullres/crossval_results_folds_0_1_2_3_4/PETCT_d5103c8fbf_04142006.nii.gz,/well/papiez/users/hri611/python/nnUnet_raw/Dataset219_PETCT/labelsTr/PETCT_d5103c8fbf_04142006.nii.gz,0.914119498354871,0.024882041931152343,0.0
763,0.9262688784352563,386,1103,0.8626637151817008,45429158,9353,10456,9739,/well/papiez/users/hri611/python/nnUNet_results/Dataset219_PETCT/nnUNetTrainer_1500epochs__nnUNetPlans__3d_fullres/crossval_results_folds_0_1_2_3_4/PETCT_d51664a9e4_11052004.nii.gz,/well/papiez/users/hri611/python/nnUnet_raw/Dataset219_PETCT/labelsTr/PETCT_d51664a9e4_11052004.nii.gz,0.9262688784352563,0.3981126708984375,0.0
764,0.9147101881472646,1188,385,0.8428257394084733,45429992,8435,8820,9623,/well/papiez/users/hri611/python/nnUNet_results/Dataset219_PETCT/nnUNetTrainer_1500epochs__nnUNetPlans__3d_fullres/crossval_results_folds_0_1_2_3_4/PETCT_d51bacdaba_06282001.nii.gz,/well/papiez/users/hri611/python/nnUnet_raw/Dataset219_PETCT/labelsTr/PETCT_d51bacdaba_06282001.nii.gz,0.9147101881472646,0.16173327255249023,0.012441020965576172
765,0.0,0,9,0.0,85599991,0,9,0,/well/papiez/users/hri611/python/nnUNet_results/Dataset219_PETCT/nnUNetTrainer_1500epochs__nnUNetPlans__3d_fullres/crossval_results_folds_0_1_2_3_4/PETCT_d539f5a88b_06232003.nii.gz,/well/papiez/users/hri611/python/nnUnet_raw/Dataset219_PETCT/labelsTr/PETCT_d539f5a88b_06232003.nii.gz,0.0,0.11196918869018554,0.0
766,0.0,0,37,0.0,72159963,0,37,0,/well/papiez/users/hri611/python/nnUNet_results/Dataset219_PETCT/nnUNetTrainer_1500epochs__nnUNetPlans__3d_fullres/crossval_results_folds_0_1_2_3_4/PETCT_d5e2aa7feb_04172003.nii.gz,/well/papiez/users/hri611/python/nnUnet_raw/Dataset219_PETCT/labelsTr/PETCT_d5e2aa7feb_04172003.nii.gz,0.0,0.4603177757263184,0.0
767,0.0,0,823,0.0,58879177,0,823,0,/well/papiez/users/hri611/python/nnUNet_results/Dataset219_PETCT/nnUNetTrainer_1500epochs__nnUNetPlans__3d_fullres/crossval_results_folds_0_1_2_3_4/PETCT_d626611daf_04032003.nii.gz,/well/papiez/users/hri611/python/nnUnet_raw/Dataset219_PETCT/labelsTr/PETCT_d626611daf_04032003.nii.gz,0.0,10.23896025466919,0.0
768,0.0,0,42,0.0,55359958,0,42,0,/well/papiez/users/hri611/python/nnUNet_results/Dataset219_PETCT/nnUNetTrainer_1500epochs__nnUNetPlans__3d_fullres/crossval_results_folds_0_1_2_3_4/PETCT_d626611daf_06192005.nii.gz,/well/papiez/users/hri611/python/nnUnet_raw/Dataset219_PETCT/labelsTr/PETCT_d626611daf_06192005.nii.gz,0.0,0.5225228805541993,0.0
769,0.0,0,237,0.0,58879763,0,237,0,/well/papiez/users/hri611/python/nnUNet_results/Dataset219_PETCT/nnUNetTrainer_1500epochs__nnUNetPlans__3d_fullres/crossval_results_folds_0_1_2_3_4/PETCT_d626611daf_10022003.nii.gz,/well/papiez/users/hri611/python/nnUnet_raw/Dataset219_PETCT/labelsTr/PETCT_d626611daf_10022003.nii.gz,0.0,2.9485219688415527,0.0
770,0.0,0,230,0.0,58879770,0,230,0,/well/papiez/users/hri611/python/nnUNet_results/Dataset219_PETCT/nnUNetTrainer_1500epochs__nnUNetPlans__3d_fullres/crossval_results_folds_0_1_2_3_4/PETCT_d626611daf_11122004.nii.gz,/well/papiez/users/hri611/python/nnUnet_raw/Dataset219_PETCT/labelsTr/PETCT_d626611daf_11122004.nii.gz,0.0,2.8614348220825194,0.0
771,0.5058830814961606,31862,54,0.3385833298793882,105711746,16338,16392,48200,/well/papiez/users/hri611/python/nnUNet_results/Dataset219_PETCT/nnUNetTrainer_1500epochs__nnUNetPlans__3d_fullres/crossval_results_folds_0_1_2_3_4/PETCT_d626611daf_11292002.nii.gz,/well/papiez/users/hri611/python/nnUnet_raw/Dataset219_PETCT/labelsTr/PETCT_d626611daf_11292002.nii.gz,0.5058830814961606,0.0,0.037323062896728515
772,0.8442917382476964,60,937,0.7305405405405405,73116300,2703,3640,2763,/well/papiez/users/hri611/python/nnUNet_results/Dataset219_PETCT/nnUNetTrainer_1500epochs__nnUNetPlans__3d_fullres/crossval_results_folds_0_1_2_3_4/PETCT_d63f6162a6_07082005.nii.gz,/well/papiez/users/hri611/python/nnUnet_raw/Dataset219_PETCT/labelsTr/PETCT_d63f6162a6_07082005.nii.gz,0.8442917382476964,0.8211073837280274,0.024882041931152343
773,,0,0,,45440000,0,0,0,/well/papiez/users/hri611/python/nnUNet_results/Dataset219_PETCT/nnUNetTrainer_1500epochs__nnUNetPlans__3d_fullres/crossval_results_folds_0_1_2_3_4/PETCT_d64d6a87c8_12182004.nii.gz,/well/papiez/users/hri611/python/nnUnet_raw/Dataset219_PETCT/labelsTr/PETCT_d64d6a87c8_12182004.nii.gz,,0.0,0.0
774,0.8733624454148472,0,29,0.7751937984496124,52479871,100,129,100,/well/papiez/users/hri611/python/nnUNet_results/Dataset219_PETCT/nnUNetTrainer_1500epochs__nnUNetPlans__3d_fullres/crossval_results_folds_0_1_2_3_4/PETCT_d65cf203be_04282007.nii.gz,/well/papiez/users/hri611/python/nnUnet_raw/Dataset219_PETCT/labelsTr/PETCT_d65cf203be_04282007.nii.gz,0.8733624454148472,0.0,0.0
775,0.8651162790697674,16,13,0.7622950819672131,45439878,93,106,109,/well/papiez/users/hri611/python/nnUNet_results/Dataset219_PETCT/nnUNetTrainer_1500epochs__nnUNetPlans__3d_fullres/crossval_results_folds_0_1_2_3_4/PETCT_d674a028b1_12032001.nii.gz,/well/papiez/users/hri611/python/nnUnet_raw/Dataset219_PETCT/labelsTr/PETCT_d674a028b1_12032001.nii.gz,0.8651162790697674,0.0,0.0
776,0.751647589316684,213,1219,0.6021116976938038,52156401,2167,3386,2380,/well/papiez/users/hri611/python/nnUNet_results/Dataset219_PETCT/nnUNetTrainer_1500epochs__nnUNetPlans__3d_fullres/crossval_results_folds_0_1_2_3_4/PETCT_d69c3fceba_04052003.nii.gz,/well/papiez/users/hri611/python/nnUnet_raw/Dataset219_PETCT/labelsTr/PETCT_d69c3fceba_04052003.nii.gz,0.751647589316684,4.864439197540283,2.6499374656677244
777,0.6956707839060781,9797,157,0.5333552107261732,45418669,11377,11534,21174,/well/papiez/users/hri611/python/nnUNet_results/Dataset219_PETCT/nnUNetTrainer_1500epochs__nnUNetPlans__3d_fullres/crossval_results_folds_0_1_2_3_4/PETCT_d69eabbb20_02012001.nii.gz,/well/papiez/users/hri611/python/nnUnet_raw/Dataset219_PETCT/labelsTr/PETCT_d69eabbb20_02012001.nii.gz,0.6956707839060781,0.11196918869018554,39.425595439910886
778,,0,0,,58880000,0,0,0,/well/papiez/users/hri611/python/nnUNet_results/Dataset219_PETCT/nnUNetTrainer_1500epochs__nnUNetPlans__3d_fullres/crossval_results_folds_0_1_2_3_4/PETCT_d6a48a629d_03062003.nii.gz,/well/papiez/users/hri611/python/nnUnet_raw/Dataset219_PETCT/labelsTr/PETCT_d6a48a629d_03062003.nii.gz,,0.0,0.0
779,,0,0,,52160000,0,0,0,/well/papiez/users/hri611/python/nnUNet_results/Dataset219_PETCT/nnUNetTrainer_1500epochs__nnUNetPlans__3d_fullres/crossval_results_folds_0_1_2_3_4/PETCT_d6a48a629d_07272002.nii.gz,/well/papiez/users/hri611/python/nnUnet_raw/Dataset219_PETCT/labelsTr/PETCT_d6a48a629d_07272002.nii.gz,,0.0,0.0
780,0.0,0,1859,0.0,99038141,0,1859,0,/well/papiez/users/hri611/python/nnUNet_results/Dataset219_PETCT/nnUNetTrainer_1500epochs__nnUNetPlans__3d_fullres/crossval_results_folds_0_1_2_3_4/PETCT_d6a491e16d_05302003.nii.gz,/well/papiez/users/hri611/python/nnUnet_raw/Dataset219_PETCT/labelsTr/PETCT_d6a491e16d_05302003.nii.gz,0.0,23.127857975006105,0.0
781,,0,0,,45440000,0,0,0,/well/papiez/users/hri611/python/nnUNet_results/Dataset219_PETCT/nnUNetTrainer_1500epochs__nnUNetPlans__3d_fullres/crossval_results_folds_0_1_2_3_4/PETCT_d6b2218bf3_12182004.nii.gz,/well/papiez/users/hri611/python/nnUnet_raw/Dataset219_PETCT/labelsTr/PETCT_d6b2218bf3_12182004.nii.gz,,0.0,0.0
782,0.2775984506132989,1117,2,0.16116941529235382,54078666,215,217,1332,/well/papiez/users/hri611/python/nnUNet_results/Dataset219_PETCT/nnUNetTrainer_1500epochs__nnUNetPlans__3d_fullres/crossval_results_folds_0_1_2_3_4/PETCT_d6de1252d9_05132007.nii.gz,/well/papiez/users/hri611/python/nnUnet_raw/Dataset219_PETCT/labelsTr/PETCT_d6de1252d9_05132007.nii.gz,0.2775984506132989,0.0,12.938661804199219
783,0.5922779922779923,692,364,0.42073505211190343,47838177,767,1131,1459,/well/papiez/users/hri611/python/nnUNet_results/Dataset219_PETCT/nnUNetTrainer_1500epochs__nnUNetPlans__3d_fullres/crossval_results_folds_0_1_2_3_4/PETCT_d8a92bafe3_03182007.nii.gz,/well/papiez/users/hri611/python/nnUnet_raw/Dataset219_PETCT/labelsTr/PETCT_d8a92bafe3_03182007.nii.gz,0.5922779922779923,0.8584304466247559,6.369802734375
784,0.7212931995540691,7,993,0.5640802092414996,92317706,1294,2287,1301,/well/papiez/users/hri611/python/nnUNet_results/Dataset219_PETCT/nnUNetTrainer_1500epochs__nnUNetPlans__3d_fullres/crossval_results_folds_0_1_2_3_4/PETCT_d8d9e52cd5_03132005.nii.gz,/well/papiez/users/hri611/python/nnUnet_raw/Dataset219_PETCT/labelsTr/PETCT_d8d9e52cd5_03132005.nii.gz,0.7212931995540691,3.76962935256958,0.012441020965576172
785,0.8334689890932769,168,1878,0.7144850683784538,100472834,5120,6998,5288,/well/papiez/users/hri611/python/nnUNet_results/Dataset219_PETCT/nnUNetTrainer_1500epochs__nnUNetPlans__3d_fullres/crossval_results_folds_0_1_2_3_4/PETCT_d8d9e52cd5_05072007.nii.gz,/well/papiez/users/hri611/python/nnUnet_raw/Dataset219_PETCT/labelsTr/PETCT_d8d9e52cd5_05072007.nii.gz,0.8334689890932769,1.2689841384887695,0.435435733795166
786,0.7871036504130029,166,633,0.6489455184534271,92317724,1477,2110,1643,/well/papiez/users/hri611/python/nnUNet_results/Dataset219_PETCT/nnUNetTrainer_1500epochs__nnUNetPlans__3d_fullres/crossval_results_folds_0_1_2_3_4/PETCT_d8d9e52cd5_07042004.nii.gz,/well/papiez/users/hri611/python/nnUnet_raw/Dataset219_PETCT/labelsTr/PETCT_d8d9e52cd5_07042004.nii.gz,0.7871036504130029,3.2222244300842284,0.0
787,0.3640066923692442,7547,1196,0.22249888839484216,94068755,2502,3698,10049,/well/papiez/users/hri611/python/nnUNet_results/Dataset219_PETCT/nnUNetTrainer_1500epochs__nnUNetPlans__3d_fullres/crossval_results_folds_0_1_2_3_4/PETCT_d8d9e52cd5_10072005.nii.gz,/well/papiez/users/hri611/python/nnUnet_raw/Dataset219_PETCT/labelsTr/PETCT_d8d9e52cd5_10072005.nii.gz,0.3640066923692442,8.323043025970458,17.330342205047607
788,0.0,0,449,0.0,52159551,0,449,0,/well/papiez/users/hri611/python/nnUNet_results/Dataset219_PETCT/nnUNetTrainer_1500epochs__nnUNetPlans__3d_fullres/crossval_results_folds_0_1_2_3_4/PETCT_d8e3aa97a0_05192005.nii.gz,/well/papiez/users/hri611/python/nnUnet_raw/Dataset219_PETCT/labelsTr/PETCT_d8e3aa97a0_05192005.nii.gz,0.0,5.586018413543701,0.0
789,0.9243686279736123,2046,224,0.8593730640564986,45423858,13872,14096,15918,/well/papiez/users/hri611/python/nnUNet_results/Dataset219_PETCT/nnUNetTrainer_1500epochs__nnUNetPlans__3d_fullres/crossval_results_folds_0_1_2_3_4/PETCT_d951eeb735_01232003.nii.gz,/well/papiez/users/hri611/python/nnUnet_raw/Dataset219_PETCT/labelsTr/PETCT_d951eeb735_01232003.nii.gz,0.9243686279736123,0.0,0.6842561531066894
790,0.7971171171171171,2127,125,0.6626722588376274,99033324,4424,4549,6551,/well/papiez/users/hri611/python/nnUNet_results/Dataset219_PETCT/nnUNetTrainer_1500epochs__nnUNetPlans__3d_fullres/crossval_results_folds_0_1_2_3_4/PETCT_d9da6129f8_04142002.nii.gz,/well/papiez/users/hri611/python/nnUnet_raw/Dataset219_PETCT/labelsTr/PETCT_d9da6129f8_04142002.nii.gz,0.7971171171171171,1.2192200546264649,0.012441020965576172
791,0.0,0,853,0.0,52159147,0,853,0,/well/papiez/users/hri611/python/nnUNet_results/Dataset219_PETCT/nnUNetTrainer_1500epochs__nnUNetPlans__3d_fullres/crossval_results_folds_0_1_2_3_4/PETCT_da4ce0da01_06132003.nii.gz,/well/papiez/users/hri611/python/nnUnet_raw/Dataset219_PETCT/labelsTr/PETCT_da4ce0da01_06132003.nii.gz,0.0,10.612190883636474,0.0
792,0.755618979664645,261,1109,0.6072247706422018,45436512,2118,3227,2379,/well/papiez/users/hri611/python/nnUNet_results/Dataset219_PETCT/nnUNetTrainer_1500epochs__nnUNetPlans__3d_fullres/crossval_results_folds_0_1_2_3_4/PETCT_da6161d7eb_06202003.nii.gz,/well/papiez/users/hri611/python/nnUnet_raw/Dataset219_PETCT/labelsTr/PETCT_da6161d7eb_06202003.nii.gz,0.755618979664645,7.054058887481689,0.7091381950378418
793,0.8231114525072614,5970,1399,0.6993962633597128,52135486,17145,18544,23115,/well/papiez/users/hri611/python/nnUNet_results/Dataset219_PETCT/nnUNetTrainer_1500epochs__nnUNetPlans__3d_fullres/crossval_results_folds_0_1_2_3_4/PETCT_dac5cd2a4d_12022001.nii.gz,/well/papiez/users/hri611/python/nnUnet_raw/Dataset219_PETCT/labelsTr/PETCT_dac5cd2a4d_12022001.nii.gz,0.8231114525072614,0.037323062896728515,4.61561877822876
794,0.06022052586938083,16,2200,0.031045037166593792,99037713,71,2271,87,/well/papiez/users/hri611/python/nnUNet_results/Dataset219_PETCT/nnUNetTrainer_1500epochs__nnUNetPlans__3d_fullres/crossval_results_folds_0_1_2_3_4/PETCT_dadcd69ba9_05192005.nii.gz,/well/papiez/users/hri611/python/nnUnet_raw/Dataset219_PETCT/labelsTr/PETCT_dadcd69ba9_05192005.nii.gz,0.06022052586938083,27.345364082336424,0.0
795,0.0,0,1291,0.0,52158709,0,1291,0,/well/papiez/users/hri611/python/nnUNet_results/Dataset219_PETCT/nnUNetTrainer_1500epochs__nnUNetPlans__3d_fullres/crossval_results_folds_0_1_2_3_4/PETCT_dae86b88e2_06212003.nii.gz,/well/papiez/users/hri611/python/nnUnet_raw/Dataset219_PETCT/labelsTr/PETCT_dae86b88e2_06212003.nii.gz,0.0,16.06135806655884,0.0
796,0.0,0,247,0.0,51039753,0,247,0,/well/papiez/users/hri611/python/nnUNet_results/Dataset219_PETCT/nnUNetTrainer_1500epochs__nnUNetPlans__3d_fullres/crossval_results_folds_0_1_2_3_4/PETCT_db3bac356a_08212005.nii.gz,/well/papiez/users/hri611/python/nnUnet_raw/Dataset219_PETCT/labelsTr/PETCT_db3bac356a_08212005.nii.gz,0.0,3.0729321784973145,0.0
797,0.9295488416203767,390,650,0.8683710922668016,52152099,6861,7511,7251,/well/papiez/users/hri611/python/nnUNet_results/Dataset219_PETCT/nnUNetTrainer_1500epochs__nnUNetPlans__3d_fullres/crossval_results_folds_0_1_2_3_4/PETCT_db3daf78d2_10302000.nii.gz,/well/papiez/users/hri611/python/nnUnet_raw/Dataset219_PETCT/labelsTr/PETCT_db3daf78d2_10302000.nii.gz,0.9295488416203767,0.6593741111755371,0.0
798,0.0,0,1,0.0,47999999,0,1,0,/well/papiez/users/hri611/python/nnUNet_results/Dataset219_PETCT/nnUNetTrainer_1500epochs__nnUNetPlans__3d_fullres/crossval_results_folds_0_1_2_3_4/PETCT_dc15c1d9bb_06032005.nii.gz,/well/papiez/users/hri611/python/nnUnet_raw/Dataset219_PETCT/labelsTr/PETCT_dc15c1d9bb_06032005.nii.gz,0.0,0.012441020965576172,0.0
799,0.837678419736543,640,12927,0.7206941985424301,45391426,35007,47934,35647,/well/papiez/users/hri611/python/nnUNet_results/Dataset219_PETCT/nnUNetTrainer_1500epochs__nnUNetPlans__3d_fullres/crossval_results_folds_0_1_2_3_4/PETCT_dc6174cb5d_03292003.nii.gz,/well/papiez/users/hri611/python/nnUnet_raw/Dataset219_PETCT/labelsTr/PETCT_dc6174cb5d_03292003.nii.gz,0.837678419736543,2.33891194152832,5.337197994232177
800,0.9051965213115761,953,2132,0.826811878964801,45422187,14728,16860,15681,/well/papiez/users/hri611/python/nnUNet_results/Dataset219_PETCT/nnUNetTrainer_1500epochs__nnUNetPlans__3d_fullres/crossval_results_folds_0_1_2_3_4/PETCT_dc6174cb5d_12152002.nii.gz,/well/papiez/users/hri611/python/nnUnet_raw/Dataset219_PETCT/labelsTr/PETCT_dc6174cb5d_12152002.nii.gz,0.9051965213115761,0.435435733795166,0.48519981765747067
801,0.0,0,13,0.0,48159987,0,13,0,/well/papiez/users/hri611/python/nnUNet_results/Dataset219_PETCT/nnUNetTrainer_1500epochs__nnUNetPlans__3d_fullres/crossval_results_folds_0_1_2_3_4/PETCT_dd6165ae36_06012006.nii.gz,/well/papiez/users/hri611/python/nnUnet_raw/Dataset219_PETCT/labelsTr/PETCT_dd6165ae36_06012006.nii.gz,0.0,0.16173327255249023,0.0
802,0.7001733102253033,343,3,0.5386666666666666,45439250,404,407,747,/well/papiez/users/hri611/python/nnUNet_results/Dataset219_PETCT/nnUNetTrainer_1500epochs__nnUNetPlans__3d_fullres/crossval_results_folds_0_1_2_3_4/PETCT_dd68a71e0a_11202004.nii.gz,/well/papiez/users/hri611/python/nnUnet_raw/Dataset219_PETCT/labelsTr/PETCT_dd68a71e0a_11202004.nii.gz,0.7001733102253033,0.0,0.4105536918640137
803,0.0,0,414,0.0,47999586,0,414,0,/well/papiez/users/hri611/python/nnUNet_results/Dataset219_PETCT/nnUNetTrainer_1500epochs__nnUNetPlans__3d_fullres/crossval_results_folds_0_1_2_3_4/PETCT_dd887591a9_05062006.nii.gz,/well/papiez/users/hri611/python/nnUnet_raw/Dataset219_PETCT/labelsTr/PETCT_dd887591a9_05062006.nii.gz,0.0,5.150582679748535,0.0
804,0.704487838300788,2143,2170,0.5437909879416121,52150546,5141,7311,7284,/well/papiez/users/hri611/python/nnUNet_results/Dataset219_PETCT/nnUNetTrainer_1500epochs__nnUNetPlans__3d_fullres/crossval_results_folds_0_1_2_3_4/PETCT_dd8f9f217c_02152004.nii.gz,/well/papiez/users/hri611/python/nnUnet_raw/Dataset219_PETCT/labelsTr/PETCT_dd8f9f217c_02152004.nii.gz,0.704487838300788,4.217506107330323,4.043331813812256
805,0.8536143486925539,4099,749,0.7446136016435758,45421017,14135,14884,18234,/well/papiez/users/hri611/python/nnUNet_results/Dataset219_PETCT/nnUNetTrainer_1500epochs__nnUNetPlans__3d_fullres/crossval_results_folds_0_1_2_3_4/PETCT_dd975744e7_09232001.nii.gz,/well/papiez/users/hri611/python/nnUnet_raw/Dataset219_PETCT/labelsTr/PETCT_dd975744e7_09232001.nii.gz,0.8536143486925539,0.0,6.892325614929199
806,0.7120346726579865,1068,94675,0.5528368330593334,51945888,118369,213044,119437,/well/papiez/users/hri611/python/nnUNet_results/Dataset219_PETCT/nnUNetTrainer_1500epochs__nnUNetPlans__3d_fullres/crossval_results_folds_0_1_2_3_4/PETCT_ddbb3c69f0_08112003.nii.gz,/well/papiez/users/hri611/python/nnUnet_raw/Dataset219_PETCT/labelsTr/PETCT_ddbb3c69f0_08112003.nii.gz,0.7120346726579865,118.92371940994262,1.3560712852478027
807,0.08963282937365011,1686,0,0.046919163369135104,45438231,83,83,1769,/well/papiez/users/hri611/python/nnUNet_results/Dataset219_PETCT/nnUNetTrainer_1500epochs__nnUNetPlans__3d_fullres/crossval_results_folds_0_1_2_3_4/PETCT_de118d7ab9_06022001.nii.gz,/well/papiez/users/hri611/python/nnUnet_raw/Dataset219_PETCT/labelsTr/PETCT_de118d7ab9_06022001.nii.gz,0.08963282937365011,0.0,0.0
808,,0,0,,52160000,0,0,0,/well/papiez/users/hri611/python/nnUNet_results/Dataset219_PETCT/nnUNetTrainer_1500epochs__nnUNetPlans__3d_fullres/crossval_results_folds_0_1_2_3_4/PETCT_dec9ff6a91_03032003.nii.gz,/well/papiez/users/hri611/python/nnUnet_raw/Dataset219_PETCT/labelsTr/PETCT_dec9ff6a91_03032003.nii.gz,,0.0,0.0
809,,0,0,,52160000,0,0,0,/well/papiez/users/hri611/python/nnUNet_results/Dataset219_PETCT/nnUNetTrainer_1500epochs__nnUNetPlans__3d_fullres/crossval_results_folds_0_1_2_3_4/PETCT_df2e16771a_11142003.nii.gz,/well/papiez/users/hri611/python/nnUnet_raw/Dataset219_PETCT/labelsTr/PETCT_df2e16771a_11142003.nii.gz,,0.0,0.0
810,0.0,0,5459,0.0,52154541,0,5459,0,/well/papiez/users/hri611/python/nnUNet_results/Dataset219_PETCT/nnUNetTrainer_1500epochs__nnUNetPlans__3d_fullres/crossval_results_folds_0_1_2_3_4/PETCT_e00c98b415_10192002.nii.gz,/well/papiez/users/hri611/python/nnUnet_raw/Dataset219_PETCT/labelsTr/PETCT_e00c98b415_10192002.nii.gz,0.0,67.91553345108032,0.0
811,0.7802106717319979,23554,1902,0.6396273960191399,38649362,45182,47084,68736,/well/papiez/users/hri611/python/nnUNet_results/Dataset219_PETCT/nnUNetTrainer_1500epochs__nnUNetPlans__3d_fullres/crossval_results_folds_0_1_2_3_4/PETCT_e03b96666f_05172001.nii.gz,/well/papiez/users/hri611/python/nnUnet_raw/Dataset219_PETCT/labelsTr/PETCT_e03b96666f_05172001.nii.gz,0.7802106717319979,0.5100818595886231,40.22182078170776
812,0.763911399243652,646,228,0.618006993006993,52157712,1414,1642,2060,/well/papiez/users/hri611/python/nnUNet_results/Dataset219_PETCT/nnUNetTrainer_1500epochs__nnUNetPlans__3d_fullres/crossval_results_folds_0_1_2_3_4/PETCT_e04b7fa860_06012002.nii.gz,/well/papiez/users/hri611/python/nnUnet_raw/Dataset219_PETCT/labelsTr/PETCT_e04b7fa860_06012002.nii.gz,0.763911399243652,2.4259990882873534,4.988849407196045
813,,0,0,,47360000,0,0,0,/well/papiez/users/hri611/python/nnUNet_results/Dataset219_PETCT/nnUNetTrainer_1500epochs__nnUNetPlans__3d_fullres/crossval_results_folds_0_1_2_3_4/PETCT_e09a20d8fc_03162006.nii.gz,/well/papiez/users/hri611/python/nnUnet_raw/Dataset219_PETCT/labelsTr/PETCT_e09a20d8fc_03162006.nii.gz,,0.0,0.0
814,,0,0,,47360000,0,0,0,/well/papiez/users/hri611/python/nnUNet_results/Dataset219_PETCT/nnUNetTrainer_1500epochs__nnUNetPlans__3d_fullres/crossval_results_folds_0_1_2_3_4/PETCT_e0a7ccecad_01282006.nii.gz,/well/papiez/users/hri611/python/nnUnet_raw/Dataset219_PETCT/labelsTr/PETCT_e0a7ccecad_01282006.nii.gz,,0.0,0.0
815,0.9488502145302029,643,418,0.9026784076316272,45429098,9841,10259,10484,/well/papiez/users/hri611/python/nnUNet_results/Dataset219_PETCT/nnUNetTrainer_1500epochs__nnUNetPlans__3d_fullres/crossval_results_folds_0_1_2_3_4/PETCT_e0aa99fa04_08292003.nii.gz,/well/papiez/users/hri611/python/nnUnet_raw/Dataset219_PETCT/labelsTr/PETCT_e0aa99fa04_08292003.nii.gz,0.9488502145302029,2.7121425704956055,0.0
816,0.0,0,9,0.0,45439991,0,9,0,/well/papiez/users/hri611/python/nnUNet_results/Dataset219_PETCT/nnUNetTrainer_1500epochs__nnUNetPlans__3d_fullres/crossval_results_folds_0_1_2_3_4/PETCT_e0fdc6212a_05292003.nii.gz,/well/papiez/users/hri611/python/nnUnet_raw/Dataset219_PETCT/labelsTr/PETCT_e0fdc6212a_05292003.nii.gz,0.0,0.11196918869018554,0.0
817,0.9142343960484958,11,180,0.8420181968569065,51678791,1018,1198,1029,/well/papiez/users/hri611/python/nnUNet_results/Dataset219_PETCT/nnUNetTrainer_1500epochs__nnUNetPlans__3d_fullres/crossval_results_folds_0_1_2_3_4/PETCT_e1a4145b63_03052006.nii.gz,/well/papiez/users/hri611/python/nnUnet_raw/Dataset219_PETCT/labelsTr/PETCT_e1a4145b63_03052006.nii.gz,0.9142343960484958,1.9034762077331542,0.0
818,0.0,0,7152,0.0,45432848,0,7152,0,/well/papiez/users/hri611/python/nnUNet_results/Dataset219_PETCT/nnUNetTrainer_1500epochs__nnUNetPlans__3d_fullres/crossval_results_folds_0_1_2_3_4/PETCT_e1a5b05186_02272005.nii.gz,/well/papiez/users/hri611/python/nnUnet_raw/Dataset219_PETCT/labelsTr/PETCT_e1a5b05186_02272005.nii.gz,0.0,88.97818194580078,0.0
819,,0,0,,38720000,0,0,0,/well/papiez/users/hri611/python/nnUNet_results/Dataset219_PETCT/nnUNetTrainer_1500epochs__nnUNetPlans__3d_fullres/crossval_results_folds_0_1_2_3_4/PETCT_e207c7a1a4_12232005.nii.gz,/well/papiez/users/hri611/python/nnUnet_raw/Dataset219_PETCT/labelsTr/PETCT_e207c7a1a4_12232005.nii.gz,,0.0,0.0
820,0.801576295329472,17610,14011,0.6688588453362097,52064509,63870,77881,81480,/well/papiez/users/hri611/python/nnUNet_results/Dataset219_PETCT/nnUNetTrainer_1500epochs__nnUNetPlans__3d_fullres/crossval_results_folds_0_1_2_3_4/PETCT_e252be4334_07092004.nii.gz,/well/papiez/users/hri611/python/nnUnet_raw/Dataset219_PETCT/labelsTr/PETCT_e252be4334_07092004.nii.gz,0.801576295329472,7.775638103485107,6.344920692443847
821,0.7414118535296338,2926,6664,0.5890821835632873,52136662,13748,20412,16674,/well/papiez/users/hri611/python/nnUNet_results/Dataset219_PETCT/nnUNetTrainer_1500epochs__nnUNetPlans__3d_fullres/crossval_results_folds_0_1_2_3_4/PETCT_e2834e6f5c_06142002.nii.gz,/well/papiez/users/hri611/python/nnUnet_raw/Dataset219_PETCT/labelsTr/PETCT_e2834e6f5c_06142002.nii.gz,0.7414118535296338,1.1196918869018555,16.260414402008056
822,0.0,0,208,0.0,50879792,0,208,0,/well/papiez/users/hri611/python/nnUNet_results/Dataset219_PETCT/nnUNetTrainer_1500epochs__nnUNetPlans__3d_fullres/crossval_results_folds_0_1_2_3_4/PETCT_e344879c2e_03082007.nii.gz,/well/papiez/users/hri611/python/nnUnet_raw/Dataset219_PETCT/labelsTr/PETCT_e344879c2e_03082007.nii.gz,0.0,2.5877323608398437,0.0
823,0.0,0,4273,0.0,49915727,0,4273,0,/well/papiez/users/hri611/python/nnUNet_results/Dataset219_PETCT/nnUNetTrainer_1500epochs__nnUNetPlans__3d_fullres/crossval_results_folds_0_1_2_3_4/PETCT_e344879c2e_11172006.nii.gz,/well/papiez/users/hri611/python/nnUnet_raw/Dataset219_PETCT/labelsTr/PETCT_e344879c2e_11172006.nii.gz,0.0,53.16048258590698,0.0
824,,0,0,,45440000,0,0,0,/well/papiez/users/hri611/python/nnUNet_results/Dataset219_PETCT/nnUNetTrainer_1500epochs__nnUNetPlans__3d_fullres/crossval_results_folds_0_1_2_3_4/PETCT_e37d5b9bc2_12102004.nii.gz,/well/papiez/users/hri611/python/nnUnet_raw/Dataset219_PETCT/labelsTr/PETCT_e37d5b9bc2_12102004.nii.gz,,0.0,0.0
825,0.8114183409588224,1678,218,0.6826778242677825,52154025,4079,4297,5757,/well/papiez/users/hri611/python/nnUNet_results/Dataset219_PETCT/nnUNetTrainer_1500epochs__nnUNetPlans__3d_fullres/crossval_results_folds_0_1_2_3_4/PETCT_e4712dc58c_02121999.nii.gz,/well/papiez/users/hri611/python/nnUnet_raw/Dataset219_PETCT/labelsTr/PETCT_e4712dc58c_02121999.nii.gz,0.8114183409588224,0.037323062896728515,3.421280765533447
826,0.761948875314825,1740,6483,0.6154421736893794,48778617,13160,19643,14900,/well/papiez/users/hri611/python/nnUNet_results/Dataset219_PETCT/nnUNetTrainer_1500epochs__nnUNetPlans__3d_fullres/crossval_results_folds_0_1_2_3_4/PETCT_e4749cda88_11032005.nii.gz,/well/papiez/users/hri611/python/nnUnet_raw/Dataset219_PETCT/labelsTr/PETCT_e4749cda88_11032005.nii.gz,0.761948875314825,2.3264709205627443,0.37323062896728515
827,0.0,0,38,0.0,52159962,0,38,0,/well/papiez/users/hri611/python/nnUNet_results/Dataset219_PETCT/nnUNetTrainer_1500epochs__nnUNetPlans__3d_fullres/crossval_results_folds_0_1_2_3_4/PETCT_e4e5baf901_02142005.nii.gz,/well/papiez/users/hri611/python/nnUnet_raw/Dataset219_PETCT/labelsTr/PETCT_e4e5baf901_02142005.nii.gz,0.0,0.4727587966918945,0.0
828,,0,0,,45600000,0,0,0,/well/papiez/users/hri611/python/nnUNet_results/Dataset219_PETCT/nnUNetTrainer_1500epochs__nnUNetPlans__3d_fullres/crossval_results_folds_0_1_2_3_4/PETCT_e4e99dbb47_07172005.nii.gz,/well/papiez/users/hri611/python/nnUnet_raw/Dataset219_PETCT/labelsTr/PETCT_e4e99dbb47_07172005.nii.gz,,0.0,0.0
829,0.0,0,1174,0.0,47358826,0,1174,0,/well/papiez/users/hri611/python/nnUNet_results/Dataset219_PETCT/nnUNetTrainer_1500epochs__nnUNetPlans__3d_fullres/crossval_results_folds_0_1_2_3_4/PETCT_e52eca67d7_03132006.nii.gz,/well/papiez/users/hri611/python/nnUnet_raw/Dataset219_PETCT/labelsTr/PETCT_e52eca67d7_03132006.nii.gz,0.0,14.605758613586426,0.0
830,0.0,0,42,0.0,45439958,0,42,0,/well/papiez/users/hri611/python/nnUNet_results/Dataset219_PETCT/nnUNetTrainer_1500epochs__nnUNetPlans__3d_fullres/crossval_results_folds_0_1_2_3_4/PETCT_e5b1d6b4bd_10232004.nii.gz,/well/papiez/users/hri611/python/nnUnet_raw/Dataset219_PETCT/labelsTr/PETCT_e5b1d6b4bd_10232004.nii.gz,0.0,0.5225228805541993,0.0
831,,0,0,,92320000,0,0,0,/well/papiez/users/hri611/python/nnUNet_results/Dataset219_PETCT/nnUNetTrainer_1500epochs__nnUNetPlans__3d_fullres/crossval_results_folds_0_1_2_3_4/PETCT_e5c7be07a8_04082005.nii.gz,/well/papiez/users/hri611/python/nnUnet_raw/Dataset219_PETCT/labelsTr/PETCT_e5c7be07a8_04082005.nii.gz,,0.0,0.0
832,,0,0,,54080000,0,0,0,/well/papiez/users/hri611/python/nnUNet_results/Dataset219_PETCT/nnUNetTrainer_1500epochs__nnUNetPlans__3d_fullres/crossval_results_folds_0_1_2_3_4/PETCT_e5d50c5569_08242006.nii.gz,/well/papiez/users/hri611/python/nnUnet_raw/Dataset219_PETCT/labelsTr/PETCT_e5d50c5569_08242006.nii.gz,,0.0,0.0
833,,0,0,,45440000,0,0,0,/well/papiez/users/hri611/python/nnUNet_results/Dataset219_PETCT/nnUNetTrainer_1500epochs__nnUNetPlans__3d_fullres/crossval_results_folds_0_1_2_3_4/PETCT_e5e1918765_07242003.nii.gz,/well/papiez/users/hri611/python/nnUnet_raw/Dataset219_PETCT/labelsTr/PETCT_e5e1918765_07242003.nii.gz,,0.0,0.0
834,0.9359772890979196,1236,275,0.8796591271105447,52147444,11045,11320,12281,/well/papiez/users/hri611/python/nnUNet_results/Dataset219_PETCT/nnUNetTrainer_1500epochs__nnUNetPlans__3d_fullres/crossval_results_folds_0_1_2_3_4/PETCT_e61c9da258_12132002.nii.gz,/well/papiez/users/hri611/python/nnUnet_raw/Dataset219_PETCT/labelsTr/PETCT_e61c9da258_12132002.nii.gz,0.9359772890979196,0.3856716499328613,0.024882041931152343
835,0.0,0,180,0.0,51839820,0,180,0,/well/papiez/users/hri611/python/nnUNet_results/Dataset219_PETCT/nnUNetTrainer_1500epochs__nnUNetPlans__3d_fullres/crossval_results_folds_0_1_2_3_4/PETCT_e664932bbc_06092007.nii.gz,/well/papiez/users/hri611/python/nnUnet_raw/Dataset219_PETCT/labelsTr/PETCT_e664932bbc_06092007.nii.gz,0.0,2.239383773803711,0.0
836,,0,0,,51200000,0,0,0,/well/papiez/users/hri611/python/nnUNet_results/Dataset219_PETCT/nnUNetTrainer_1500epochs__nnUNetPlans__3d_fullres/crossval_results_folds_0_1_2_3_4/PETCT_e68c4577d8_05252007.nii.gz,/well/papiez/users/hri611/python/nnUnet_raw/Dataset219_PETCT/labelsTr/PETCT_e68c4577d8_05252007.nii.gz,,0.0,0.0
837,0.0,0,971,0.0,48159029,0,971,0,/well/papiez/users/hri611/python/nnUNet_results/Dataset219_PETCT/nnUNetTrainer_1500epochs__nnUNetPlans__3d_fullres/crossval_results_folds_0_1_2_3_4/PETCT_e6a91fef70_03022006.nii.gz,/well/papiez/users/hri611/python/nnUnet_raw/Dataset219_PETCT/labelsTr/PETCT_e6a91fef70_03022006.nii.gz,0.0,12.080231357574462,0.0
838,0.0,0,1,0.0,44479999,0,1,0,/well/papiez/users/hri611/python/nnUNet_results/Dataset219_PETCT/nnUNetTrainer_1500epochs__nnUNetPlans__3d_fullres/crossval_results_folds_0_1_2_3_4/PETCT_e6f6c84ec5_11052005.nii.gz,/well/papiez/users/hri611/python/nnUnet_raw/Dataset219_PETCT/labelsTr/PETCT_e6f6c84ec5_11052005.nii.gz,0.0,0.012441020965576172,0.0
839,0.9078593567191445,2012,2477,0.8312659750413471,46373396,22115,24592,24127,/well/papiez/users/hri611/python/nnUNet_results/Dataset219_PETCT/nnUNetTrainer_1500epochs__nnUNetPlans__3d_fullres/crossval_results_folds_0_1_2_3_4/PETCT_e77124b7f4_09292005.nii.gz,/well/papiez/users/hri611/python/nnUnet_raw/Dataset219_PETCT/labelsTr/PETCT_e77124b7f4_09292005.nii.gz,0.9078593567191445,0.721579216003418,0.012441020965576172
840,0.8659191557523792,1026,397,0.7635427052176803,52153982,4595,4992,5621,/well/papiez/users/hri611/python/nnUNet_results/Dataset219_PETCT/nnUNetTrainer_1500epochs__nnUNetPlans__3d_fullres/crossval_results_folds_0_1_2_3_4/PETCT_e77c5fca12_10282002.nii.gz,/well/papiez/users/hri611/python/nnUnet_raw/Dataset219_PETCT/labelsTr/PETCT_e77c5fca12_10282002.nii.gz,0.8659191557523792,0.0,7.875166271209717
841,0.3073852295409182,103,244,0.18160377358490565,89759576,77,321,180,/well/papiez/users/hri611/python/nnUNet_results/Dataset219_PETCT/nnUNetTrainer_1500epochs__nnUNetPlans__3d_fullres/crossval_results_folds_0_1_2_3_4/PETCT_e79291780d_05142007.nii.gz,/well/papiez/users/hri611/python/nnUnet_raw/Dataset219_PETCT/labelsTr/PETCT_e79291780d_05142007.nii.gz,0.3073852295409182,3.035609115600586,0.0
842,,0,0,,49920000,0,0,0,/well/papiez/users/hri611/python/nnUNet_results/Dataset219_PETCT/nnUNetTrainer_1500epochs__nnUNetPlans__3d_fullres/crossval_results_folds_0_1_2_3_4/PETCT_e8624bab41_07072007.nii.gz,/well/papiez/users/hri611/python/nnUnet_raw/Dataset219_PETCT/labelsTr/PETCT_e8624bab41_07072007.nii.gz,,0.0,0.0
843,0.0,0,18,0.0,85599982,0,18,0,/well/papiez/users/hri611/python/nnUNet_results/Dataset219_PETCT/nnUNetTrainer_1500epochs__nnUNetPlans__3d_fullres/crossval_results_folds_0_1_2_3_4/PETCT_e90a287d09_02242003.nii.gz,/well/papiez/users/hri611/python/nnUnet_raw/Dataset219_PETCT/labelsTr/PETCT_e90a287d09_02242003.nii.gz,0.0,0.2239383773803711,0.0
844,0.0,0,334,0.0,92319666,0,334,0,/well/papiez/users/hri611/python/nnUNet_results/Dataset219_PETCT/nnUNetTrainer_1500epochs__nnUNetPlans__3d_fullres/crossval_results_folds_0_1_2_3_4/PETCT_e90a287d09_08222002.nii.gz,/well/papiez/users/hri611/python/nnUnet_raw/Dataset219_PETCT/labelsTr/PETCT_e90a287d09_08222002.nii.gz,0.0,4.1553010025024415,0.0
845,0.7535100108000332,2240,727,0.6045054652092775,105752498,4535,5262,6775,/well/papiez/users/hri611/python/nnUNet_results/Dataset219_PETCT/nnUNetTrainer_1500epochs__nnUNetPlans__3d_fullres/crossval_results_folds_0_1_2_3_4/PETCT_e9be8ec30f_12122002.nii.gz,/well/papiez/users/hri611/python/nnUnet_raw/Dataset219_PETCT/labelsTr/PETCT_e9be8ec30f_12122002.nii.gz,0.7535100108000332,7.812961166381836,3.5830140380859374
846,0.8079941404206341,1467,368,0.6778441011235955,45434304,3861,4229,5328,/well/papiez/users/hri611/python/nnUNet_results/Dataset219_PETCT/nnUNetTrainer_1500epochs__nnUNetPlans__3d_fullres/crossval_results_folds_0_1_2_3_4/PETCT_e9e1a391b5_10112001.nii.gz,/well/papiez/users/hri611/python/nnUnet_raw/Dataset219_PETCT/labelsTr/PETCT_e9e1a391b5_10112001.nii.gz,0.8079941404206341,0.0,0.0
847,0.0,0,849,0.0,42399151,0,849,0,/well/papiez/users/hri611/python/nnUNet_results/Dataset219_PETCT/nnUNetTrainer_1500epochs__nnUNetPlans__3d_fullres/crossval_results_folds_0_1_2_3_4/PETCT_e9feb1135e_07012005.nii.gz,/well/papiez/users/hri611/python/nnUnet_raw/Dataset219_PETCT/labelsTr/PETCT_e9feb1135e_07012005.nii.gz,0.0,10.562426799774169,0.0
848,0.0,0,1184,0.0,44318816,0,1184,0,/well/papiez/users/hri611/python/nnUNet_results/Dataset219_PETCT/nnUNetTrainer_1500epochs__nnUNetPlans__3d_fullres/crossval_results_folds_0_1_2_3_4/PETCT_e9feb1135e_09092005.nii.gz,/well/papiez/users/hri611/python/nnUnet_raw/Dataset219_PETCT/labelsTr/PETCT_e9feb1135e_09092005.nii.gz,0.0,14.730168823242188,0.0
849,0.8868231408267441,6963,2083,0.7966596983388405,52115513,35441,37524,42404,/well/papiez/users/hri611/python/nnUNet_results/Dataset219_PETCT/nnUNetTrainer_1500epochs__nnUNetPlans__3d_fullres/crossval_results_folds_0_1_2_3_4/PETCT_ea0fd89f0f_10252003.nii.gz,/well/papiez/users/hri611/python/nnUnet_raw/Dataset219_PETCT/labelsTr/PETCT_ea0fd89f0f_10252003.nii.gz,0.8868231408267441,0.4603177757263184,0.4727587966918945
850,0.8902932739460352,12005,2872,0.8022779830413864,47124758,60365,63237,72370,/well/papiez/users/hri611/python/nnUNet_results/Dataset219_PETCT/nnUNetTrainer_1500epochs__nnUNetPlans__3d_fullres/crossval_results_folds_0_1_2_3_4/PETCT_ea42c88cc7_02262006.nii.gz,/well/papiez/users/hri611/python/nnUnet_raw/Dataset219_PETCT/labelsTr/PETCT_ea42c88cc7_02262006.nii.gz,0.8902932739460352,5.872161895751953,4.553413673400879
851,0.7149640067391637,23,1838,0.5563766388557807,51515805,2334,4172,2357,/well/papiez/users/hri611/python/nnUNet_results/Dataset219_PETCT/nnUNetTrainer_1500epochs__nnUNetPlans__3d_fullres/crossval_results_folds_0_1_2_3_4/PETCT_ea6c621616_08082005.nii.gz,/well/papiez/users/hri611/python/nnUnet_raw/Dataset219_PETCT/labelsTr/PETCT_ea6c621616_08082005.nii.gz,0.7149640067391637,5.424285140991211,0.0
852,0.30088078011953445,388,8502,0.17708044061834677,58869197,1913,10415,2301,/well/papiez/users/hri611/python/nnUNet_results/Dataset219_PETCT/nnUNetTrainer_1500epochs__nnUNetPlans__3d_fullres/crossval_results_folds_0_1_2_3_4/PETCT_ea9302fb0f_08232003.nii.gz,/well/papiez/users/hri611/python/nnUnet_raw/Dataset219_PETCT/labelsTr/PETCT_ea9302fb0f_08232003.nii.gz,0.30088078011953445,102.30251539993286,0.0
853,0.5864040660736975,4,1298,0.4148314606741573,52157775,923,2221,927,/well/papiez/users/hri611/python/nnUNet_results/Dataset219_PETCT/nnUNetTrainer_1500epochs__nnUNetPlans__3d_fullres/crossval_results_folds_0_1_2_3_4/PETCT_eafa147e24_04182005.nii.gz,/well/papiez/users/hri611/python/nnUnet_raw/Dataset219_PETCT/labelsTr/PETCT_eafa147e24_04182005.nii.gz,0.5864040660736975,12.552990154266357,0.0
854,0.0,0,10,0.0,52159990,0,10,0,/well/papiez/users/hri611/python/nnUNet_results/Dataset219_PETCT/nnUNetTrainer_1500epochs__nnUNetPlans__3d_fullres/crossval_results_folds_0_1_2_3_4/PETCT_ebaa30ba2e_04172003.nii.gz,/well/papiez/users/hri611/python/nnUnet_raw/Dataset219_PETCT/labelsTr/PETCT_ebaa30ba2e_04172003.nii.gz,0.0,0.12441020965576172,0.0
855,0.8969805680119581,476,1247,0.8132046834345187,52150776,7501,8748,7977,/well/papiez/users/hri611/python/nnUNet_results/Dataset219_PETCT/nnUNetTrainer_1500epochs__nnUNetPlans__3d_fullres/crossval_results_folds_0_1_2_3_4/PETCT_ebb0045704_09272002.nii.gz,/well/papiez/users/hri611/python/nnUnet_raw/Dataset219_PETCT/labelsTr/PETCT_ebb0045704_09272002.nii.gz,0.8969805680119581,3.060491157531738,0.0
856,0.7641129032258065,0,702,0.6182707993474714,58878161,1137,1839,1137,/well/papiez/users/hri611/python/nnUNet_results/Dataset219_PETCT/nnUNetTrainer_1500epochs__nnUNetPlans__3d_fullres/crossval_results_folds_0_1_2_3_4/PETCT_ec581d49ef_01232003.nii.gz,/well/papiez/users/hri611/python/nnUnet_raw/Dataset219_PETCT/labelsTr/PETCT_ec581d49ef_01232003.nii.gz,0.7641129032258065,0.2861434822082519,0.0
857,0.8650095602294455,292,61,0.7621293800539084,52158516,1131,1192,1423,/well/papiez/users/hri611/python/nnUNet_results/Dataset219_PETCT/nnUNetTrainer_1500epochs__nnUNetPlans__3d_fullres/crossval_results_folds_0_1_2_3_4/PETCT_ec581d49ef_03252002.nii.gz,/well/papiez/users/hri611/python/nnUnet_raw/Dataset219_PETCT/labelsTr/PETCT_ec581d49ef_03252002.nii.gz,0.8650095602294455,0.3359075660705566,0.16173327255249023
858,0.9294241112422931,747,329,0.8681534125719887,45431839,7085,7414,7832,/well/papiez/users/hri611/python/nnUNet_results/Dataset219_PETCT/nnUNetTrainer_1500epochs__nnUNetPlans__3d_fullres/crossval_results_folds_0_1_2_3_4/PETCT_ec6b934720_10252002.nii.gz,/well/papiez/users/hri611/python/nnUnet_raw/Dataset219_PETCT/labelsTr/PETCT_ec6b934720_10252002.nii.gz,0.9294241112422931,0.0,0.0
859,0.0,0,210,0.0,52159790,0,210,0,/well/papiez/users/hri611/python/nnUNet_results/Dataset219_PETCT/nnUNetTrainer_1500epochs__nnUNetPlans__3d_fullres/crossval_results_folds_0_1_2_3_4/PETCT_eca59074b9_07202002.nii.gz,/well/papiez/users/hri611/python/nnUnet_raw/Dataset219_PETCT/labelsTr/PETCT_eca59074b9_07202002.nii.gz,0.0,2.612614402770996,0.0
860,0.837629703235176,183,8314,0.7206220819359506,52129586,21917,30231,22100,/well/papiez/users/hri611/python/nnUNet_results/Dataset219_PETCT/nnUNetTrainer_1500epochs__nnUNetPlans__3d_fullres/crossval_results_folds_0_1_2_3_4/PETCT_ed9dca00d2_09252004.nii.gz,/well/papiez/users/hri611/python/nnUnet_raw/Dataset219_PETCT/labelsTr/PETCT_ed9dca00d2_09252004.nii.gz,0.837629703235176,2.973404010772705,0.7713432998657226
861,,0,0,,56480000,0,0,0,/well/papiez/users/hri611/python/nnUNet_results/Dataset219_PETCT/nnUNetTrainer_1500epochs__nnUNetPlans__3d_fullres/crossval_results_folds_0_1_2_3_4/PETCT_eda00de6b0_06242006.nii.gz,/well/papiez/users/hri611/python/nnUnet_raw/Dataset219_PETCT/labelsTr/PETCT_eda00de6b0_06242006.nii.gz,,0.0,0.0
862,0.7988648947951273,5177,635,0.6650916215281779,45422646,11542,12177,16719,/well/papiez/users/hri611/python/nnUNet_results/Dataset219_PETCT/nnUNetTrainer_1500epochs__nnUNetPlans__3d_fullres/crossval_results_folds_0_1_2_3_4/PETCT_ede28cc3c2_01042001.nii.gz,/well/papiez/users/hri611/python/nnUnet_raw/Dataset219_PETCT/labelsTr/PETCT_ede28cc3c2_01042001.nii.gz,0.7988648947951273,0.6966971740722656,0.0
863,0.698056237025854,3062,138,0.5361646615451515,52153101,3699,3837,6761,/well/papiez/users/hri611/python/nnUNet_results/Dataset219_PETCT/nnUNetTrainer_1500epochs__nnUNetPlans__3d_fullres/crossval_results_folds_0_1_2_3_4/PETCT_ee97822c60_03032003.nii.gz,/well/papiez/users/hri611/python/nnUnet_raw/Dataset219_PETCT/labelsTr/PETCT_ee97822c60_03032003.nii.gz,0.698056237025854,0.9828406562805175,5.586018413543701
864,,0,0,,48160000,0,0,0,/well/papiez/users/hri611/python/nnUNet_results/Dataset219_PETCT/nnUNetTrainer_1500epochs__nnUNetPlans__3d_fullres/crossval_results_folds_0_1_2_3_4/PETCT_eee2ede9ad_11242006.nii.gz,/well/papiez/users/hri611/python/nnUnet_raw/Dataset219_PETCT/labelsTr/PETCT_eee2ede9ad_11242006.nii.gz,,0.0,0.0
865,0.8827840176763027,2443,740,0.7901641505702419,45424831,11986,12726,14429,/well/papiez/users/hri611/python/nnUNet_results/Dataset219_PETCT/nnUNetTrainer_1500epochs__nnUNetPlans__3d_fullres/crossval_results_folds_0_1_2_3_4/PETCT_eeeda112bb_06072003.nii.gz,/well/papiez/users/hri611/python/nnUnet_raw/Dataset219_PETCT/labelsTr/PETCT_eeeda112bb_06072003.nii.gz,0.8827840176763027,1.1072508659362792,0.0
866,0.8227373621871503,26290,2699,0.6988562583754921,52063737,67274,69973,93564,/well/papiez/users/hri611/python/nnUNet_results/Dataset219_PETCT/nnUNetTrainer_1500epochs__nnUNetPlans__3d_fullres/crossval_results_folds_0_1_2_3_4/PETCT_ef9d41b836_05212001.nii.gz,/well/papiez/users/hri611/python/nnUnet_raw/Dataset219_PETCT/labelsTr/PETCT_ef9d41b836_05212001.nii.gz,0.8227373621871503,0.26126144027709963,19.569725978851316
867,0.8318318318318318,1896,232,0.712082262210797,45432609,5263,5495,7159,/well/papiez/users/hri611/python/nnUNet_results/Dataset219_PETCT/nnUNetTrainer_1500epochs__nnUNetPlans__3d_fullres/crossval_results_folds_0_1_2_3_4/PETCT_efd619ecbf_02232003.nii.gz,/well/papiez/users/hri611/python/nnUnet_raw/Dataset219_PETCT/labelsTr/PETCT_efd619ecbf_02232003.nii.gz,0.8318318318318318,1.6546557884216309,0.0
868,0.7258064516129032,151,325,0.569620253164557,45438894,630,955,781,/well/papiez/users/hri611/python/nnUNet_results/Dataset219_PETCT/nnUNetTrainer_1500epochs__nnUNetPlans__3d_fullres/crossval_results_folds_0_1_2_3_4/PETCT_f01e83894d_03242005.nii.gz,/well/papiez/users/hri611/python/nnUnet_raw/Dataset219_PETCT/labelsTr/PETCT_f01e83894d_03242005.nii.gz,0.7258064516129032,1.7790659980773926,1.7790659980773926
869,0.0,0,16457,0.0,92463543,0,16457,0,/well/papiez/users/hri611/python/nnUNet_results/Dataset219_PETCT/nnUNetTrainer_1500epochs__nnUNetPlans__3d_fullres/crossval_results_folds_0_1_2_3_4/PETCT_f068e22258_05142007.nii.gz,/well/papiez/users/hri611/python/nnUnet_raw/Dataset219_PETCT/labelsTr/PETCT_f068e22258_05142007.nii.gz,0.0,204.74188203048706,0.0
870,0.0,0,146,0.0,52159854,0,146,0,/well/papiez/users/hri611/python/nnUNet_results/Dataset219_PETCT/nnUNetTrainer_1500epochs__nnUNetPlans__3d_fullres/crossval_results_folds_0_1_2_3_4/PETCT_f0a1a38a3b_03272005.nii.gz,/well/papiez/users/hri611/python/nnUnet_raw/Dataset219_PETCT/labelsTr/PETCT_f0a1a38a3b_03272005.nii.gz,0.0,1.8163890609741211,0.0
871,,0,0,,52160000,0,0,0,/well/papiez/users/hri611/python/nnUNet_results/Dataset219_PETCT/nnUNetTrainer_1500epochs__nnUNetPlans__3d_fullres/crossval_results_folds_0_1_2_3_4/PETCT_f0e1b89b41_05172007.nii.gz,/well/papiez/users/hri611/python/nnUnet_raw/Dataset219_PETCT/labelsTr/PETCT_f0e1b89b41_05172007.nii.gz,,0.0,0.0
872,0.6942157539703617,2251,3506,0.5316465994142532,52147708,6535,10041,8786,/well/papiez/users/hri611/python/nnUNet_results/Dataset219_PETCT/nnUNetTrainer_1500epochs__nnUNetPlans__3d_fullres/crossval_results_folds_0_1_2_3_4/PETCT_f11f3d3692_10242003.nii.gz,/well/papiez/users/hri611/python/nnUnet_raw/Dataset219_PETCT/labelsTr/PETCT_f11f3d3692_10242003.nii.gz,0.6942157539703617,1.8288300819396972,8.559422424316406
873,0.95249392088251,388,1214,0.9092967953799117,45422338,16060,17274,16448,/well/papiez/users/hri611/python/nnUNet_results/Dataset219_PETCT/nnUNetTrainer_1500epochs__nnUNetPlans__3d_fullres/crossval_results_folds_0_1_2_3_4/PETCT_f1501b1f45_03202005.nii.gz,/well/papiez/users/hri611/python/nnUnet_raw/Dataset219_PETCT/labelsTr/PETCT_f1501b1f45_03202005.nii.gz,0.95249392088251,3.483485870361328,1.443158432006836
874,0.0,0,624,0.0,72159376,0,624,0,/well/papiez/users/hri611/python/nnUNet_results/Dataset219_PETCT/nnUNetTrainer_1500epochs__nnUNetPlans__3d_fullres/crossval_results_folds_0_1_2_3_4/PETCT_f1594a7d8a_04252003.nii.gz,/well/papiez/users/hri611/python/nnUnet_raw/Dataset219_PETCT/labelsTr/PETCT_f1594a7d8a_04252003.nii.gz,0.0,7.763197082519531,0.0
875,0.0,0,1,0.0,47519999,0,1,0,/well/papiez/users/hri611/python/nnUNet_results/Dataset219_PETCT/nnUNetTrainer_1500epochs__nnUNetPlans__3d_fullres/crossval_results_folds_0_1_2_3_4/PETCT_f15b868db6_02032006.nii.gz,/well/papiez/users/hri611/python/nnUnet_raw/Dataset219_PETCT/labelsTr/PETCT_f15b868db6_02032006.nii.gz,0.0,0.012441020965576172,0.0
876,0.8075723830734967,373,491,0.6772506537168472,99037323,1813,2304,2186,/well/papiez/users/hri611/python/nnUNet_results/Dataset219_PETCT/nnUNetTrainer_1500epochs__nnUNetPlans__3d_fullres/crossval_results_folds_0_1_2_3_4/PETCT_f1ca0f7c4c_12222001.nii.gz,/well/papiez/users/hri611/python/nnUnet_raw/Dataset219_PETCT/labelsTr/PETCT_f1ca0f7c4c_12222001.nii.gz,0.8075723830734967,2.4508811302185056,0.8957535095214844
877,0.9109492435805785,6590,7237,0.8364616967675549,45355451,70722,77959,77312,/well/papiez/users/hri611/python/nnUNet_results/Dataset219_PETCT/nnUNetTrainer_1500epochs__nnUNetPlans__3d_fullres/crossval_results_folds_0_1_2_3_4/PETCT_f21755a99b_05052005.nii.gz,/well/papiez/users/hri611/python/nnUnet_raw/Dataset219_PETCT/labelsTr/PETCT_f21755a99b_05052005.nii.gz,0.9109492435805785,5.536254329681396,0.435435733795166
878,0.9152017435691548,21,2936,0.8436607803743259,105581086,15957,18893,15978,/well/papiez/users/hri611/python/nnUNet_results/Dataset219_PETCT/nnUNetTrainer_1500epochs__nnUNetPlans__3d_fullres/crossval_results_folds_0_1_2_3_4/PETCT_f24f3ce1da_09142001.nii.gz,/well/papiez/users/hri611/python/nnUnet_raw/Dataset219_PETCT/labelsTr/PETCT_f24f3ce1da_09142001.nii.gz,0.9152017435691548,3.4586038284301757,0.0
879,0.7990574682550072,1344,191,0.6653586221931546,52155413,3052,3243,4396,/well/papiez/users/hri611/python/nnUNet_results/Dataset219_PETCT/nnUNetTrainer_1500epochs__nnUNetPlans__3d_fullres/crossval_results_folds_0_1_2_3_4/PETCT_f2f28337ba_05032001.nii.gz,/well/papiez/users/hri611/python/nnUnet_raw/Dataset219_PETCT/labelsTr/PETCT_f2f28337ba_05032001.nii.gz,0.7990574682550072,0.0,0.0
880,0.9243634548177734,171,435,0.859364121605941,45435691,3703,4138,3874,/well/papiez/users/hri611/python/nnUNet_results/Dataset219_PETCT/nnUNetTrainer_1500epochs__nnUNetPlans__3d_fullres/crossval_results_folds_0_1_2_3_4/PETCT_f4668d2bdc_09042000.nii.gz,/well/papiez/users/hri611/python/nnUnet_raw/Dataset219_PETCT/labelsTr/PETCT_f4668d2bdc_09042000.nii.gz,0.9243634548177734,1.094809844970703,0.0
881,0.8393162393162393,48,140,0.7231222385861561,52159321,491,631,539,/well/papiez/users/hri611/python/nnUNet_results/Dataset219_PETCT/nnUNetTrainer_1500epochs__nnUNetPlans__3d_fullres/crossval_results_folds_0_1_2_3_4/PETCT_f47e31ceb5_07262003.nii.gz,/well/papiez/users/hri611/python/nnUnet_raw/Dataset219_PETCT/labelsTr/PETCT_f47e31ceb5_07262003.nii.gz,0.8393162393162393,0.8833124885559082,0.21149735641479492
882,0.7173560421735604,1274,120,0.5592791653493518,45436837,1769,1889,3043,/well/papiez/users/hri611/python/nnUNet_results/Dataset219_PETCT/nnUNetTrainer_1500epochs__nnUNetPlans__3d_fullres/crossval_results_folds_0_1_2_3_4/PETCT_f4813007a0_11252000.nii.gz,/well/papiez/users/hri611/python/nnUnet_raw/Dataset219_PETCT/labelsTr/PETCT_f4813007a0_11252000.nii.gz,0.7173560421735604,0.0,10.214078212738038
883,0.0,0,384,0.0,99039616,0,384,0,/well/papiez/users/hri611/python/nnUNet_results/Dataset219_PETCT/nnUNetTrainer_1500epochs__nnUNetPlans__3d_fullres/crossval_results_folds_0_1_2_3_4/PETCT_f4a5ebd915_10032003.nii.gz,/well/papiez/users/hri611/python/nnUnet_raw/Dataset219_PETCT/labelsTr/PETCT_f4a5ebd915_10032003.nii.gz,0.0,4.77735205078125,0.0
884,0.9212884753042233,1593,1156,0.8540638105855497,52141163,16088,17244,17681,/well/papiez/users/hri611/python/nnUNet_results/Dataset219_PETCT/nnUNetTrainer_1500epochs__nnUNetPlans__3d_fullres/crossval_results_folds_0_1_2_3_4/PETCT_f5c2c09846_10282002.nii.gz,/well/papiez/users/hri611/python/nnUnet_raw/Dataset219_PETCT/labelsTr/PETCT_f5c2c09846_10282002.nii.gz,0.9212884753042233,0.0,7.4024074745178225
885,0.7741547544209691,10267,6259,0.6315273132664437,92275150,28324,34583,38591,/well/papiez/users/hri611/python/nnUNet_results/Dataset219_PETCT/nnUNetTrainer_1500epochs__nnUNetPlans__3d_fullres/crossval_results_folds_0_1_2_3_4/PETCT_f5c9b0de6c_04022004.nii.gz,/well/papiez/users/hri611/python/nnUnet_raw/Dataset219_PETCT/labelsTr/PETCT_f5c9b0de6c_04022004.nii.gz,0.7741547544209691,27.183630809783935,59.40587511062622
886,0.0,0,33,0.0,65279967,0,33,0,/well/papiez/users/hri611/python/nnUNet_results/Dataset219_PETCT/nnUNetTrainer_1500epochs__nnUNetPlans__3d_fullres/crossval_results_folds_0_1_2_3_4/PETCT_f5cff2e59d_05102007.nii.gz,/well/papiez/users/hri611/python/nnUnet_raw/Dataset219_PETCT/labelsTr/PETCT_f5cff2e59d_05102007.nii.gz,0.0,0.4105536918640137,0.0
887,,0,0,,52160000,0,0,0,/well/papiez/users/hri611/python/nnUNet_results/Dataset219_PETCT/nnUNetTrainer_1500epochs__nnUNetPlans__3d_fullres/crossval_results_folds_0_1_2_3_4/PETCT_f603eeceba_03172003.nii.gz,/well/papiez/users/hri611/python/nnUnet_raw/Dataset219_PETCT/labelsTr/PETCT_f603eeceba_03172003.nii.gz,,0.0,0.0
888,0.8727289876089084,9480,1315,0.774196247411467,52112193,37012,38327,46492,/well/papiez/users/hri611/python/nnUNet_results/Dataset219_PETCT/nnUNetTrainer_1500epochs__nnUNetPlans__3d_fullres/crossval_results_folds_0_1_2_3_4/PETCT_f60ea3abc5_05032003.nii.gz,/well/papiez/users/hri611/python/nnUnet_raw/Dataset219_PETCT/labelsTr/PETCT_f60ea3abc5_05032003.nii.gz,0.8727289876089084,0.0,1.6297737464904785
889,0.0,0,7275,0.0,47192725,0,7275,0,/well/papiez/users/hri611/python/nnUNet_results/Dataset219_PETCT/nnUNetTrainer_1500epochs__nnUNetPlans__3d_fullres/crossval_results_folds_0_1_2_3_4/PETCT_f6295a93a6_10092006.nii.gz,/well/papiez/users/hri611/python/nnUnet_raw/Dataset219_PETCT/labelsTr/PETCT_f6295a93a6_10092006.nii.gz,0.0,90.50842752456664,0.0
890,0.8257575757575758,32,14,0.7032258064516129,92319845,109,123,141,/well/papiez/users/hri611/python/nnUNet_results/Dataset219_PETCT/nnUNetTrainer_1500epochs__nnUNetPlans__3d_fullres/crossval_results_folds_0_1_2_3_4/PETCT_f637b5930b_07272003.nii.gz,/well/papiez/users/hri611/python/nnUnet_raw/Dataset219_PETCT/labelsTr/PETCT_f637b5930b_07272003.nii.gz,0.8257575757575758,0.0,0.19905633544921875
891,,0,0,,52160000,0,0,0,/well/papiez/users/hri611/python/nnUNet_results/Dataset219_PETCT/nnUNetTrainer_1500epochs__nnUNetPlans__3d_fullres/crossval_results_folds_0_1_2_3_4/PETCT_f650c87621_03112005.nii.gz,/well/papiez/users/hri611/python/nnUnet_raw/Dataset219_PETCT/labelsTr/PETCT_f650c87621_03112005.nii.gz,,0.0,0.0
892,0.0,0,359,0.0,47519641,0,359,0,/well/papiez/users/hri611/python/nnUNet_results/Dataset219_PETCT/nnUNetTrainer_1500epochs__nnUNetPlans__3d_fullres/crossval_results_folds_0_1_2_3_4/PETCT_f650c87621_12082005.nii.gz,/well/papiez/users/hri611/python/nnUnet_raw/Dataset219_PETCT/labelsTr/PETCT_f650c87621_12082005.nii.gz,0.0,4.466326526641845,0.0
893,0.8575600259571706,584,1172,0.7506390230048282,52312958,5286,6458,5870,/well/papiez/users/hri611/python/nnUNet_results/Dataset219_PETCT/nnUNetTrainer_1500epochs__nnUNetPlans__3d_fullres/crossval_results_folds_0_1_2_3_4/PETCT_f65602d938_03252007.nii.gz,/well/papiez/users/hri611/python/nnUnet_raw/Dataset219_PETCT/labelsTr/PETCT_f65602d938_03252007.nii.gz,0.8575600259571706,3.5581319961547853,0.012441020965576172
894,0.7762699014404852,4851,1051,0.6343473142927948,52143859,10239,11290,15090,/well/papiez/users/hri611/python/nnUNet_results/Dataset219_PETCT/nnUNetTrainer_1500epochs__nnUNetPlans__3d_fullres/crossval_results_folds_0_1_2_3_4/PETCT_f7067b7bbb_05262001.nii.gz,/well/papiez/users/hri611/python/nnUnet_raw/Dataset219_PETCT/labelsTr/PETCT_f7067b7bbb_05262001.nii.gz,0.7762699014404852,0.04976408386230469,19.532402915954588
895,0.0,0,161,0.0,52159839,0,161,0,/well/papiez/users/hri611/python/nnUNet_results/Dataset219_PETCT/nnUNetTrainer_1500epochs__nnUNetPlans__3d_fullres/crossval_results_folds_0_1_2_3_4/PETCT_f75d25523c_09132002.nii.gz,/well/papiez/users/hri611/python/nnUnet_raw/Dataset219_PETCT/labelsTr/PETCT_f75d25523c_09132002.nii.gz,0.0,2.0030043754577638,0.0
896,0.0,0,947,0.0,52159053,0,947,0,/well/papiez/users/hri611/python/nnUNet_results/Dataset219_PETCT/nnUNetTrainer_1500epochs__nnUNetPlans__3d_fullres/crossval_results_folds_0_1_2_3_4/PETCT_f7a9267a69_02012003.nii.gz,/well/papiez/users/hri611/python/nnUnet_raw/Dataset219_PETCT/labelsTr/PETCT_f7a9267a69_02012003.nii.gz,0.0,11.781646854400634,0.0
897,0.0,0,348,0.0,52159652,0,348,0,/well/papiez/users/hri611/python/nnUNet_results/Dataset219_PETCT/nnUNetTrainer_1500epochs__nnUNetPlans__3d_fullres/crossval_results_folds_0_1_2_3_4/PETCT_f7a9267a69_11012002.nii.gz,/well/papiez/users/hri611/python/nnUnet_raw/Dataset219_PETCT/labelsTr/PETCT_f7a9267a69_11012002.nii.gz,0.0,4.329475296020508,0.0
898,,0,0,,45440000,0,0,0,/well/papiez/users/hri611/python/nnUNet_results/Dataset219_PETCT/nnUNetTrainer_1500epochs__nnUNetPlans__3d_fullres/crossval_results_folds_0_1_2_3_4/PETCT_f8314eb3f7_03142003.nii.gz,/well/papiez/users/hri611/python/nnUnet_raw/Dataset219_PETCT/labelsTr/PETCT_f8314eb3f7_03142003.nii.gz,,0.0,0.0
899,0.0,0,3287,0.0,45436713,0,3287,0,/well/papiez/users/hri611/python/nnUNet_results/Dataset219_PETCT/nnUNetTrainer_1500epochs__nnUNetPlans__3d_fullres/crossval_results_folds_0_1_2_3_4/PETCT_f8314eb3f7_09202003.nii.gz,/well/papiez/users/hri611/python/nnUnet_raw/Dataset219_PETCT/labelsTr/PETCT_f8314eb3f7_09202003.nii.gz,0.0,40.893635913848875,0.0
900,,0,0,,52320000,0,0,0,/well/papiez/users/hri611/python/nnUNet_results/Dataset219_PETCT/nnUNetTrainer_1500epochs__nnUNetPlans__3d_fullres/crossval_results_folds_0_1_2_3_4/PETCT_f8aac0e202_02262006.nii.gz,/well/papiez/users/hri611/python/nnUnet_raw/Dataset219_PETCT/labelsTr/PETCT_f8aac0e202_02262006.nii.gz,,0.0,0.0
901,,0,0,,50880000,0,0,0,/well/papiez/users/hri611/python/nnUNet_results/Dataset219_PETCT/nnUNetTrainer_1500epochs__nnUNetPlans__3d_fullres/crossval_results_folds_0_1_2_3_4/PETCT_f8aac0e202_07302006.nii.gz,/well/papiez/users/hri611/python/nnUnet_raw/Dataset219_PETCT/labelsTr/PETCT_f8aac0e202_07302006.nii.gz,,0.0,0.0
902,,0,0,,53440000,0,0,0,/well/papiez/users/hri611/python/nnUNet_results/Dataset219_PETCT/nnUNetTrainer_1500epochs__nnUNetPlans__3d_fullres/crossval_results_folds_0_1_2_3_4/PETCT_f8de0cde56_12052005.nii.gz,/well/papiez/users/hri611/python/nnUnet_raw/Dataset219_PETCT/labelsTr/PETCT_f8de0cde56_12052005.nii.gz,,0.0,0.0
903,0.7394118891474508,1390,10928,0.5865610525609183,63490206,17476,28404,18866,/well/papiez/users/hri611/python/nnUNet_results/Dataset219_PETCT/nnUNetTrainer_1500epochs__nnUNetPlans__3d_fullres/crossval_results_folds_0_1_2_3_4/PETCT_f9c4d4f9ab_03222007.nii.gz,/well/papiez/users/hri611/python/nnUnet_raw/Dataset219_PETCT/labelsTr/PETCT_f9c4d4f9ab_03222007.nii.gz,0.7394118891474508,7.6263458518981935,0.0
904,0.9147239263803681,95,183,0.8428490672696438,52158231,1491,1674,1586,/well/papiez/users/hri611/python/nnUNet_results/Dataset219_PETCT/nnUNetTrainer_1500epochs__nnUNetPlans__3d_fullres/crossval_results_folds_0_1_2_3_4/PETCT_f9e0c504af_06292003.nii.gz,/well/papiez/users/hri611/python/nnUnet_raw/Dataset219_PETCT/labelsTr/PETCT_f9e0c504af_06292003.nii.gz,0.9147239263803681,1.7541839561462402,0.012441020965576172
905,,0,0,,45440000,0,0,0,/well/papiez/users/hri611/python/nnUNet_results/Dataset219_PETCT/nnUNetTrainer_1500epochs__nnUNetPlans__3d_fullres/crossval_results_folds_0_1_2_3_4/PETCT_fa45f610c4_10072004.nii.gz,/well/papiez/users/hri611/python/nnUnet_raw/Dataset219_PETCT/labelsTr/PETCT_fa45f610c4_10072004.nii.gz,,0.0,0.0
906,0.6768034754773065,2630,197,0.5114912735441507,52154213,2960,3157,5590,/well/papiez/users/hri611/python/nnUNet_results/Dataset219_PETCT/nnUNetTrainer_1500epochs__nnUNetPlans__3d_fullres/crossval_results_folds_0_1_2_3_4/PETCT_faf4a6dbaa_01102003.nii.gz,/well/papiez/users/hri611/python/nnUnet_raw/Dataset219_PETCT/labelsTr/PETCT_faf4a6dbaa_01102003.nii.gz,0.6768034754773065,1.4680404739379882,8.609186508178711
907,0.39102185469580625,0,2062,0.24302496328928047,47997276,662,2724,662,/well/papiez/users/hri611/python/nnUNet_results/Dataset219_PETCT/nnUNetTrainer_1500epochs__nnUNetPlans__3d_fullres/crossval_results_folds_0_1_2_3_4/PETCT_fb014a1ea0_12012005.nii.gz,/well/papiez/users/hri611/python/nnUnet_raw/Dataset219_PETCT/labelsTr/PETCT_fb014a1ea0_12012005.nii.gz,0.39102185469580625,1.443158432006836,0.0
908,0.6739336492890995,26,662,0.5082201572551823,45438601,711,1373,737,/well/papiez/users/hri611/python/nnUNet_results/Dataset219_PETCT/nnUNetTrainer_1500epochs__nnUNetPlans__3d_fullres/crossval_results_folds_0_1_2_3_4/PETCT_fbd907a179_10042003.nii.gz,/well/papiez/users/hri611/python/nnUnet_raw/Dataset219_PETCT/labelsTr/PETCT_fbd907a179_10042003.nii.gz,0.6739336492890995,7.875166271209717,0.0
909,0.0,0,65,0.0,95519935,0,65,0,/well/papiez/users/hri611/python/nnUNet_results/Dataset219_PETCT/nnUNetTrainer_1500epochs__nnUNetPlans__3d_fullres/crossval_results_folds_0_1_2_3_4/PETCT_fc0389a486_05302005.nii.gz,/well/papiez/users/hri611/python/nnUnet_raw/Dataset219_PETCT/labelsTr/PETCT_fc0389a486_05302005.nii.gz,0.0,0.8086663627624512,0.0
910,0.8679820475908205,1123,436,0.766756433273489,99033316,5125,5561,6248,/well/papiez/users/hri611/python/nnUNet_results/Dataset219_PETCT/nnUNetTrainer_1500epochs__nnUNetPlans__3d_fullres/crossval_results_folds_0_1_2_3_4/PETCT_fcdbe15200_12142003.nii.gz,/well/papiez/users/hri611/python/nnUnet_raw/Dataset219_PETCT/labelsTr/PETCT_fcdbe15200_12142003.nii.gz,0.8679820475908205,0.37323062896728515,0.06220510482788086
911,0.39384116693679094,248,500,0.24520686175580222,47839009,243,743,491,/well/papiez/users/hri611/python/nnUNet_results/Dataset219_PETCT/nnUNetTrainer_1500epochs__nnUNetPlans__3d_fullres/crossval_results_folds_0_1_2_3_4/PETCT_fde66dd53a_12222005.nii.gz,/well/papiez/users/hri611/python/nnUnet_raw/Dataset219_PETCT/labelsTr/PETCT_fde66dd53a_12222005.nii.gz,0.39384116693679094,5.125700637817383,3.0107270736694334
912,0.0,0,6,0.0,92319994,0,6,0,/well/papiez/users/hri611/python/nnUNet_results/Dataset219_PETCT/nnUNetTrainer_1500epochs__nnUNetPlans__3d_fullres/crossval_results_folds_0_1_2_3_4/PETCT_fde79b6aa9_02232003.nii.gz,/well/papiez/users/hri611/python/nnUnet_raw/Dataset219_PETCT/labelsTr/PETCT_fde79b6aa9_02232003.nii.gz,0.0,0.07464612579345703,0.0
913,0.8875,232,596,0.797752808988764,92315906,3266,3862,3498,/well/papiez/users/hri611/python/nnUNet_results/Dataset219_PETCT/nnUNetTrainer_1500epochs__nnUNetPlans__3d_fullres/crossval_results_folds_0_1_2_3_4/PETCT_fde79b6aa9_05092005.nii.gz,/well/papiez/users/hri611/python/nnUnet_raw/Dataset219_PETCT/labelsTr/PETCT_fde79b6aa9_05092005.nii.gz,0.8875,5.088377574920655,0.0
914,,0,0,,92320000,0,0,0,/well/papiez/users/hri611/python/nnUNet_results/Dataset219_PETCT/nnUNetTrainer_1500epochs__nnUNetPlans__3d_fullres/crossval_results_folds_0_1_2_3_4/PETCT_fde79b6aa9_08162003.nii.gz,/well/papiez/users/hri611/python/nnUnet_raw/Dataset219_PETCT/labelsTr/PETCT_fde79b6aa9_08162003.nii.gz,,0.0,0.0
915,0.0,0,296,0.0,45439704,0,296,0,/well/papiez/users/hri611/python/nnUNet_results/Dataset219_PETCT/nnUNetTrainer_1500epochs__nnUNetPlans__3d_fullres/crossval_results_folds_0_1_2_3_4/PETCT_fe705ea1cc_04272003.nii.gz,/well/papiez/users/hri611/python/nnUnet_raw/Dataset219_PETCT/labelsTr/PETCT_fe705ea1cc_04272003.nii.gz,0.0,3.682542205810547,0.0
916,0.7978807947019868,4500,3893,0.6637285147642134,45415041,16566,20459,21066,/well/papiez/users/hri611/python/nnUNet_results/Dataset219_PETCT/nnUNetTrainer_1500epochs__nnUNetPlans__3d_fullres/crossval_results_folds_0_1_2_3_4/PETCT_fe705ea1cc_12292002.nii.gz,/well/papiez/users/hri611/python/nnUnet_raw/Dataset219_PETCT/labelsTr/PETCT_fe705ea1cc_12292002.nii.gz,0.7978807947019868,8.02445852279663,12.018026252746582
917,0.0,0,13,0.0,52159987,0,13,0,/well/papiez/users/hri611/python/nnUNet_results/Dataset219_PETCT/nnUNetTrainer_1500epochs__nnUNetPlans__3d_fullres/crossval_results_folds_0_1_2_3_4/PETCT_ff1451316e_03312003.nii.gz,/well/papiez/users/hri611/python/nnUnet_raw/Dataset219_PETCT/labelsTr/PETCT_ff1451316e_03312003.nii.gz,0.0,0.16173327255249023,0.0
918,0.0,0,870,0.0,86079130,0,870,0,/well/papiez/users/hri611/python/nnUNet_results/Dataset219_PETCT/nnUNetTrainer_1500epochs__nnUNetPlans__3d_fullres/crossval_results_folds_0_1_2_3_4/PETCT_ff39795341_09222005.nii.gz,/well/papiez/users/hri611/python/nnUnet_raw/Dataset219_PETCT/labelsTr/PETCT_ff39795341_09222005.nii.gz,0.0,10.82368824005127,0.0
